region_id,time_slot,day_of_week,supply,demand,demand_supply_gap
1,0,0,21,208,187
1,0,1,50,220,170
1,0,2,20,181,161
1,0,3,9,181,172
1,0,4,17,340,323
1,0,5,11,238,227
1,0,6,5,257,252
1,1,0,21,167,146
1,1,1,15,146,131
1,1,2,24,182,158
1,1,3,7,149,142
1,1,4,15,306,291
1,1,5,15,226,211
1,1,6,12,219,207
1,2,0,12,151,139
1,2,1,22,157,135
1,2,2,11,130,119
1,2,3,10,125,115
1,2,4,18,314,296
1,2,5,9,185,176
1,2,6,13,223,210
1,3,0,16,148,132
1,3,1,14,142,128
1,3,2,4,100,96
1,3,3,4,115,111
1,3,4,11,276,265
1,3,5,5,163,158
1,3,6,8,206,198
1,4,0,7,130,123
1,4,1,15,128,113
1,4,2,1,113,112
1,4,3,4,110,106
1,4,4,8,238,230
1,4,5,16,184,168
1,4,6,3,180,177
1,5,0,6,98,92
1,5,1,4,108,104
1,5,2,2,101,99
1,5,3,2,97,95
1,5,4,3,217,214
1,5,5,23,184,161
1,5,6,9,167,158
1,6,0,5,115,110
1,6,1,16,99,83
1,6,2,2,97,95
1,6,3,5,85,80
1,6,4,14,202,188
1,6,5,10,148,138
1,6,6,9,165,156
1,7,0,13,108,95
1,7,1,8,77,69
1,7,2,3,93,90
1,7,3,5,88,83
1,7,4,9,210,201
1,7,5,9,115,106
1,7,6,11,142,131
1,8,0,21,107,86
1,8,1,6,78,72
1,8,2,5,78,73
1,8,3,3,81,78
1,8,4,12,185,173
1,8,5,2,126,124
1,8,6,13,150,137
1,9,0,9,76,67
1,9,1,4,64,60
1,9,2,3,87,84
1,9,3,13,114,101
1,9,4,6,172,166
1,9,5,7,105,98
1,9,6,18,142,124
1,10,0,13,77,64
1,10,1,6,78,72
1,10,2,2,66,64
1,10,3,12,98,86
1,10,4,3,140,137
1,10,5,12,113,101
1,10,6,18,127,109
1,11,0,11,81,70
1,11,1,14,83,69
1,11,2,0,56,56
1,11,3,6,48,42
1,11,4,6,128,122
1,11,5,9,112,103
1,11,6,7,99,92
1,12,0,8,79,71
1,12,1,4,66,62
1,12,2,1,63,62
1,12,3,2,63,61
1,12,4,6,122,116
1,12,5,9,106,97
1,12,6,13,114,101
1,13,0,9,62,53
1,13,1,13,74,61
1,13,2,6,74,68
1,13,3,4,59,55
1,13,4,5,117,112
1,13,5,28,118,90
1,13,6,7,78,71
1,14,0,8,55,47
1,14,1,5,63,58
1,14,2,2,54,52
1,14,3,2,55,53
1,14,4,7,113,106
1,14,5,16,88,72
1,14,6,6,74,68
1,15,0,1,56,55
1,15,1,16,41,25
1,15,2,6,59,53
1,15,3,2,43,41
1,15,4,12,111,99
1,15,5,6,73,67
1,15,6,7,76,69
1,16,0,4,48,44
1,16,1,5,35,30
1,16,2,1,36,35
1,16,3,3,52,49
1,16,4,21,98,77
1,16,5,6,69,63
1,16,6,3,54,51
1,17,0,5,39,34
1,17,1,6,42,36
1,17,2,3,44,41
1,17,3,6,44,38
1,17,4,19,103,84
1,17,5,9,88,79
1,17,6,2,67,65
1,18,0,0,42,42
1,18,1,9,45,36
1,18,2,1,41,40
1,18,3,4,41,37
1,18,4,11,87,76
1,18,5,17,82,65
1,18,6,4,53,49
1,19,0,10,51,41
1,19,1,5,29,24
1,19,2,4,31,27
1,19,3,4,38,34
1,19,4,11,76,65
1,19,5,4,39,35
1,19,6,3,42,39
1,20,0,1,31,30
1,20,1,20,52,32
1,20,2,3,38,35
1,20,3,3,34,31
1,20,4,3,64,61
1,20,5,3,53,50
1,20,6,5,54,49
1,21,0,2,28,26
1,21,1,8,39,31
1,21,2,8,24,16
1,21,3,5,34,29
1,21,4,3,50,47
1,21,5,3,42,39
1,21,6,16,63,47
1,22,0,2,29,27
1,22,1,3,22,19
1,22,2,6,42,36
1,22,3,4,24,20
1,22,4,3,47,44
1,22,5,4,38,34
1,22,6,4,37,33
1,23,0,5,28,23
1,23,1,4,28,24
1,23,2,3,24,21
1,23,3,4,24,20
1,23,4,10,45,35
1,23,5,10,31,21
1,23,6,1,33,32
1,24,0,3,31,28
1,24,1,6,24,18
1,24,2,2,21,19
1,24,3,1,24,23
1,24,4,1,30,29
1,24,5,0,22,22
1,24,6,5,33,28
1,25,0,3,22,19
1,25,1,2,21,19
1,25,2,4,19,15
1,25,3,1,10,9
1,25,4,1,30,29
1,25,5,0,20,20
1,25,6,2,34,32
1,26,0,6,23,17
1,26,1,4,24,20
1,26,2,1,30,29
1,26,3,2,22,20
1,26,4,6,44,38
1,26,5,1,30,29
1,26,6,3,19,16
1,27,0,1,23,22
1,27,1,5,22,17
1,27,2,2,31,29
1,27,3,3,27,24
1,27,4,2,29,27
1,27,5,0,22,22
1,27,6,0,29,29
1,28,0,1,18,17
1,28,1,3,16,13
1,28,2,7,20,13
1,28,3,1,23,22
1,28,4,4,39,35
1,28,5,2,25,23
1,28,6,3,27,24
1,29,0,1,24,23
1,29,1,3,27,24
1,29,2,5,18,13
1,29,3,5,21,16
1,29,4,16,38,22
1,29,5,5,30,25
1,29,6,1,20,19
1,30,0,2,18,16
1,30,1,5,24,19
1,30,2,9,22,13
1,30,3,10,25,15
1,30,4,29,51,22
1,30,5,6,28,22
1,30,6,5,25,20
1,31,0,0,16,16
1,31,1,6,29,23
1,31,2,3,26,23
1,31,3,7,31,24
1,31,4,17,50,33
1,31,5,12,40,28
1,31,6,4,25,21
1,32,0,2,16,14
1,32,1,8,26,18
1,32,2,3,21,18
1,32,3,3,24,21
1,32,4,27,48,21
1,32,5,5,32,27
1,32,6,5,32,27
1,33,0,3,31,28
1,33,1,2,22,20
1,33,2,4,24,20
1,33,3,7,28,21
1,33,4,56,85,29
1,33,5,4,35,31
1,33,6,14,42,28
1,34,0,3,36,33
1,34,1,10,33,23
1,34,2,2,26,24
1,34,3,8,26,18
1,34,4,58,84,26
1,34,5,9,58,49
1,34,6,4,40,36
1,35,0,19,46,27
1,35,1,18,57,39
1,35,2,19,60,41
1,35,3,16,43,27
1,35,4,116,164,48
1,35,5,16,56,40
1,35,6,12,63,51
1,36,0,25,72,47
1,36,1,8,61,53
1,36,2,49,100,51
1,36,3,32,77,45
1,36,4,226,272,46
1,36,5,18,73,55
1,36,6,11,62,51
1,37,0,22,68,46
1,37,1,20,73,53
1,37,2,17,73,56
1,37,3,19,75,56
1,37,4,227,303,76
1,37,5,33,101,68
1,37,6,13,56,43
1,38,0,20,85,65
1,38,1,31,103,72
1,38,2,9,88,79
1,38,3,17,90,73
1,38,4,227,299,72
1,38,5,13,85,72
1,38,6,20,80,60
1,39,0,5,128,123
1,39,1,3,102,99
1,39,2,8,129,121
1,39,3,3,120,117
1,39,4,248,374,126
1,39,5,1,106,105
1,39,6,9,81,72
1,40,0,3,135,132
1,40,1,5,136,131
1,40,2,5,142,137
1,40,3,3,145,142
1,40,4,187,314,127
1,40,5,7,122,115
1,40,6,7,97,90
1,41,0,5,212,207
1,41,1,5,176,171
1,41,2,7,178,171
1,41,3,4,165,161
1,41,4,70,237,167
1,41,5,6,126,120
1,41,6,8,121,113
1,42,0,4,276,272
1,42,1,4,262,258
1,42,2,14,297,283
1,42,3,9,257,248
1,42,4,60,307,247
1,42,5,7,164,157
1,42,6,2,143,141
1,43,0,5,344,339
1,43,1,10,339,329
1,43,2,10,362,352
1,43,3,8,359,351
1,43,4,12,333,321
1,43,5,1,217,216
1,43,6,6,169,163
1,44,0,6,467,461
1,44,1,6,470,464
1,44,2,8,454,446
1,44,3,12,486,474
1,44,4,7,395,388
1,44,5,6,251,245
1,44,6,5,206,201
1,45,0,5,640,635
1,45,1,9,642,633
1,45,2,11,729,718
1,45,3,12,724,712
1,45,4,12,560,548
1,45,5,6,289,283
1,45,6,10,317,307
1,46,0,24,782,758
1,46,1,19,695,676
1,46,2,11,864,853
1,46,3,36,805,769
1,46,4,10,608,598
1,46,5,9,372,363
1,46,6,5,318,313
1,47,0,25,807,782
1,47,1,15,741,726
1,47,2,15,862,847
1,47,3,26,801,775
1,47,4,11,607,596
1,47,5,10,363,353
1,47,6,6,298,292
1,48,0,78,1048,970
1,48,1,32,979,947
1,48,2,31,1108,1077
1,48,3,157,1158,1001
1,48,4,17,771,754
1,48,5,10,472,462
1,48,6,8,399,391
1,49,0,402,1448,1046
1,49,1,101,1241,1140
1,49,2,213,1354,1141
1,49,3,316,1358,1042
1,49,4,30,922,892
1,49,5,17,584,567
1,49,6,9,489,480
1,50,0,209,1115,906
1,50,1,57,991,934
1,50,2,195,1175,980
1,50,3,230,1196,966
1,50,4,54,814,760
1,50,5,15,615,600
1,50,6,15,491,476
1,51,0,183,1267,1084
1,51,1,58,1113,1055
1,51,2,128,1281,1153
1,51,3,154,1212,1058
1,51,4,20,785,765
1,51,5,34,666,632
1,51,6,9,561,552
1,52,0,330,1477,1147
1,52,1,132,1354,1222
1,52,2,116,1324,1208
1,52,3,234,1335,1101
1,52,4,47,968,921
1,52,5,25,706,681
1,52,6,22,557,535
1,53,0,76,927,851
1,53,1,30,894,864
1,53,2,33,861,828
1,53,3,31,873,842
1,53,4,18,697,679
1,53,5,14,469,455
1,53,6,9,424,415
1,54,0,18,660,642
1,54,1,14,683,669
1,54,2,18,657,639
1,54,3,15,666,651
1,54,4,16,548,532
1,54,5,9,418,409
1,54,6,4,405,401
1,55,0,8,651,643
1,55,1,13,600,587
1,55,2,15,644,629
1,55,3,14,610,596
1,55,4,7,520,513
1,55,5,12,432,420
1,55,6,5,399,394
1,56,0,9,573,564
1,56,1,13,553,540
1,56,2,8,590,582
1,56,3,12,557,545
1,56,4,20,508,488
1,56,5,5,416,411
1,56,6,14,386,372
1,57,0,19,531,512
1,57,1,20,500,480
1,57,2,6,445,439
1,57,3,9,534,525
1,57,4,11,450,439
1,57,5,13,399,386
1,57,6,7,333,326
1,58,0,9,531,522
1,58,1,14,510,496
1,58,2,9,535,526
1,58,3,13,487,474
1,58,4,15,448,433
1,58,5,7,425,418
1,58,6,11,432,421
1,59,0,7,407,400
1,59,1,8,428,420
1,59,2,10,494,484
1,59,3,8,445,437
1,59,4,12,436,424
1,59,5,14,454,440
1,59,6,11,390,379
1,60,0,4,394,390
1,60,1,9,387,378
1,60,2,7,387,380
1,60,3,15,429,414
1,60,4,12,512,500
1,60,5,11,435,424
1,60,6,4,441,437
1,61,0,10,407,397
1,61,1,6,364,358
1,61,2,6,372,366
1,61,3,6,392,386
1,61,4,11,412,401
1,61,5,7,392,385
1,61,6,9,399,390
1,62,0,8,364,356
1,62,1,9,345,336
1,62,2,11,358,347
1,62,3,8,390,382
1,62,4,9,416,407
1,62,5,8,379,371
1,62,6,8,396,388
1,63,0,7,419,412
1,63,1,7,338,331
1,63,2,5,412,407
1,63,3,10,391,381
1,63,4,28,444,416
1,63,5,7,396,389
1,63,6,10,408,398
1,64,0,11,366,355
1,64,1,10,385,375
1,64,2,10,356,346
1,64,3,8,393,385
1,64,4,8,414,406
1,64,5,10,384,374
1,64,6,9,425,416
1,65,0,13,383,370
1,65,1,3,340,337
1,65,2,10,405,395
1,65,3,9,415,406
1,65,4,13,388,375
1,65,5,10,401,391
1,65,6,5,407,402
1,66,0,18,458,440
1,66,1,9,404,395
1,66,2,12,412,400
1,66,3,11,425,414
1,66,4,10,501,491
1,66,5,9,446,437
1,66,6,14,420,406
1,67,0,10,438,428
1,67,1,14,391,377
1,67,2,9,444,435
1,67,3,11,450,439
1,67,4,23,530,507
1,67,5,9,451,442
1,67,6,12,443,431
1,68,0,11,409,398
1,68,1,9,411,402
1,68,2,17,397,380
1,68,3,32,455,423
1,68,4,36,493,457
1,68,5,10,420,410
1,68,6,20,502,482
1,69,0,9,476,467
1,69,1,20,490,470
1,69,2,32,486,454
1,69,3,12,483,471
1,69,4,27,532,505
1,69,5,16,484,468
1,69,6,19,566,547
1,70,0,18,490,472
1,70,1,9,507,498
1,70,2,44,529,485
1,70,3,24,451,427
1,70,4,34,596,562
1,70,5,9,497,488
1,70,6,19,611,592
1,71,0,14,496,482
1,71,1,12,469,457
1,71,2,13,516,503
1,71,3,22,461,439
1,71,4,50,615,565
1,71,5,15,509,494
1,71,6,16,592,576
1,72,0,13,514,501
1,72,1,33,500,467
1,72,2,17,460,443
1,72,3,21,501,480
1,72,4,28,589,561
1,72,5,11,512,501
1,72,6,21,650,629
1,73,0,18,469,451
1,73,1,18,428,410
1,73,2,19,514,495
1,73,3,27,511,484
1,73,4,31,547,516
1,73,5,14,510,496
1,73,6,18,615,597
1,74,0,16,486,470
1,74,1,14,415,401
1,74,2,10,460,450
1,74,3,12,457,445
1,74,4,28,499,471
1,74,5,13,547,534
1,74,6,17,550,533
1,75,0,10,516,506
1,75,1,18,445,427
1,75,2,12,497,485
1,75,3,15,484,469
1,75,4,16,522,506
1,75,5,14,512,498
1,75,6,16,590,574
1,76,0,16,563,547
1,76,1,20,513,493
1,76,2,14,491,477
1,76,3,12,516,504
1,76,4,25,550,525
1,76,5,15,545,530
1,76,6,11,607,596
1,77,0,16,516,500
1,77,1,18,475,457
1,77,2,14,479,465
1,77,3,18,506,488
1,77,4,11,515,504
1,77,5,16,554,538
1,77,6,18,631,613
1,78,0,20,574,554
1,78,1,16,498,482
1,78,2,9,500,491
1,78,3,15,479,464
1,78,4,14,569,555
1,78,5,13,552,539
1,78,6,17,580,563
1,79,0,14,525,511
1,79,1,9,457,448
1,79,2,19,560,541
1,79,3,13,506,493
1,79,4,21,579,558
1,79,5,13,545,532
1,79,6,24,640,616
1,80,0,19,499,480
1,80,1,13,433,420
1,80,2,15,486,471
1,80,3,17,541,524
1,80,4,22,590,568
1,80,5,10,557,547
1,80,6,17,594,577
1,81,0,11,524,513
1,81,1,10,514,504
1,81,2,6,484,478
1,81,3,10,463,453
1,81,4,26,547,521
1,81,5,12,531,519
1,81,6,16,652,636
1,82,0,7,486,479
1,82,1,18,467,449
1,82,2,18,522,504
1,82,3,12,462,450
1,82,4,12,511,499
1,82,5,12,578,566
1,82,6,12,618,606
1,83,0,11,515,504
1,83,1,10,439,429
1,83,2,7,439,432
1,83,3,14,478,464
1,83,4,20,558,538
1,83,5,16,572,556
1,83,6,12,647,635
1,84,0,14,528,514
1,84,1,17,442,425
1,84,2,11,505,494
1,84,3,13,473,460
1,84,4,16,563,547
1,84,5,14,555,541
1,84,6,11,621,610
1,85,0,18,510,492
1,85,1,11,452,441
1,85,2,13,469,456
1,85,3,11,441,430
1,85,4,20,543,523
1,85,5,12,559,547
1,85,6,18,645,627
1,86,0,18,478,460
1,86,1,19,437,418
1,86,2,16,429,413
1,86,3,23,477,454
1,86,4,18,541,523
1,86,5,13,531,518
1,86,6,8,671,663
1,87,0,14,519,505
1,87,1,17,441,424
1,87,2,13,485,472
1,87,3,11,552,541
1,87,4,19,544,525
1,87,5,9,579,570
1,87,6,23,699,676
1,88,0,15,488,473
1,88,1,12,445,433
1,88,2,8,466,458
1,88,3,31,550,519
1,88,4,20,555,535
1,88,5,13,598,585
1,88,6,11,645,634
1,89,0,6,482,476
1,89,1,8,458,450
1,89,2,12,449,437
1,89,3,65,552,487
1,89,4,18,575,557
1,89,5,17,606,589
1,89,6,20,645,625
1,90,0,9,525,516
1,90,1,12,495,483
1,90,2,15,488,473
1,90,3,92,576,484
1,90,4,11,598,587
1,90,5,29,652,623
1,90,6,8,616,608
1,91,0,13,554,541
1,91,1,16,516,500
1,91,2,29,495,466
1,91,3,77,536,459
1,91,4,20,560,540
1,91,5,14,573,559
1,91,6,14,652,638
1,92,0,10,552,542
1,92,1,14,519,505
1,92,2,34,512,478
1,92,3,70,524,454
1,92,4,19,574,555
1,92,5,11,552,541
1,92,6,14,673,659
1,93,0,10,569,559
1,93,1,13,495,482
1,93,2,12,551,539
1,93,3,15,534,519
1,93,4,11,601,590
1,93,5,17,558,541
1,93,6,19,718,699
1,94,0,16,513,497
1,94,1,9,520,511
1,94,2,14,522,508
1,94,3,11,467,456
1,94,4,17,579,562
1,94,5,19,550,531
1,94,6,17,712,695
1,95,0,9,540,531
1,95,1,15,526,511
1,95,2,8,526,518
1,95,3,24,469,445
1,95,4,16,586,570
1,95,5,21,575,554
1,95,6,18,731,713
1,96,0,12,611,599
1,96,1,15,603,588
1,96,2,20,605,585
1,96,3,13,544,531
1,96,4,16,573,557
1,96,5,33,664,631
1,96,6,24,781,757
1,97,0,12,603,591
1,97,1,21,608,587
1,97,2,12,551,539
1,97,3,19,540,521
1,97,4,17,619,602
1,97,5,12,623,611
1,97,6,14,741,727
1,98,0,26,650,624
1,98,1,18,594,576
1,98,2,26,578,552
1,98,3,12,610,598
1,98,4,22,723,701
1,98,5,12,641,629
1,98,6,12,733,721
1,99,0,16,639,623
1,99,1,19,627,608
1,99,2,14,693,679
1,99,3,14,654,640
1,99,4,22,701,679
1,99,5,13,708,695
1,99,6,22,797,775
1,100,0,15,623,608
1,100,1,31,636,605
1,100,2,30,645,615
1,100,3,20,609,589
1,100,4,16,687,671
1,100,5,20,647,627
1,100,6,16,814,798
1,101,0,25,688,663
1,101,1,3,594,591
1,101,2,14,645,631
1,101,3,13,665,652
1,101,4,25,739,714
1,101,5,18,690,672
1,101,6,14,763,749
1,102,0,30,839,809
1,102,1,21,846,825
1,102,2,22,884,862
1,102,3,21,925,904
1,102,4,18,836,818
1,102,5,20,709,689
1,102,6,18,831,813
1,103,0,18,754,736
1,103,1,17,704,687
1,103,2,28,801,773
1,103,3,23,750,727
1,103,4,22,820,798
1,103,5,16,687,671
1,103,6,23,832,809
1,104,0,15,687,672
1,104,1,25,736,711
1,104,2,24,749,725
1,104,3,23,735,712
1,104,4,20,803,783
1,104,5,21,802,781
1,104,6,23,805,782
1,105,0,23,907,884
1,105,1,10,865,855
1,105,2,27,910,883
1,105,3,18,943,925
1,105,4,31,908,877
1,105,5,24,874,850
1,105,6,30,906,876
1,106,0,15,848,833
1,106,1,18,819,801
1,106,2,27,841,814
1,106,3,23,809,786
1,106,4,26,899,873
1,106,5,19,856,837
1,106,6,21,803,782
1,107,0,26,801,775
1,107,1,15,748,733
1,107,2,28,779,751
1,107,3,30,765,735
1,107,4,23,825,802
1,107,5,15,784,769
1,107,6,17,821,804
1,108,0,26,839,813
1,108,1,30,915,885
1,108,2,25,910,885
1,108,3,22,850,828
1,108,4,25,858,833
1,108,5,32,850,818
1,108,6,22,920,898
1,109,0,32,789,757
1,109,1,21,845,824
1,109,2,26,849,823
1,109,3,18,774,756
1,109,4,24,836,812
1,109,5,20,798,778
1,109,6,24,825,801
1,110,0,21,794,773
1,110,1,34,822,788
1,110,2,26,793,767
1,110,3,17,718,701
1,110,4,28,868,840
1,110,5,14,767,753
1,110,6,12,755,743
1,111,0,11,749,738
1,111,1,19,783,764
1,111,2,17,746,729
1,111,3,23,797,774
1,111,4,28,802,774
1,111,5,20,795,775
1,111,6,8,754,746
1,112,0,23,696,673
1,112,1,17,730,713
1,112,2,15,712,697
1,112,3,17,667,650
1,112,4,9,722,713
1,112,5,42,808,766
1,112,6,18,734,716
1,113,0,20,656,636
1,113,1,11,650,639
1,113,2,16,647,631
1,113,3,20,659,639
1,113,4,14,706,692
1,113,5,35,799,764
1,113,6,21,779,758
1,114,0,12,634,622
1,114,1,13,658,645
1,114,2,20,673,653
1,114,3,15,653,638
1,114,4,16,747,731
1,114,5,20,728,708
1,114,6,16,712,696
1,115,0,12,598,586
1,115,1,22,651,629
1,115,2,15,587,572
1,115,3,7,603,596
1,115,4,22,739,717
1,115,5,20,695,675
1,115,6,19,756,737
1,116,0,22,579,557
1,116,1,14,584,570
1,116,2,15,649,634
1,116,3,24,648,624
1,116,4,17,683,666
1,116,5,21,625,604
1,116,6,13,709,696
1,117,0,16,622,606
1,117,1,17,657,640
1,117,2,19,664,645
1,117,3,12,616,604
1,117,4,22,692,670
1,117,5,15,625,610
1,117,6,14,758,744
1,118,0,20,614,594
1,118,1,11,613,602
1,118,2,24,702,678
1,118,3,15,569,554
1,118,4,17,684,667
1,118,5,18,685,667
1,118,6,25,723,698
1,119,0,18,651,633
1,119,1,20,665,645
1,119,2,15,660,645
1,119,3,23,609,586
1,119,4,15,702,687
1,119,5,22,717,695
1,119,6,25,781,756
1,120,0,27,698,671
1,120,1,12,693,681
1,120,2,23,715,692
1,120,3,21,686,665
1,120,4,21,758,737
1,120,5,11,665,654
1,120,6,8,752,744
1,121,0,15,671,656
1,121,1,23,668,645
1,121,2,14,777,763
1,121,3,19,694,675
1,121,4,28,787,759
1,121,5,22,710,688
1,121,6,19,750,731
1,122,0,20,672,652
1,122,1,16,684,668
1,122,2,15,671,656
1,122,3,19,715,696
1,122,4,20,744,724
1,122,5,11,706,695
1,122,6,28,726,698
1,123,0,19,713,694
1,123,1,22,775,753
1,123,2,26,726,700
1,123,3,23,671,648
1,123,4,25,817,792
1,123,5,15,750,735
1,123,6,17,715,698
1,124,0,12,678,666
1,124,1,20,765,745
1,124,2,23,750,727
1,124,3,18,666,648
1,124,4,17,731,714
1,124,5,10,663,653
1,124,6,16,731,715
1,125,0,30,692,662
1,125,1,20,792,772
1,125,2,6,691,685
1,125,3,12,669,657
1,125,4,19,792,773
1,125,5,20,768,748
1,125,6,22,760,738
1,126,0,20,771,751
1,126,1,18,820,802
1,126,2,18,778,760
1,126,3,21,730,709
1,126,4,33,821,788
1,126,5,15,708,693
1,126,6,21,772,751
1,127,0,12,620,608
1,127,1,11,657,646
1,127,2,24,790,766
1,127,3,17,705,688
1,127,4,18,810,792
1,127,5,16,695,679
1,127,6,17,674,657
1,128,0,18,639,621
1,128,1,21,679,658
1,128,2,20,654,634
1,128,3,20,652,632
1,128,4,24,783,759
1,128,5,22,729,707
1,128,6,19,662,643
1,129,0,15,615,600
1,129,1,19,674,655
1,129,2,24,668,644
1,129,3,18,595,577
1,129,4,18,688,670
1,129,5,29,758,729
1,129,6,24,680,656
1,130,0,13,595,582
1,130,1,11,611,600
1,130,2,11,611,600
1,130,3,13,583,570
1,130,4,24,694,670
1,130,5,15,648,633
1,130,6,14,607,593
1,131,0,10,625,615
1,131,1,8,576,568
1,131,2,12,653,641
1,131,3,14,591,577
1,131,4,25,754,729
1,131,5,29,846,817
1,131,6,30,626,596
1,132,0,21,682,661
1,132,1,18,669,651
1,132,2,17,673,656
1,132,3,14,611,597
1,132,4,18,801,783
1,132,5,110,970,860
1,132,6,12,621,609
1,133,0,20,550,530
1,133,1,12,477,465
1,133,2,11,529,518
1,133,3,22,478,456
1,133,4,31,664,633
1,133,5,171,892,721
1,133,6,17,577,560
1,134,0,15,421,406
1,134,1,12,427,415
1,134,2,8,473,465
1,134,3,17,442,425
1,134,4,22,554,532
1,134,5,135,745,610
1,134,6,15,454,439
1,135,0,10,403,393
1,135,1,14,334,320
1,135,2,15,394,379
1,135,3,16,420,404
1,135,4,17,527,510
1,135,5,31,541,510
1,135,6,10,389,379
1,136,0,7,320,313
1,136,1,13,292,279
1,136,2,4,348,344
1,136,3,10,333,323
1,136,4,15,456,441
1,136,5,23,501,478
1,136,6,19,402,383
1,137,0,11,344,333
1,137,1,17,349,332
1,137,2,4,341,337
1,137,3,8,320,312
1,137,4,20,404,384
1,137,5,16,486,470
1,137,6,17,354,337
1,138,0,7,241,234
1,138,1,5,246,241
1,138,2,15,261,246
1,138,3,13,264,251
1,138,4,14,366,352
1,138,5,8,381,373
1,138,6,7,343,336
1,139,0,13,245,232
1,139,1,6,210,204
1,139,2,13,267,254
1,139,3,13,254,241
1,139,4,10,331,321
1,139,5,15,322,307
1,139,6,15,269,254
1,140,0,4,206,202
1,140,1,2,219,217
1,140,2,11,223,212
1,140,3,16,235,219
1,140,4,8,335,327
1,140,5,8,333,325
1,140,6,11,261,250
1,141,0,9,195,186
1,141,1,6,200,194
1,141,2,1,187,186
1,141,3,15,220,205
1,141,4,8,269,261
1,141,5,5,261,256
1,141,6,9,235,226
1,142,0,10,173,163
1,142,1,7,162,155
1,142,2,7,214,207
1,142,3,9,174,165
1,142,4,11,260,249
1,142,5,8,258,250
1,142,6,12,159,147
1,143,0,11,161,150
1,143,1,8,176,168
1,143,2,13,196,183
1,143,3,16,194,178
1,143,4,4,230,226
1,143,5,11,250,239
1,143,6,9,162,153
2,0,0,0,16,16
2,0,1,0,18,18
2,0,2,1,25,24
2,0,3,1,23,22
2,0,4,2,28,26
2,0,5,2,29,27
2,0,6,2,39,37
2,1,0,0,18,18
2,1,1,1,22,21
2,1,2,0,22,22
2,1,3,3,26,23
2,1,4,0,30,30
2,1,5,0,23,23
2,1,6,2,27,25
2,2,0,1,18,17
2,2,1,2,19,17
2,2,2,1,34,33
2,2,3,2,19,17
2,2,4,0,25,25
2,2,5,0,16,16
2,2,6,0,29,29
2,3,0,2,26,24
2,3,1,0,13,13
2,3,2,3,22,19
2,3,3,2,24,22
2,3,4,0,20,20
2,3,5,0,24,24
2,3,6,1,27,26
2,4,0,2,20,18
2,4,1,2,13,11
2,4,2,0,17,17
2,4,3,1,16,15
2,4,4,1,28,27
2,4,5,6,24,18
2,4,6,1,21,20
2,5,0,2,16,14
2,5,1,1,15,14
2,5,2,0,18,18
2,5,3,0,11,11
2,5,4,3,27,24
2,5,5,3,15,12
2,5,6,0,15,15
2,6,0,1,12,11
2,6,1,0,17,17
2,6,2,3,25,22
2,6,3,0,12,12
2,6,4,4,25,21
2,6,5,1,17,16
2,6,6,1,23,22
2,7,0,1,11,10
2,7,1,0,6,6
2,7,2,2,13,11
2,7,3,5,15,10
2,7,4,0,14,14
2,7,5,1,14,13
2,7,6,4,16,12
2,8,0,0,11,11
2,8,1,0,9,9
2,8,2,5,17,12
2,8,3,1,8,7
2,8,4,0,9,9
2,8,5,0,13,13
2,8,6,2,12,10
2,9,0,2,13,11
2,9,1,0,4,4
2,9,2,0,11,11
2,9,3,0,8,8
2,9,4,0,11,11
2,9,5,1,8,7
2,9,6,1,18,17
2,10,0,1,6,5
2,10,1,0,13,13
2,10,2,1,8,7
2,10,3,2,13,11
2,10,4,1,17,16
2,10,5,1,13,12
2,10,6,1,16,15
2,11,0,3,11,8
2,11,1,2,5,3
2,11,2,7,14,7
2,11,3,0,3,3
2,11,4,1,11,10
2,11,5,4,5,1
2,11,6,2,8,6
2,12,0,0,6,6
2,12,1,3,12,9
2,12,2,2,7,5
2,12,3,0,7,7
2,12,4,1,11,10
2,12,5,2,10,8
2,12,6,1,4,3
2,13,0,2,11,9
2,13,1,0,2,2
2,13,2,0,11,11
2,13,3,2,8,6
2,13,4,3,12,9
2,13,5,2,7,5
2,13,6,3,7,4
2,14,0,1,5,4
2,14,1,0,4,4
2,14,2,3,13,10
2,14,3,1,7,6
2,14,4,0,5,5
2,14,5,1,8,7
2,14,6,2,15,13
2,15,0,1,5,4
2,15,1,0,5,5
2,15,2,2,8,6
2,15,3,1,5,4
2,15,4,3,13,10
2,15,5,0,2,2
2,15,6,3,7,4
2,16,0,4,8,4
2,16,1,2,7,5
2,16,2,0,7,7
2,16,3,0,1,1
2,16,4,0,6,6
2,16,5,1,7,6
2,16,6,1,5,4
2,17,0,3,5,2
2,17,1,2,6,4
2,17,2,0,6,6
2,17,3,0,4,4
2,17,5,3,8,5
2,17,6,3,9,6
2,18,0,0,1,1
2,18,1,0,3,3
2,18,2,1,3,2
2,18,3,4,7,3
2,18,4,1,3,2
2,18,5,1,1,0
2,18,6,2,2,0
2,19,0,0,2,2
2,19,1,0,3,3
2,19,2,0,4,4
2,19,3,1,5,4
2,19,5,0,2,2
2,19,6,1,5,4
2,20,0,0,1,1
2,20,1,0,3,3
2,20,2,1,3,2
2,20,3,0,1,1
2,20,4,0,2,2
2,20,5,1,2,1
2,20,6,1,5,4
2,21,0,0,1,1
2,21,1,0,2,2
2,21,2,1,3,2
2,21,3,2,2,0
2,21,4,0,4,4
2,21,5,0,3,3
2,21,6,3,5,2
2,22,0,0,2,2
2,22,1,1,5,4
2,22,2,0,2,2
2,22,4,5,7,2
2,22,5,2,2,0
2,22,6,1,2,1
2,23,0,0,1,1
2,23,2,0,2,2
2,23,3,0,2,2
2,23,4,2,2,0
2,23,5,0,1,1
2,23,6,1,3,2
2,24,0,0,2,2
2,24,2,0,2,2
2,24,3,2,3,1
2,24,4,2,3,1
2,24,5,2,2,0
2,25,1,0,1,1
2,25,2,1,1,0
2,25,3,2,4,2
2,25,4,1,1,0
2,25,6,0,1,1
2,26,2,1,3,2
2,26,3,0,1,1
2,26,5,2,2,0
2,26,6,1,3,2
2,27,0,4,5,1
2,27,1,1,4,3
2,27,2,1,1,0
2,27,3,2,2,0
2,27,4,2,3,1
2,27,6,0,1,1
2,28,0,2,2,0
2,28,2,1,2,1
2,28,4,2,3,1
2,28,5,1,1,0
2,28,6,1,2,1
2,29,1,1,2,1
2,29,3,0,1,1
2,29,4,0,1,1
2,29,6,1,3,2
2,30,1,6,6,0
2,30,2,0,1,1
2,30,3,0,2,2
2,30,4,1,2,1
2,31,0,1,3,2
2,31,1,1,1,0
2,31,3,1,2,1
2,31,5,1,1,0
2,32,0,4,5,1
2,32,1,1,1,0
2,32,2,0,2,2
2,32,3,2,4,2
2,32,4,0,2,2
2,32,5,1,1,0
2,32,6,0,1,1
2,33,0,5,8,3
2,33,1,0,2,2
2,33,2,0,2,2
2,33,3,2,4,2
2,33,4,4,10,6
2,33,5,0,1,1
2,33,6,1,1,0
2,34,0,2,4,2
2,34,1,0,1,1
2,34,2,0,2,2
2,34,4,1,2,1
2,34,5,1,3,2
2,34,6,4,4,0
2,35,0,2,6,4
2,35,1,1,2,1
2,35,2,0,3,3
2,35,4,3,5,2
2,35,5,0,1,1
2,35,6,0,2,2
2,36,0,4,8,4
2,36,1,1,3,2
2,36,2,0,3,3
2,36,3,1,3,2
2,36,4,2,5,3
2,36,6,0,2,2
2,37,0,2,7,5
2,37,1,1,5,4
2,37,2,0,4,4
2,37,3,0,6,6
2,37,4,0,1,1
2,37,5,0,1,1
2,37,6,0,4,4
2,38,0,6,21,15
2,38,1,0,11,11
2,38,2,1,12,11
2,38,3,1,9,8
2,38,4,0,12,12
2,38,5,1,4,3
2,38,6,1,7,6
2,39,0,1,31,30
2,39,1,3,25,22
2,39,2,2,35,33
2,39,3,3,33,30
2,39,4,2,19,17
2,39,5,0,20,20
2,39,6,2,14,12
2,40,0,0,34,34
2,40,1,2,28,26
2,40,2,5,39,34
2,40,3,3,22,19
2,40,4,1,21,20
2,40,5,1,14,13
2,40,6,0,11,11
2,41,0,1,37,36
2,41,1,0,34,34
2,41,2,1,41,40
2,41,3,3,39,36
2,41,4,1,31,30
2,41,5,1,14,13
2,41,6,0,7,7
2,42,0,3,40,37
2,42,1,0,52,52
2,42,2,2,37,35
2,42,3,5,52,47
2,42,4,1,30,29
2,42,5,0,13,13
2,42,6,0,16,16
2,43,0,0,82,82
2,43,1,0,77,77
2,43,2,2,78,76
2,43,3,4,73,69
2,43,4,0,48,48
2,43,5,0,24,24
2,43,6,1,23,22
2,44,0,1,85,84
2,44,1,0,77,77
2,44,2,2,84,82
2,44,3,4,77,73
2,44,4,2,75,73
2,44,5,0,29,29
2,44,6,1,36,35
2,45,0,2,105,103
2,45,1,0,97,97
2,45,2,3,102,99
2,45,3,1,96,95
2,45,4,1,64,63
2,45,5,1,47,46
2,45,6,1,29,28
2,46,0,7,124,117
2,46,1,2,86,84
2,46,2,1,96,95
2,46,3,3,124,121
2,46,4,0,78,78
2,46,5,0,59,59
2,46,6,1,43,42
2,47,0,6,90,84
2,47,1,3,99,96
2,47,2,2,104,102
2,47,3,2,115,113
2,47,4,0,70,70
2,47,5,0,55,55
2,47,6,0,57,57
2,48,0,0,100,100
2,48,1,3,96,93
2,48,2,1,115,114
2,48,3,1,129,128
2,48,4,9,93,84
2,48,5,0,53,53
2,48,6,1,62,61
2,49,0,7,147,140
2,49,1,1,139,138
2,49,2,2,129,127
2,49,3,0,130,130
2,49,4,1,84,83
2,49,5,1,73,72
2,49,6,2,66,64
2,50,0,1,123,122
2,50,1,3,101,98
2,50,2,4,123,119
2,50,3,3,128,125
2,50,4,2,77,75
2,50,5,0,47,47
2,50,6,1,52,51
2,51,0,0,52,52
2,51,1,0,76,76
2,51,2,3,69,66
2,51,3,1,86,85
2,51,4,3,70,67
2,51,5,1,51,50
2,51,6,0,51,51
2,52,0,4,69,65
2,52,1,1,62,61
2,52,2,0,79,79
2,52,3,3,77,74
2,52,4,1,70,69
2,52,5,1,65,64
2,52,6,1,53,52
2,53,0,4,63,59
2,53,1,1,71,70
2,53,2,0,50,50
2,53,3,2,76,74
2,53,4,2,49,47
2,53,5,0,45,45
2,53,6,1,37,36
2,54,0,3,63,60
2,54,1,0,61,61
2,54,2,0,58,58
2,54,3,0,48,48
2,54,4,3,52,49
2,54,5,0,47,47
2,54,6,0,35,35
2,55,0,2,60,58
2,55,1,0,49,49
2,55,2,2,58,56
2,55,3,0,51,51
2,55,4,2,52,50
2,55,5,2,59,57
2,55,6,3,61,58
2,56,0,0,63,63
2,56,1,0,57,57
2,56,2,11,75,64
2,56,3,4,69,65
2,56,4,3,44,41
2,56,5,2,35,33
2,56,6,2,62,60
2,57,0,2,63,61
2,57,1,0,45,45
2,57,2,1,47,46
2,57,3,0,47,47
2,57,4,1,51,50
2,57,5,0,35,35
2,57,6,1,36,35
2,58,0,2,47,45
2,58,1,4,62,58
2,58,2,3,60,57
2,58,3,1,40,39
2,58,4,0,44,44
2,58,5,0,48,48
2,58,6,2,50,48
2,59,0,1,37,36
2,59,1,0,50,50
2,59,2,0,42,42
2,59,3,2,55,53
2,59,4,0,53,53
2,59,5,3,61,58
2,59,6,1,52,51
2,60,0,2,47,45
2,60,1,0,42,42
2,60,2,0,36,36
2,60,3,2,42,40
2,60,4,3,49,46
2,60,5,0,47,47
2,60,6,1,50,49
2,61,0,0,42,42
2,61,1,0,43,43
2,61,2,0,40,40
2,61,3,2,45,43
2,61,4,0,49,49
2,61,5,2,44,42
2,61,6,0,41,41
2,62,0,1,53,52
2,62,1,0,39,39
2,62,2,2,48,46
2,62,3,1,37,36
2,62,4,0,48,48
2,62,5,3,53,50
2,62,6,1,53,52
2,63,0,0,42,42
2,63,1,0,51,51
2,63,2,1,42,41
2,63,3,0,43,43
2,63,4,1,46,45
2,63,5,0,50,50
2,63,6,0,39,39
2,64,0,2,55,53
2,64,1,0,54,54
2,64,2,1,53,52
2,64,3,2,47,45
2,64,4,6,60,54
2,64,5,2,47,45
2,64,6,1,74,73
2,65,0,0,49,49
2,65,1,0,36,36
2,65,2,0,35,35
2,65,3,0,42,42
2,65,4,2,42,40
2,65,5,0,59,59
2,65,6,0,59,59
2,66,0,2,62,60
2,66,1,2,32,30
2,66,2,1,49,48
2,66,3,1,44,43
2,66,4,2,48,46
2,66,5,0,47,47
2,66,6,0,57,57
2,67,0,2,53,51
2,67,1,2,60,58
2,67,2,0,39,39
2,67,3,0,60,60
2,67,4,1,49,48
2,67,5,1,69,68
2,67,6,1,61,60
2,68,0,0,61,61
2,68,1,2,58,56
2,68,2,1,67,66
2,68,3,1,50,49
2,68,4,0,50,50
2,68,5,0,63,63
2,68,6,1,70,69
2,69,0,1,51,50
2,69,1,0,53,53
2,69,2,2,54,52
2,69,3,1,50,49
2,69,4,0,43,43
2,69,5,2,61,59
2,69,6,3,67,64
2,70,0,1,63,62
2,70,1,2,46,44
2,70,2,2,52,50
2,70,3,2,57,55
2,70,4,0,70,70
2,70,5,0,57,57
2,70,6,1,50,49
2,71,0,5,62,57
2,71,1,3,59,56
2,71,2,0,57,57
2,71,3,2,57,55
2,71,4,1,49,48
2,71,5,1,51,50
2,71,6,0,62,62
2,72,0,2,40,38
2,72,1,0,41,41
2,72,2,0,49,49
2,72,3,2,68,66
2,72,4,0,49,49
2,72,5,2,52,50
2,72,6,1,67,66
2,73,0,1,69,68
2,73,1,2,52,50
2,73,2,1,59,58
2,73,3,2,60,58
2,73,4,0,49,49
2,73,5,2,58,56
2,73,6,1,65,64
2,74,0,0,56,56
2,74,1,0,41,41
2,74,2,1,56,55
2,74,3,1,59,58
2,74,4,2,62,60
2,74,5,2,54,52
2,74,6,4,86,82
2,75,0,0,55,55
2,75,1,0,46,46
2,75,2,0,47,47
2,75,3,3,54,51
2,75,4,2,67,65
2,75,5,0,62,62
2,75,6,0,79,79
2,76,0,4,59,55
2,76,1,0,57,57
2,76,2,0,53,53
2,76,3,13,77,64
2,76,4,0,74,74
2,76,5,2,72,70
2,76,6,3,73,70
2,77,0,0,43,43
2,77,1,3,58,55
2,77,2,1,61,60
2,77,3,1,62,61
2,77,4,1,59,58
2,77,5,1,88,87
2,77,6,0,65,65
2,78,0,0,61,61
2,78,1,1,53,52
2,78,2,0,43,43
2,78,3,1,58,57
2,78,4,1,66,65
2,78,5,5,52,47
2,78,6,2,80,78
2,79,0,2,69,67
2,79,1,3,74,71
2,79,2,1,61,60
2,79,3,3,55,52
2,79,4,1,62,61
2,79,5,2,75,73
2,79,6,2,89,87
2,80,0,3,51,48
2,80,1,0,42,42
2,80,2,0,58,58
2,80,3,1,64,63
2,80,4,1,57,56
2,80,5,4,53,49
2,80,6,1,94,93
2,81,0,3,73,70
2,81,1,1,52,51
2,81,2,3,56,53
2,81,3,0,82,82
2,81,4,2,58,56
2,81,5,1,57,56
2,81,6,1,78,77
2,82,0,2,65,63
2,82,1,0,57,57
2,82,2,1,69,68
2,82,3,0,74,74
2,82,4,3,67,64
2,82,5,1,68,67
2,82,6,0,81,81
2,83,0,0,48,48
2,83,1,1,53,52
2,83,2,2,57,55
2,83,3,0,53,53
2,83,4,1,66,65
2,83,5,1,63,62
2,83,6,2,66,64
2,84,0,1,65,64
2,84,1,1,51,50
2,84,2,0,56,56
2,84,3,1,53,52
2,84,4,3,84,81
2,84,5,2,60,58
2,84,6,0,71,71
2,85,0,1,64,63
2,85,1,4,52,48
2,85,2,0,51,51
2,85,3,1,60,59
2,85,4,4,69,65
2,85,5,2,63,61
2,85,6,1,59,58
2,86,0,1,60,59
2,86,1,1,52,51
2,86,2,1,55,54
2,86,3,0,51,51
2,86,4,2,54,52
2,86,5,2,81,79
2,86,6,0,78,78
2,87,0,1,67,66
2,87,1,0,51,51
2,87,2,2,60,58
2,87,3,1,55,54
2,87,4,7,69,62
2,87,5,2,66,64
2,87,6,3,80,77
2,88,0,0,48,48
2,88,1,1,56,55
2,88,2,0,57,57
2,88,3,0,50,50
2,88,4,0,68,68
2,88,5,2,57,55
2,88,6,2,61,59
2,89,0,2,49,47
2,89,1,0,64,64
2,89,2,1,81,80
2,89,3,2,54,52
2,89,4,1,67,66
2,89,5,2,79,77
2,89,6,2,81,79
2,90,0,1,57,56
2,90,1,4,64,60
2,90,2,2,83,81
2,90,3,0,66,66
2,90,4,1,60,59
2,90,5,1,48,47
2,90,6,0,89,89
2,91,0,1,59,58
2,91,1,3,66,63
2,91,2,0,77,77
2,91,3,6,61,55
2,91,4,2,68,66
2,91,5,2,58,56
2,91,6,2,65,63
2,92,0,1,57,56
2,92,1,2,52,50
2,92,2,1,71,70
2,92,3,1,66,65
2,92,4,0,61,61
2,92,5,3,68,65
2,92,6,1,91,90
2,93,0,2,70,68
2,93,1,1,67,66
2,93,2,1,105,104
2,93,3,3,65,62
2,93,4,5,81,76
2,93,5,2,61,59
2,93,6,5,92,87
2,94,0,7,98,91
2,94,1,1,100,99
2,94,2,4,85,81
2,94,3,2,92,90
2,94,4,9,104,95
2,94,5,2,60,58
2,94,6,2,97,95
2,95,0,1,81,80
2,95,1,8,82,74
2,95,2,0,80,80
2,95,3,2,74,72
2,95,4,11,99,88
2,95,5,2,87,85
2,95,6,2,118,116
2,96,0,0,79,79
2,96,1,10,83,73
2,96,2,3,80,77
2,96,3,3,89,86
2,96,4,13,98,85
2,96,5,7,100,93
2,96,6,0,101,101
2,97,0,0,80,80
2,97,1,2,76,74
2,97,2,5,100,95
2,97,3,7,107,100
2,97,4,10,98,88
2,97,5,8,139,131
2,97,6,5,103,98
2,98,0,5,86,81
2,98,1,16,104,88
2,98,2,3,83,80
2,98,3,5,103,98
2,98,4,3,84,81
2,98,5,5,107,102
2,98,6,6,97,91
2,99,0,2,80,78
2,99,1,7,119,112
2,99,2,2,127,125
2,99,3,1,109,108
2,99,4,1,75,74
2,99,5,4,87,83
2,99,6,2,99,97
2,100,0,0,87,87
2,100,1,5,96,91
2,100,2,3,108,105
2,100,3,16,125,109
2,100,4,0,111,111
2,100,5,6,94,88
2,100,6,1,96,95
2,101,0,1,109,108
2,101,1,3,130,127
2,101,2,0,131,131
2,101,3,5,128,123
2,101,4,3,136,133
2,101,5,5,101,96
2,101,6,7,136,129
2,102,0,3,125,122
2,102,1,18,150,132
2,102,2,3,133,130
2,102,3,4,171,167
2,102,4,1,136,135
2,102,5,3,124,121
2,102,6,2,137,135
2,103,0,1,105,104
2,103,1,1,103,102
2,103,2,5,123,118
2,103,3,4,126,122
2,103,4,4,161,157
2,103,5,1,89,88
2,103,6,7,121,114
2,104,0,4,117,113
2,104,1,5,107,102
2,104,2,4,116,112
2,104,3,1,113,112
2,104,4,4,119,115
2,104,5,2,87,85
2,104,6,6,114,108
2,105,0,1,104,103
2,105,1,4,113,109
2,105,2,1,91,90
2,105,3,0,114,114
2,105,4,3,93,90
2,105,5,1,88,87
2,105,6,0,99,99
2,106,0,0,88,88
2,106,1,2,79,77
2,106,2,1,84,83
2,106,3,4,124,120
2,106,4,5,100,95
2,106,5,2,85,83
2,106,6,1,107,106
2,107,0,2,70,68
2,107,1,1,78,77
2,107,2,4,104,100
2,107,3,5,96,91
2,107,4,3,91,88
2,107,5,4,87,83
2,107,6,0,69,69
2,108,0,0,72,72
2,108,1,3,76,73
2,108,2,1,90,89
2,108,3,0,81,81
2,108,4,1,101,100
2,108,5,3,94,91
2,108,6,1,86,85
2,109,0,2,71,69
2,109,1,2,85,83
2,109,2,2,82,80
2,109,3,2,97,95
2,109,4,1,89,88
2,109,5,4,105,101
2,109,6,1,100,99
2,110,0,2,97,95
2,110,1,2,91,89
2,110,2,2,116,114
2,110,3,6,84,78
2,110,4,2,93,91
2,110,5,2,76,74
2,110,6,0,97,97
2,111,0,2,87,85
2,111,1,6,103,97
2,111,2,4,95,91
2,111,3,2,94,92
2,111,4,7,105,98
2,111,5,1,98,97
2,111,6,4,95,91
2,112,0,0,90,90
2,112,1,3,99,96
2,112,2,2,84,82
2,112,3,6,81,75
2,112,4,6,113,107
2,112,5,7,123,116
2,112,6,4,85,81
2,113,0,0,77,77
2,113,1,8,94,86
2,113,2,4,87,83
2,113,3,7,98,91
2,113,4,2,90,88
2,113,5,3,94,91
2,113,6,4,84,80
2,114,0,1,58,57
2,114,1,2,58,56
2,114,2,6,102,96
2,114,3,3,73,70
2,114,4,1,78,77
2,114,5,3,99,96
2,114,6,3,86,83
2,115,0,4,70,66
2,115,1,0,80,80
2,115,2,0,76,76
2,115,3,1,79,78
2,115,4,1,88,87
2,115,5,3,85,82
2,115,6,0,80,80
2,116,0,1,63,62
2,116,1,0,64,64
2,116,2,3,88,85
2,116,3,2,65,63
2,116,4,1,94,93
2,116,5,4,77,73
2,116,6,1,89,88
2,117,0,3,85,82
2,117,1,5,86,81
2,117,2,0,76,76
2,117,3,1,81,80
2,117,4,2,81,79
2,117,5,3,87,84
2,117,6,2,78,76
2,118,0,1,71,70
2,118,1,3,78,75
2,118,2,4,64,60
2,118,3,3,109,106
2,118,4,2,102,100
2,118,5,3,94,91
2,118,6,1,72,71
2,119,0,1,69,68
2,119,1,2,65,63
2,119,2,5,76,71
2,119,3,0,82,82
2,119,4,6,97,91
2,119,5,3,78,75
2,119,6,2,56,54
2,120,0,2,79,77
2,120,1,1,97,96
2,120,2,3,77,74
2,120,3,1,69,68
2,120,4,4,95,91
2,120,5,2,77,75
2,120,6,3,71,68
2,121,0,1,68,67
2,121,1,0,63,63
2,121,2,0,78,78
2,121,3,2,96,94
2,121,4,3,83,80
2,121,5,1,69,68
2,121,6,2,63,61
2,122,0,2,80,78
2,122,1,1,65,64
2,122,2,2,99,97
2,122,3,2,74,72
2,122,4,3,82,79
2,122,5,4,76,72
2,122,6,3,66,63
2,123,0,0,78,78
2,123,1,6,78,72
2,123,2,2,79,77
2,123,3,6,91,85
2,123,4,0,68,68
2,123,5,2,74,72
2,123,6,0,59,59
2,124,0,4,79,75
2,124,1,5,88,83
2,124,2,2,75,73
2,124,3,4,67,63
2,124,4,0,68,68
2,124,5,4,74,70
2,124,6,1,63,62
2,125,0,6,87,81
2,125,1,5,73,68
2,125,2,5,71,66
2,125,3,1,77,76
2,125,4,1,78,77
2,125,5,4,82,78
2,125,6,1,60,59
2,126,0,0,84,84
2,126,1,0,86,86
2,126,2,1,70,69
2,126,3,3,100,97
2,126,4,1,100,99
2,126,5,4,100,96
2,126,6,0,77,77
2,127,0,0,74,74
2,127,1,3,54,51
2,127,2,5,58,53
2,127,3,4,80,76
2,127,4,1,66,65
2,127,5,6,83,77
2,127,6,1,48,47
2,128,0,2,60,58
2,128,1,1,59,58
2,128,2,2,75,73
2,128,3,2,77,75
2,128,4,0,66,66
2,128,5,9,89,80
2,128,6,1,65,64
2,129,0,1,70,69
2,129,1,2,68,66
2,129,2,1,66,65
2,129,3,4,67,63
2,129,4,1,80,79
2,129,5,5,86,81
2,129,6,1,57,56
2,130,0,0,54,54
2,130,1,2,44,42
2,130,2,0,71,71
2,130,3,7,71,64
2,130,4,2,70,68
2,130,5,2,67,65
2,130,6,1,42,41
2,131,0,4,56,52
2,131,1,1,42,41
2,131,2,3,54,51
2,131,3,4,63,59
2,131,4,0,58,58
2,131,5,3,55,52
2,131,6,0,49,49
2,132,0,2,51,49
2,132,1,9,58,49
2,132,2,4,53,49
2,132,3,4,66,62
2,132,4,0,74,74
2,132,5,4,88,84
2,132,6,2,54,52
2,133,0,0,45,45
2,133,1,2,50,48
2,133,2,0,48,48
2,133,3,1,41,40
2,133,4,2,61,59
2,133,5,15,82,67
2,133,6,3,57,54
2,134,0,0,46,46
2,134,1,1,46,45
2,134,2,0,38,38
2,134,3,3,37,34
2,134,4,4,49,45
2,134,5,6,55,49
2,134,6,2,48,46
2,135,0,3,39,36
2,135,1,2,46,44
2,135,2,0,42,42
2,135,3,1,55,54
2,135,4,2,47,45
2,135,5,0,66,66
2,135,6,0,45,45
2,136,0,2,29,27
2,136,1,1,37,36
2,136,2,1,43,42
2,136,3,6,49,43
2,136,4,2,33,31
2,136,5,0,43,43
2,136,6,0,36,36
2,137,0,2,35,33
2,137,1,1,31,30
2,137,2,0,34,34
2,137,3,2,45,43
2,137,4,1,40,39
2,137,5,0,52,52
2,137,6,1,27,26
2,138,0,0,18,18
2,138,1,1,29,28
2,138,2,1,43,42
2,138,3,1,53,52
2,138,4,1,34,33
2,138,5,0,48,48
2,138,6,0,32,32
2,139,0,1,27,26
2,139,1,5,39,34
2,139,2,3,34,31
2,139,3,1,29,28
2,139,4,2,44,42
2,139,5,1,35,34
2,139,6,1,24,23
2,140,0,3,31,28
2,140,1,0,31,31
2,140,2,0,31,31
2,140,3,1,30,29
2,140,4,6,44,38
2,140,5,2,40,38
2,140,6,4,50,46
2,141,0,1,18,17
2,141,1,2,38,36
2,141,2,1,30,29
2,141,3,0,22,22
2,141,4,3,58,55
2,141,5,1,33,32
2,141,6,1,36,35
2,142,0,2,21,19
2,142,1,1,29,28
2,142,2,0,19,19
2,142,3,2,27,25
2,142,4,4,30,26
2,142,5,3,47,44
2,142,6,0,38,38
2,143,0,0,20,20
2,143,1,1,27,26
2,143,2,1,23,22
2,143,3,1,39,38
2,143,4,0,32,32
2,143,5,0,32,32
2,143,6,0,25,25
3,0,0,0,2,2
3,0,1,0,2,2
3,0,2,2,2,0
3,0,4,1,3,2
3,0,5,1,1,0
3,0,6,2,3,1
3,1,0,4,4,0
3,1,1,1,2,1
3,1,2,0,1,1
3,1,3,1,1,0
3,1,4,0,1,1
3,1,5,0,2,2
3,1,6,0,1,1
3,2,0,0,1,1
3,2,1,0,1,1
3,2,2,2,2,0
3,2,3,4,5,1
3,2,4,4,6,2
3,2,5,0,2,2
3,2,6,0,2,2
3,3,0,1,2,1
3,3,1,0,1,1
3,3,2,1,1,0
3,3,3,6,7,1
3,3,4,4,6,2
3,3,6,1,2,1
3,4,0,2,3,1
3,4,2,1,2,1
3,4,3,2,3,1
3,4,4,2,2,0
3,4,5,3,4,1
3,4,6,0,2,2
3,5,0,3,4,1
3,5,2,1,2,1
3,5,3,8,9,1
3,5,4,0,3,3
3,5,5,2,5,3
3,5,6,2,4,2
3,6,0,1,4,3
3,6,1,1,1,0
3,6,3,2,4,2
3,6,4,0,1,1
3,6,6,4,4,0
3,7,0,2,2,0
3,7,2,1,1,0
3,7,5,2,3,1
3,7,6,1,2,1
3,8,0,1,1,0
3,8,3,2,2,0
3,8,4,0,2,2
3,8,5,0,1,1
3,9,2,2,4,2
3,9,4,0,1,1
3,9,5,0,1,1
3,10,0,0,1,1
3,10,1,0,1,1
3,10,4,2,4,2
3,10,6,1,1,0
3,11,4,0,2,2
3,11,5,0,1,1
3,11,6,1,2,1
3,12,0,1,1,0
3,12,4,2,3,1
3,12,6,1,3,2
3,13,1,0,1,1
3,13,4,0,1,1
3,13,5,0,2,2
3,13,6,1,2,1
3,14,0,0,2,2
3,14,1,0,3,3
3,14,3,0,1,1
3,14,6,0,1,1
3,15,1,0,2,2
3,15,2,0,1,1
3,15,6,0,1,1
3,16,2,0,1,1
3,16,4,0,1,1
3,16,5,0,2,2
3,17,0,0,1,1
3,17,2,0,1,1
3,17,5,1,1,0
3,18,0,1,1,0
3,18,2,1,1,0
3,18,4,0,1,1
3,19,0,0,1,1
3,19,1,1,1,0
3,19,2,1,2,1
3,19,3,4,4,0
3,20,3,3,3,0
3,20,4,0,1,1
3,21,2,0,1,1
3,21,4,1,1,0
3,22,2,1,1,0
3,22,6,1,1,0
3,23,3,0,1,1
3,24,1,0,1,1
3,24,3,0,1,1
3,24,6,2,2,0
3,25,0,1,1,0
3,25,4,1,1,0
3,25,6,1,1,0
3,26,0,1,1,0
3,26,3,4,4,0
3,27,0,2,2,0
3,27,3,1,1,0
3,28,0,3,3,0
3,28,1,0,1,1
3,28,3,0,1,1
3,29,0,1,1,0
3,29,4,2,2,0
3,30,2,0,1,1
3,31,3,0,1,1
3,31,5,1,1,0
3,33,3,0,1,1
3,33,4,2,3,1
3,34,3,1,2,1
3,34,4,0,1,1
3,34,5,0,1,1
3,35,2,2,2,0
3,35,3,0,1,1
3,35,5,1,1,0
3,36,3,0,2,2
3,36,4,1,1,0
3,37,0,1,2,1
3,37,1,0,1,1
3,37,2,0,1,1
3,37,4,1,2,1
3,37,5,2,2,0
3,38,0,0,1,1
3,38,1,1,1,0
3,38,2,1,4,3
3,38,3,3,5,2
3,38,4,1,1,0
3,38,5,3,3,0
3,38,6,1,1,0
3,39,0,2,5,3
3,39,1,0,2,2
3,39,2,1,6,5
3,39,3,1,3,2
3,39,4,3,3,0
3,39,5,3,4,1
3,39,6,2,4,2
3,40,0,1,7,6
3,40,1,0,2,2
3,40,2,0,2,2
3,40,3,1,6,5
3,40,4,1,3,2
3,40,5,0,3,3
3,40,6,0,3,3
3,41,0,4,11,7
3,41,1,0,5,5
3,41,2,0,3,3
3,41,3,0,4,4
3,41,4,0,3,3
3,41,5,0,2,2
3,41,6,0,2,2
3,42,0,2,10,8
3,42,1,0,5,5
3,42,2,2,8,6
3,42,3,0,9,9
3,42,4,2,4,2
3,42,5,1,4,3
3,42,6,0,4,4
3,43,0,5,16,11
3,43,1,0,10,10
3,43,2,3,12,9
3,43,3,0,9,9
3,43,4,1,9,8
3,43,5,0,4,4
3,43,6,1,6,5
3,44,0,3,15,12
3,44,1,1,20,19
3,44,2,3,24,21
3,44,3,1,8,7
3,44,4,2,21,19
3,44,5,1,12,11
3,44,6,3,7,4
3,45,0,6,18,12
3,45,1,0,15,15
3,45,2,0,21,21
3,45,3,6,27,21
3,45,4,6,14,8
3,45,5,0,13,13
3,45,6,3,13,10
3,46,0,0,8,8
3,46,1,1,11,10
3,46,2,2,15,13
3,46,3,5,20,15
3,46,4,3,16,13
3,46,5,0,10,10
3,46,6,2,11,9
3,47,0,3,12,9
3,47,1,1,11,10
3,47,2,6,18,12
3,47,3,5,21,16
3,47,4,12,24,12
3,47,5,0,11,11
3,47,6,0,7,7
3,48,0,7,17,10
3,48,1,6,21,15
3,48,2,5,20,15
3,48,3,5,18,13
3,48,4,6,18,12
3,48,5,0,10,10
3,48,6,2,10,8
3,49,0,16,28,12
3,49,1,3,20,17
3,49,2,2,14,12
3,49,3,5,23,18
3,49,4,5,10,5
3,49,5,2,9,7
3,49,6,2,7,5
3,50,0,15,30,15
3,50,1,4,11,7
3,50,2,13,19,6
3,50,3,2,10,8
3,50,4,5,19,14
3,50,5,0,16,16
3,50,6,2,10,8
3,51,0,8,24,16
3,51,1,4,20,16
3,51,2,15,32,17
3,51,3,1,16,15
3,51,4,3,15,12
3,51,5,2,12,10
3,51,6,1,16,15
3,52,0,4,15,11
3,52,1,7,19,12
3,52,2,1,23,22
3,52,3,2,18,16
3,52,4,4,16,12
3,52,5,4,21,17
3,52,6,2,9,7
3,53,0,9,19,10
3,53,1,1,14,13
3,53,2,0,11,11
3,53,3,7,29,22
3,53,4,1,9,8
3,53,5,1,10,9
3,53,6,8,21,13
3,54,0,1,8,7
3,54,1,3,11,8
3,54,2,0,6,6
3,54,3,5,17,12
3,54,4,0,9,9
3,54,5,0,8,8
3,54,6,1,14,13
3,55,0,1,6,5
3,55,1,1,11,10
3,55,2,0,9,9
3,55,3,9,16,7
3,55,4,2,12,10
3,55,5,1,10,9
3,55,6,9,19,10
3,56,0,3,15,12
3,56,1,4,20,16
3,56,2,2,13,11
3,56,3,8,14,6
3,56,4,5,14,9
3,56,5,1,11,10
3,56,6,3,13,10
3,57,0,0,10,10
3,57,1,0,11,11
3,57,2,6,19,13
3,57,3,5,11,6
3,57,4,2,5,3
3,57,5,0,8,8
3,57,6,1,9,8
3,58,0,1,5,4
3,58,1,5,10,5
3,58,2,3,13,10
3,58,3,3,10,7
3,58,4,7,14,7
3,58,5,1,4,3
3,58,6,1,8,7
3,59,0,7,13,6
3,59,1,6,15,9
3,59,2,4,10,6
3,59,3,4,18,14
3,59,4,2,8,6
3,59,5,1,10,9
3,59,6,0,6,6
3,60,0,4,12,8
3,60,1,3,10,7
3,60,2,4,11,7
3,60,3,1,9,8
3,60,4,8,16,8
3,60,5,1,10,9
3,60,6,3,15,12
3,61,0,0,7,7
3,61,1,9,18,9
3,61,2,1,5,4
3,61,3,4,11,7
3,61,4,1,7,6
3,61,5,0,3,3
3,61,6,1,6,5
3,62,0,4,9,5
3,62,1,1,12,11
3,62,2,2,15,13
3,62,3,8,14,6
3,62,4,10,14,4
3,62,5,1,4,3
3,62,6,3,11,8
3,63,0,4,10,6
3,63,1,1,5,4
3,63,2,4,18,14
3,63,3,10,14,4
3,63,4,10,17,7
3,63,5,1,10,9
3,63,6,4,11,7
3,64,0,5,9,4
3,64,1,1,3,2
3,64,2,3,7,4
3,64,3,2,8,6
3,64,4,6,14,8
3,64,5,2,8,6
3,64,6,2,10,8
3,65,0,3,10,7
3,65,1,4,10,6
3,65,2,0,2,2
3,65,3,7,14,7
3,65,4,8,18,10
3,65,5,0,3,3
3,65,6,5,15,10
3,66,0,1,7,6
3,66,1,5,9,4
3,66,2,3,8,5
3,66,3,1,9,8
3,66,4,5,11,6
3,66,5,2,8,6
3,66,6,0,11,11
3,67,0,3,9,6
3,67,1,5,11,6
3,67,2,6,12,6
3,67,3,1,4,3
3,67,4,24,32,8
3,67,5,6,10,4
3,67,6,4,11,7
3,68,0,4,9,5
3,68,1,9,13,4
3,68,2,5,8,3
3,68,3,3,6,3
3,68,4,7,15,8
3,68,5,7,14,7
3,68,6,3,10,7
3,69,0,3,6,3
3,69,1,0,3,3
3,69,2,1,6,5
3,69,3,2,8,6
3,69,4,4,8,4
3,69,5,3,11,8
3,69,6,1,10,9
3,70,0,7,15,8
3,70,1,11,16,5
3,70,2,5,9,4
3,70,3,3,10,7
3,70,4,6,12,6
3,70,5,1,6,5
3,70,6,10,15,5
3,71,0,0,7,7
3,71,1,3,7,4
3,71,2,4,6,2
3,71,3,1,3,2
3,71,4,3,9,6
3,71,5,4,19,15
3,71,6,8,24,16
3,72,0,0,8,8
3,72,1,1,5,4
3,72,2,4,13,9
3,72,3,0,2,2
3,72,4,9,15,6
3,72,5,2,11,9
3,72,6,2,12,10
3,73,0,1,13,12
3,73,1,2,8,6
3,73,2,6,15,9
3,73,3,3,6,3
3,73,4,5,12,7
3,73,5,10,23,13
3,73,6,3,15,12
3,74,0,2,8,6
3,74,1,1,10,9
3,74,2,3,10,7
3,74,3,0,4,4
3,74,4,8,13,5
3,74,5,2,8,6
3,74,6,1,9,8
3,75,0,1,5,4
3,75,1,5,11,6
3,75,2,3,11,8
3,75,3,1,8,7
3,75,4,2,16,14
3,75,5,6,17,11
3,75,6,1,12,11
3,76,0,3,9,6
3,76,1,10,15,5
3,76,2,12,20,8
3,76,3,5,12,7
3,76,4,6,15,9
3,76,5,3,15,12
3,76,6,0,6,6
3,77,0,2,8,6
3,77,1,3,9,6
3,77,2,1,10,9
3,77,3,3,10,7
3,77,4,1,12,11
3,77,5,6,13,7
3,77,6,0,12,12
3,78,0,3,5,2
3,78,1,4,13,9
3,78,2,5,18,13
3,78,3,2,16,14
3,78,4,3,8,5
3,78,5,2,15,13
3,78,6,2,10,8
3,79,0,6,15,9
3,79,1,2,7,5
3,79,2,2,15,13
3,79,3,4,14,10
3,79,4,5,13,8
3,79,5,0,11,11
3,79,6,3,10,7
3,80,0,9,17,8
3,80,1,3,11,8
3,80,2,5,11,6
3,80,3,0,5,5
3,80,4,3,14,11
3,80,5,4,17,13
3,80,6,0,10,10
3,81,0,4,11,7
3,81,1,3,9,6
3,81,2,10,15,5
3,81,3,4,10,6
3,81,4,1,9,8
3,81,5,4,20,16
3,81,6,3,11,8
3,82,0,5,11,6
3,82,1,2,5,3
3,82,2,2,10,8
3,82,3,5,17,12
3,82,4,3,11,8
3,82,5,4,14,10
3,82,6,1,5,4
3,83,0,6,12,6
3,83,1,2,4,2
3,83,2,6,10,4
3,83,3,9,14,5
3,83,4,6,14,8
3,83,5,3,12,9
3,83,6,2,13,11
3,84,0,8,15,7
3,84,1,9,17,8
3,84,2,5,9,4
3,84,3,9,17,8
3,84,4,7,12,5
3,84,5,0,12,12
3,84,6,1,14,13
3,85,0,5,13,8
3,85,1,5,14,9
3,85,2,3,11,8
3,85,3,5,16,11
3,85,4,5,11,6
3,85,5,2,10,8
3,85,6,1,9,8
3,86,0,0,4,4
3,86,1,0,9,9
3,86,2,4,6,2
3,86,3,1,9,8
3,86,4,1,8,7
3,86,5,1,11,10
3,86,6,0,3,3
3,87,0,2,7,5
3,87,1,2,9,7
3,87,2,3,6,3
3,87,3,5,10,5
3,87,4,5,10,5
3,87,5,3,7,4
3,87,6,3,14,11
3,88,0,1,5,4
3,88,1,0,6,6
3,88,2,1,8,7
3,88,3,4,12,8
3,88,4,1,6,5
3,88,5,3,14,11
3,88,6,1,17,16
3,89,0,0,5,5
3,89,1,1,11,10
3,89,2,11,19,8
3,89,3,2,9,7
3,89,4,1,8,7
3,89,5,1,5,4
3,89,6,5,15,10
3,90,0,1,8,7
3,90,1,1,5,4
3,90,2,4,13,9
3,90,3,0,7,7
3,90,4,1,8,7
3,90,5,5,12,7
3,90,6,1,9,8
3,91,0,1,7,6
3,91,1,0,14,14
3,91,2,3,10,7
3,91,3,3,6,3
3,91,4,2,9,7
3,91,5,4,12,8
3,91,6,2,12,10
3,92,0,2,5,3
3,92,1,4,11,7
3,92,2,0,5,5
3,92,3,0,6,6
3,92,4,2,8,6
3,92,5,1,4,3
3,92,6,1,10,9
3,93,0,0,4,4
3,93,1,0,3,3
3,93,2,4,13,9
3,93,3,0,7,7
3,93,4,0,11,11
3,93,5,3,13,10
3,93,6,3,16,13
3,94,0,0,11,11
3,94,1,1,10,9
3,94,2,2,12,10
3,94,3,2,12,10
3,94,4,2,11,9
3,94,5,2,12,10
3,94,6,1,12,11
3,95,0,4,9,5
3,95,1,1,6,5
3,95,2,0,8,8
3,95,3,1,16,15
3,95,4,1,14,13
3,95,5,6,14,8
3,95,6,4,8,4
3,96,0,3,13,10
3,96,1,1,11,10
3,96,2,0,5,5
3,96,3,0,14,14
3,96,4,0,13,13
3,96,5,1,18,17
3,96,6,0,13,13
3,97,0,1,15,14
3,97,1,0,11,11
3,97,2,0,10,10
3,97,3,0,9,9
3,97,4,2,9,7
3,97,5,1,10,9
3,97,6,2,15,13
3,98,0,0,8,8
3,98,1,0,3,3
3,98,2,1,5,4
3,98,3,1,12,11
3,98,4,1,8,7
3,98,5,2,12,10
3,98,6,0,13,13
3,99,0,0,14,14
3,99,1,0,7,7
3,99,2,0,6,6
3,99,3,0,10,10
3,99,4,4,16,12
3,99,5,0,15,15
3,99,6,2,16,14
3,100,0,3,11,8
3,100,1,1,11,10
3,100,2,1,7,6
3,100,3,1,10,9
3,100,4,1,15,14
3,100,5,0,14,14
3,100,6,5,15,10
3,101,0,3,16,13
3,101,1,2,11,9
3,101,2,6,12,6
3,101,3,0,10,10
3,101,4,0,11,11
3,101,5,3,16,13
3,101,6,2,12,10
3,102,0,0,14,14
3,102,1,6,29,23
3,102,2,1,20,19
3,102,3,1,8,7
3,102,4,2,10,8
3,102,5,2,19,17
3,102,6,2,14,12
3,103,0,2,14,12
3,103,1,5,29,24
3,103,2,8,22,14
3,103,3,4,14,10
3,103,4,4,17,13
3,103,5,2,13,11
3,103,6,1,15,14
3,104,0,3,17,14
3,104,1,1,12,11
3,104,2,5,15,10
3,104,3,8,23,15
3,104,4,9,23,14
3,104,5,2,14,12
3,104,6,1,12,11
3,105,0,1,10,9
3,105,1,3,17,14
3,105,2,9,28,19
3,105,3,2,20,18
3,105,4,0,17,17
3,105,5,2,15,13
3,105,6,0,10,10
3,106,0,0,11,11
3,106,1,0,14,14
3,106,2,0,16,16
3,106,3,0,14,14
3,106,4,0,13,13
3,106,5,0,10,10
3,106,6,1,5,4
3,107,0,3,12,9
3,107,1,0,11,11
3,107,2,1,8,7
3,107,3,0,11,11
3,107,4,6,19,13
3,107,5,1,15,14
3,107,6,0,4,4
3,108,0,1,8,7
3,108,1,1,3,2
3,108,2,1,14,13
3,108,3,3,13,10
3,108,4,7,14,7
3,108,5,2,7,5
3,108,6,0,9,9
3,109,0,1,13,12
3,109,1,2,6,4
3,109,2,0,10,10
3,109,3,0,12,12
3,109,4,6,13,7
3,109,5,0,8,8
3,109,6,1,14,13
3,110,0,2,19,17
3,110,1,3,9,6
3,110,2,1,11,10
3,110,3,2,12,10
3,110,4,1,16,15
3,110,5,2,16,14
3,110,6,3,10,7
3,111,0,1,7,6
3,111,1,0,14,14
3,111,2,0,10,10
3,111,3,2,12,10
3,111,4,0,7,7
3,111,5,1,17,16
3,111,6,2,11,9
3,112,0,0,13,13
3,112,1,2,9,7
3,112,2,0,7,7
3,112,3,0,7,7
3,112,4,1,11,10
3,112,5,1,15,14
3,112,6,2,10,8
3,113,0,0,7,7
3,113,1,0,11,11
3,113,2,1,10,9
3,113,3,0,9,9
3,113,4,1,9,8
3,113,5,1,13,12
3,113,6,1,15,14
3,114,0,3,10,7
3,114,1,1,11,10
3,114,2,2,8,6
3,114,3,1,7,6
3,114,4,0,11,11
3,114,5,4,14,10
3,114,6,2,20,18
3,115,0,1,13,12
3,115,1,1,9,8
3,115,2,2,8,6
3,115,3,2,8,6
3,115,4,4,15,11
3,115,5,2,14,12
3,115,6,2,12,10
3,116,0,2,9,7
3,116,1,1,8,7
3,116,2,4,9,5
3,116,3,0,12,12
3,116,4,3,10,7
3,116,5,4,13,9
3,116,6,0,8,8
3,117,0,2,9,7
3,117,1,0,2,2
3,117,2,6,11,5
3,117,3,0,9,9
3,117,4,1,10,9
3,117,5,3,12,9
3,117,6,1,5,4
3,118,0,3,7,4
3,118,1,0,6,6
3,118,2,1,6,5
3,118,3,3,17,14
3,118,4,1,10,9
3,118,5,3,12,9
3,118,6,3,14,11
3,119,0,1,8,7
3,119,1,0,10,10
3,119,2,2,10,8
3,119,3,0,8,8
3,119,4,0,4,4
3,119,5,0,4,4
3,119,6,5,12,7
3,120,0,0,4,4
3,120,1,0,7,7
3,120,2,2,10,8
3,120,3,0,8,8
3,120,4,0,10,10
3,120,5,5,13,8
3,120,6,2,10,8
3,121,0,0,7,7
3,121,1,1,11,10
3,121,2,0,4,4
3,121,3,0,8,8
3,121,4,1,15,14
3,121,5,4,13,9
3,121,6,1,7,6
3,122,0,1,3,2
3,122,1,2,10,8
3,122,2,4,10,6
3,122,3,0,8,8
3,122,4,1,7,6
3,122,5,2,7,5
3,122,6,2,11,9
3,123,0,0,6,6
3,123,1,2,7,5
3,123,2,5,15,10
3,123,3,3,4,1
3,123,4,3,10,7
3,123,5,2,9,7
3,123,6,1,7,6
3,124,0,3,4,1
3,124,1,0,10,10
3,124,2,3,11,8
3,124,3,3,11,8
3,124,4,3,9,6
3,124,5,0,5,5
3,124,6,3,12,9
3,125,0,1,8,7
3,125,1,0,10,10
3,125,2,3,8,5
3,125,3,5,15,10
3,125,4,1,4,3
3,125,5,4,10,6
3,125,6,1,7,6
3,126,0,2,10,8
3,126,1,0,7,7
3,126,2,1,8,7
3,126,3,0,5,5
3,126,4,0,5,5
3,126,5,0,7,7
3,126,6,2,5,3
3,127,0,3,10,7
3,127,1,2,6,4
3,127,2,1,5,4
3,127,3,5,12,7
3,127,4,3,11,8
3,127,5,3,6,3
3,127,6,3,12,9
3,128,0,6,16,10
3,128,1,2,6,4
3,128,2,1,4,3
3,128,3,5,12,7
3,128,4,2,5,3
3,128,5,0,3,3
3,128,6,1,6,5
3,129,0,1,5,4
3,129,1,0,8,8
3,129,2,0,3,3
3,129,3,0,3,3
3,129,4,2,8,6
3,129,5,3,14,11
3,129,6,1,8,7
3,130,0,4,11,7
3,130,1,0,6,6
3,130,2,1,3,2
3,130,3,1,7,6
3,130,4,4,9,5
3,130,5,2,8,6
3,130,6,1,7,6
3,131,0,2,7,5
3,131,1,0,5,5
3,131,2,0,5,5
3,131,3,1,4,3
3,131,4,2,7,5
3,131,5,2,7,5
3,131,6,0,4,4
3,132,0,1,8,7
3,132,1,0,7,7
3,132,2,1,4,3
3,132,4,0,7,7
3,132,5,1,6,5
3,132,6,1,10,9
3,133,0,4,6,2
3,133,1,4,8,4
3,133,2,1,2,1
3,133,3,3,7,4
3,133,4,0,7,7
3,133,5,3,5,2
3,133,6,1,6,5
3,134,0,3,8,5
3,134,1,2,11,9
3,134,2,0,4,4
3,134,3,1,2,1
3,134,4,0,7,7
3,134,5,1,2,1
3,134,6,3,11,8
3,135,0,1,4,3
3,135,1,0,7,7
3,135,2,1,4,3
3,135,3,2,7,5
3,135,4,5,12,7
3,135,5,0,1,1
3,135,6,0,3,3
3,136,0,1,5,4
3,136,1,1,7,6
3,136,2,1,7,6
3,136,3,3,12,9
3,136,4,4,14,10
3,136,5,0,2,2
3,136,6,1,5,4
3,137,0,1,4,3
3,137,1,2,7,5
3,137,2,2,6,4
3,137,3,0,5,5
3,137,4,1,4,3
3,137,5,1,6,5
3,137,6,2,5,3
3,138,0,4,6,2
3,138,1,0,1,1
3,138,2,0,2,2
3,138,3,1,8,7
3,138,4,0,5,5
3,138,5,5,5,0
3,138,6,1,1,0
3,139,0,0,3,3
3,139,1,0,1,1
3,139,2,2,4,2
3,139,3,2,4,2
3,139,4,1,2,1
3,139,5,4,7,3
3,139,6,2,6,4
3,140,0,1,2,1
3,140,1,1,4,3
3,140,2,3,4,1
3,140,3,0,4,4
3,140,4,4,10,6
3,140,5,2,5,3
3,140,6,7,10,3
3,141,0,0,2,2
3,141,1,3,5,2
3,141,2,0,1,1
3,141,3,1,6,5
3,141,4,1,3,2
3,141,5,1,6,5
3,141,6,1,4,3
3,142,0,4,8,4
3,142,1,1,2,1
3,142,2,0,1,1
3,142,3,4,6,2
3,142,4,2,3,1
3,142,5,2,4,2
3,142,6,0,1,1
3,143,0,1,2,1
3,143,1,0,1,1
3,143,2,0,1,1
3,143,3,0,1,1
3,143,4,0,6,6
3,143,5,1,2,1
4,0,0,1,41,40
4,0,1,4,58,54
4,0,2,7,60,53
4,0,3,3,54,51
4,0,4,11,61,50
4,0,5,3,45,42
4,0,6,4,59,55
4,1,0,4,54,50
4,1,1,6,41,35
4,1,2,2,46,44
4,1,3,4,48,44
4,1,4,5,76,71
4,1,5,2,73,71
4,1,6,7,73,66
4,2,0,8,52,44
4,2,1,3,35,32
4,2,2,4,47,43
4,2,3,1,46,45
4,2,4,5,97,92
4,2,5,4,51,47
4,2,6,4,38,34
4,3,0,1,35,34
4,3,1,5,43,38
4,3,2,3,29,26
4,3,3,5,37,32
4,3,4,7,67,60
4,3,5,2,37,35
4,3,6,4,52,48
4,4,0,2,27,25
4,4,1,0,20,20
4,4,2,6,44,38
4,4,3,7,31,24
4,4,4,0,45,45
4,4,5,7,43,36
4,4,6,2,43,41
4,5,0,3,24,21
4,5,1,0,23,23
4,5,2,12,37,25
4,5,3,9,47,38
4,5,4,3,43,40
4,5,5,3,45,42
4,5,6,4,51,47
4,6,0,1,27,26
4,6,1,4,25,21
4,6,2,10,32,22
4,6,3,2,22,20
4,6,4,1,37,36
4,6,5,8,48,40
4,6,6,10,60,50
4,7,0,3,19,16
4,7,1,0,21,21
4,7,2,4,21,17
4,7,3,4,22,18
4,7,4,1,48,47
4,7,5,0,25,25
4,7,6,13,50,37
4,8,0,4,19,15
4,8,1,7,27,20
4,8,2,0,18,18
4,8,3,5,29,24
4,8,4,0,36,36
4,8,5,1,22,21
4,8,6,8,35,27
4,9,0,2,19,17
4,9,1,1,16,15
4,9,2,5,24,19
4,9,3,3,17,14
4,9,4,0,37,37
4,9,5,5,26,21
4,9,6,0,21,21
4,10,0,1,18,17
4,10,1,3,18,15
4,10,2,4,28,24
4,10,3,0,14,14
4,10,4,1,25,24
4,10,5,0,19,19
4,10,6,2,29,27
4,11,0,4,28,24
4,11,1,3,18,15
4,11,2,3,13,10
4,11,3,2,11,9
4,11,4,3,34,31
4,11,5,4,23,19
4,11,6,4,22,18
4,12,0,14,30,16
4,12,1,1,20,19
4,12,2,2,15,13
4,12,3,2,16,14
4,12,4,2,27,25
4,12,5,10,33,23
4,12,6,1,23,22
4,13,0,4,20,16
4,13,1,9,24,15
4,13,2,8,25,17
4,13,3,8,23,15
4,13,4,1,22,21
4,13,5,9,44,35
4,13,6,3,22,19
4,14,0,3,19,16
4,14,1,2,18,16
4,14,2,1,12,11
4,14,3,0,10,10
4,14,4,1,25,24
4,14,5,6,36,30
4,14,6,4,24,20
4,15,0,1,12,11
4,15,1,6,11,5
4,15,2,8,20,12
4,15,3,1,6,5
4,15,4,2,27,25
4,15,5,1,13,12
4,15,6,4,19,15
4,16,0,2,9,7
4,16,1,4,16,12
4,16,2,1,13,12
4,16,3,5,19,14
4,16,4,3,19,16
4,16,5,0,7,7
4,16,6,2,17,15
4,17,0,4,10,6
4,17,1,2,10,8
4,17,2,5,12,7
4,17,3,5,9,4
4,17,4,0,10,10
4,17,5,5,14,9
4,17,6,0,11,11
4,18,0,1,8,7
4,18,1,8,12,4
4,18,2,1,13,12
4,18,3,4,10,6
4,18,4,2,16,14
4,18,5,1,15,14
4,18,6,2,7,5
4,19,0,2,6,4
4,19,1,0,5,5
4,19,2,0,8,8
4,19,3,5,13,8
4,19,4,3,22,19
4,19,5,1,10,9
4,19,6,3,12,9
4,20,0,0,2,2
4,20,1,1,6,5
4,20,2,1,6,5
4,20,3,0,6,6
4,20,4,1,12,11
4,20,5,2,8,6
4,20,6,1,7,6
4,21,0,1,5,4
4,21,1,3,5,2
4,21,2,1,8,7
4,21,3,6,14,8
4,21,4,6,14,8
4,21,5,2,12,10
4,21,6,8,17,9
4,22,0,1,3,2
4,22,1,1,4,3
4,22,2,2,10,8
4,22,3,0,4,4
4,22,4,4,10,6
4,22,5,2,4,2
4,22,6,3,10,7
4,23,0,2,6,4
4,23,1,0,3,3
4,23,2,1,4,3
4,23,3,1,9,8
4,23,4,5,13,8
4,23,5,1,6,5
4,23,6,0,5,5
4,24,0,0,3,3
4,24,1,1,5,4
4,24,2,2,7,5
4,24,3,2,5,3
4,24,4,0,5,5
4,24,5,2,6,4
4,24,6,0,5,5
4,25,0,2,6,4
4,25,1,6,8,2
4,25,2,1,8,7
4,25,3,2,5,3
4,25,4,2,9,7
4,25,5,1,6,5
4,25,6,1,5,4
4,26,0,1,4,3
4,26,1,4,6,2
4,26,2,4,9,5
4,26,3,1,4,3
4,26,4,5,10,5
4,26,5,1,6,5
4,26,6,2,3,1
4,27,0,4,6,2
4,27,1,3,8,5
4,27,2,4,6,2
4,27,3,2,4,2
4,27,4,4,5,1
4,27,5,1,9,8
4,27,6,0,1,1
4,28,0,10,11,1
4,28,1,1,4,3
4,28,2,4,10,6
4,28,3,1,2,1
4,28,4,2,4,2
4,28,5,5,11,6
4,28,6,1,6,5
4,29,0,0,1,1
4,29,1,0,2,2
4,29,2,1,6,5
4,29,3,0,2,2
4,29,4,0,6,6
4,29,5,4,9,5
4,29,6,2,7,5
4,30,0,0,1,1
4,30,1,1,4,3
4,30,2,1,3,2
4,30,3,1,8,7
4,30,4,0,3,3
4,30,5,2,6,4
4,30,6,0,2,2
4,31,0,1,4,3
4,31,1,1,1,0
4,31,2,2,7,5
4,31,3,2,5,3
4,31,4,8,14,6
4,31,5,2,7,5
4,31,6,2,10,8
4,32,0,7,11,4
4,32,1,3,4,1
4,32,2,0,5,5
4,32,3,2,4,2
4,32,4,15,19,4
4,32,5,0,4,4
4,32,6,2,6,4
4,33,0,4,6,2
4,33,1,3,10,7
4,33,2,1,4,3
4,33,3,6,10,4
4,33,4,20,26,6
4,33,5,6,15,9
4,33,6,7,10,3
4,34,0,11,14,3
4,34,1,5,10,5
4,34,2,3,9,6
4,34,3,12,15,3
4,34,4,23,28,5
4,34,5,0,3,3
4,34,6,0,8,8
4,35,0,11,11,0
4,35,1,9,13,4
4,35,2,8,12,4
4,35,3,4,11,7
4,35,4,36,42,6
4,35,5,5,12,7
4,35,6,3,11,8
4,36,0,10,16,6
4,36,1,12,19,7
4,36,2,5,13,8
4,36,3,18,26,8
4,36,4,25,33,8
4,36,5,11,17,6
4,36,6,4,9,5
4,37,0,6,12,6
4,37,1,14,22,8
4,37,2,11,13,2
4,37,3,10,21,11
4,37,4,30,33,3
4,37,5,6,10,4
4,37,6,8,14,6
4,38,0,11,29,18
4,38,1,8,22,14
4,38,2,9,17,8
4,38,3,13,29,16
4,38,4,26,32,6
4,38,5,9,18,9
4,38,6,6,17,11
4,39,0,2,48,46
4,39,1,0,21,21
4,39,2,3,28,25
4,39,3,3,34,31
4,39,4,32,60,28
4,39,5,5,24,19
4,39,6,9,27,18
4,40,0,5,40,35
4,40,1,2,38,36
4,40,2,6,40,34
4,40,3,0,28,28
4,40,4,15,39,24
4,40,5,12,28,16
4,40,6,2,20,18
4,41,0,9,60,51
4,41,1,1,35,34
4,41,2,2,42,40
4,41,3,1,33,32
4,41,4,7,39,32
4,41,5,8,34,26
4,41,6,3,28,25
4,42,0,6,87,81
4,42,1,2,85,83
4,42,2,0,76,76
4,42,3,1,72,71
4,42,4,10,60,50
4,42,5,12,51,39
4,42,6,3,22,19
4,43,0,5,131,126
4,43,1,6,90,84
4,43,2,2,91,89
4,43,3,8,92,84
4,43,4,39,105,66
4,43,5,6,58,52
4,43,6,4,37,33
4,44,0,8,139,131
4,44,1,5,131,126
4,44,2,10,149,139
4,44,3,11,140,129
4,44,4,31,136,105
4,44,5,14,64,50
4,44,6,23,55,32
4,45,0,26,197,171
4,45,1,9,167,158
4,45,2,10,175,165
4,45,3,28,190,162
4,45,4,30,130,100
4,45,5,6,96,90
4,45,6,19,77,58
4,46,0,72,258,186
4,46,1,8,187,179
4,46,2,13,206,193
4,46,3,49,213,164
4,46,4,15,152,137
4,46,5,7,88,81
4,46,6,27,92,65
4,47,0,103,326,223
4,47,1,28,244,216
4,47,2,58,259,201
4,47,3,61,268,207
4,47,4,29,202,173
4,47,5,12,112,100
4,47,6,23,89,66
4,48,0,214,426,212
4,48,1,105,357,252
4,48,2,127,403,276
4,48,3,63,314,251
4,48,4,95,296,201
4,48,5,22,113,91
4,48,6,29,104,75
4,49,0,285,528,243
4,49,1,202,466,264
4,49,2,259,535,276
4,49,3,118,404,286
4,49,4,119,344,225
4,49,5,23,142,119
4,49,6,24,122,98
4,50,0,309,597,288
4,50,1,301,602,301
4,50,2,269,549,280
4,50,3,149,462,313
4,50,4,177,427,250
4,50,5,10,117,107
4,50,6,16,128,112
4,51,0,304,578,274
4,51,1,374,693,319
4,51,2,308,624,316
4,51,3,212,523,311
4,51,4,163,397,234
4,51,5,45,170,125
4,51,6,22,133,111
4,52,0,350,617,267
4,52,1,324,599,275
4,52,2,270,565,295
4,52,3,224,523,299
4,52,4,178,377,199
4,52,5,30,169,139
4,52,6,38,127,89
4,53,0,277,573,296
4,53,1,243,591,348
4,53,2,155,508,353
4,53,3,203,546,343
4,53,4,128,374,246
4,53,5,11,136,125
4,53,6,14,107,93
4,54,0,215,537,322
4,54,1,189,538,349
4,54,2,96,429,333
4,54,3,192,552,360
4,54,4,94,378,284
4,54,5,10,145,135
4,54,6,21,132,111
4,55,0,241,551,310
4,55,1,191,530,339
4,55,2,136,451,315
4,55,3,195,525,330
4,55,4,100,360,260
4,55,5,8,144,136
4,55,6,6,104,98
4,56,0,187,453,266
4,56,1,214,499,285
4,56,2,160,462,302
4,56,3,145,466,321
4,56,4,73,324,251
4,56,5,8,146,138
4,56,6,7,103,96
4,57,0,184,377,193
4,57,1,220,408,188
4,57,2,183,379,196
4,57,3,215,439,224
4,57,4,112,259,147
4,57,5,24,149,125
4,57,6,6,132,126
4,58,0,117,306,189
4,58,1,150,326,176
4,58,2,179,381,202
4,58,3,124,327,203
4,58,4,99,260,161
4,58,5,22,134,112
4,58,6,19,119,100
4,59,0,96,238,142
4,59,1,90,265,175
4,59,2,111,283,172
4,59,3,76,262,186
4,59,4,69,234,165
4,59,5,14,161,147
4,59,6,18,143,125
4,60,0,36,161,125
4,60,1,37,187,150
4,60,2,57,191,134
4,60,3,28,200,172
4,60,4,75,204,129
4,60,5,10,142,132
4,60,6,18,135,117
4,61,0,26,146,120
4,61,1,30,176,146
4,61,2,25,169,144
4,61,3,22,153,131
4,61,4,78,186,108
4,61,5,13,129,116
4,61,6,15,129,114
4,62,0,10,115,105
4,62,1,22,135,113
4,62,2,14,118,104
4,62,3,7,118,111
4,62,4,81,210,129
4,62,5,17,157,140
4,62,6,15,148,133
4,63,0,6,116,110
4,63,1,5,117,112
4,63,2,8,106,98
4,63,3,7,114,107
4,63,4,96,207,111
4,63,5,16,150,134
4,63,6,8,124,116
4,64,0,6,110,104
4,64,1,5,94,89
4,64,2,10,119,109
4,64,3,5,112,107
4,64,4,73,171,98
4,64,5,21,153,132
4,64,6,12,123,111
4,65,0,3,109,106
4,65,1,5,96,91
4,65,2,5,86,81
4,65,3,6,116,110
4,65,4,56,157,101
4,65,5,16,157,141
4,65,6,9,128,119
4,66,0,4,91,87
4,66,1,8,106,98
4,66,2,13,114,101
4,66,3,5,88,83
4,66,4,54,150,96
4,66,5,16,174,158
4,66,6,15,144,129
4,67,0,12,110,98
4,67,1,6,99,93
4,67,2,3,96,93
4,67,3,4,97,93
4,67,4,41,135,94
4,67,5,14,139,125
4,67,6,25,158,133
4,68,0,9,118,109
4,68,1,5,111,106
4,68,2,13,115,102
4,68,3,13,114,101
4,68,4,50,156,106
4,68,5,21,147,126
4,68,6,45,188,143
4,69,0,9,103,94
4,69,1,6,100,94
4,69,2,15,111,96
4,69,3,11,97,86
4,69,4,75,190,115
4,69,5,32,173,141
4,69,6,27,166,139
4,70,0,8,91,83
4,70,1,13,117,104
4,70,2,9,101,92
4,70,3,18,118,100
4,70,4,51,153,102
4,70,5,26,178,152
4,70,6,17,160,143
4,71,0,11,121,110
4,71,1,8,110,102
4,71,2,14,108,94
4,71,3,17,120,103
4,71,4,57,169,112
4,71,5,22,155,133
4,71,6,18,156,138
4,72,0,15,121,106
4,72,1,4,103,99
4,72,2,11,121,110
4,72,3,21,158,137
4,72,4,75,220,145
4,72,5,14,156,142
4,72,6,8,156,148
4,73,0,10,118,108
4,73,1,12,108,96
4,73,2,12,141,129
4,73,3,26,143,117
4,73,4,51,171,120
4,73,5,45,207,162
4,73,6,26,167,141
4,74,0,17,140,123
4,74,1,14,142,128
4,74,2,12,124,112
4,74,3,5,123,118
4,74,4,46,175,129
4,74,5,41,195,154
4,74,6,19,175,156
4,75,0,14,135,121
4,75,1,19,114,95
4,75,2,9,110,101
4,75,3,9,127,118
4,75,4,51,158,107
4,75,5,30,194,164
4,75,6,14,159,145
4,76,0,7,110,103
4,76,1,23,130,107
4,76,2,29,142,113
4,76,3,13,132,119
4,76,4,29,144,115
4,76,5,25,159,134
4,76,6,15,160,145
4,77,0,4,138,134
4,77,1,17,140,123
4,77,2,13,127,114
4,77,3,21,139,118
4,77,4,46,163,117
4,77,5,49,207,158
4,77,6,19,153,134
4,78,0,14,128,114
4,78,1,22,158,136
4,78,2,19,151,132
4,78,3,30,164,134
4,78,4,47,164,117
4,78,5,81,234,153
4,78,6,23,183,160
4,79,0,16,136,120
4,79,1,19,136,117
4,79,2,34,133,99
4,79,3,29,144,115
4,79,4,60,191,131
4,79,5,77,234,157
4,79,6,31,206,175
4,80,0,18,132,114
4,80,1,38,176,138
4,80,2,49,191,142
4,80,3,59,184,125
4,80,4,68,209,141
4,80,5,69,225,156
4,80,6,31,192,161
4,81,0,19,139,120
4,81,1,40,164,124
4,81,2,46,166,120
4,81,3,56,208,152
4,81,4,55,202,147
4,81,5,56,226,170
4,81,6,33,195,162
4,82,0,9,107,98
4,82,1,47,174,127
4,82,2,38,157,119
4,82,3,42,152,110
4,82,4,81,211,130
4,82,5,83,262,179
4,82,6,27,197,170
4,83,0,11,127,116
4,83,1,26,128,102
4,83,2,32,148,116
4,83,3,32,150,118
4,83,4,81,212,131
4,83,5,71,233,162
4,83,6,38,212,174
4,84,0,14,143,129
4,84,1,13,130,117
4,84,2,20,155,135
4,84,3,35,170,135
4,84,4,81,198,117
4,84,5,43,241,198
4,84,6,24,211,187
4,85,0,12,115,103
4,85,1,19,118,99
4,85,2,34,135,101
4,85,3,14,144,130
4,85,4,67,185,118
4,85,5,31,229,198
4,85,6,30,221,191
4,86,0,8,107,99
4,86,1,6,104,98
4,86,2,15,121,106
4,86,3,8,130,122
4,86,4,54,191,137
4,86,5,30,224,194
4,86,6,22,225,203
4,87,0,9,110,101
4,87,1,7,136,129
4,87,2,8,124,116
4,87,3,17,143,126
4,87,4,93,237,144
4,87,5,42,238,196
4,87,6,39,253,214
4,88,0,12,128,116
4,88,1,7,113,106
4,88,2,13,144,131
4,88,3,10,118,108
4,88,4,82,219,137
4,88,5,34,210,176
4,88,6,26,233,207
4,89,0,7,130,123
4,89,1,7,123,116
4,89,2,11,109,98
4,89,3,9,113,104
4,89,4,45,182,137
4,89,5,36,218,182
4,89,6,27,225,198
4,90,0,6,128,122
4,90,1,9,107,98
4,90,2,9,114,105
4,90,3,7,126,119
4,90,4,44,184,140
4,90,5,17,212,195
4,90,6,21,215,194
4,91,0,28,139,111
4,91,1,16,141,125
4,91,2,18,137,119
4,91,3,10,117,107
4,91,4,114,234,120
4,91,5,10,184,174
4,91,6,21,229,208
4,92,0,22,149,127
4,92,1,17,137,120
4,92,2,45,171,126
4,92,3,25,151,126
4,92,4,106,248,142
4,92,5,29,238,209
4,92,6,23,224,201
4,93,0,7,144,137
4,93,1,3,132,129
4,93,2,14,159,145
4,93,3,3,141,138
4,93,4,12,185,173
4,93,5,26,227,201
4,93,6,9,210,201
4,94,0,6,121,115
4,94,1,18,147,129
4,94,2,23,173,150
4,94,3,4,128,124
4,94,4,12,182,170
4,94,5,26,218,192
4,94,6,22,232,210
4,95,0,4,147,143
4,95,1,20,166,146
4,95,2,17,132,115
4,95,3,3,143,140
4,95,4,8,160,152
4,95,5,43,245,202
4,95,6,24,222,198
4,96,0,7,141,134
4,96,1,4,147,143
4,96,2,8,161,153
4,96,3,5,145,140
4,96,4,5,155,150
4,96,5,4,229,225
4,96,6,4,228,224
4,97,0,7,139,132
4,97,1,1,126,125
4,97,2,11,154,143
4,97,3,8,150,142
4,97,4,10,174,164
4,97,5,3,240,237
4,97,6,6,219,213
4,98,0,6,134,128
4,98,1,2,180,178
4,98,2,2,151,149
4,98,3,5,154,149
4,98,4,7,179,172
4,98,5,9,190,181
4,98,6,11,216,205
4,99,0,9,132,123
4,99,1,5,146,141
4,99,2,10,171,161
4,99,3,6,127,121
4,99,4,7,195,188
4,99,5,16,224,208
4,99,6,9,253,244
4,100,0,4,136,132
4,100,1,8,153,145
4,100,2,21,187,166
4,100,3,8,170,162
4,100,4,5,171,166
4,100,5,7,208,201
4,100,6,16,227,211
4,101,0,8,157,149
4,101,1,6,159,153
4,101,2,9,190,181
4,101,3,9,171,162
4,101,4,8,184,176
4,101,5,1,209,208
4,101,6,4,213,209
4,102,0,7,191,184
4,102,1,9,222,213
4,102,2,15,213,198
4,102,3,3,208,205
4,102,4,9,224,215
4,102,5,7,221,214
4,102,6,2,191,189
4,103,0,7,182,175
4,103,1,6,192,186
4,103,2,20,220,200
4,103,3,6,181,175
4,103,4,14,207,193
4,103,5,7,234,227
4,103,6,7,183,176
4,104,0,16,220,204
4,104,1,5,194,189
4,104,2,25,210,185
4,104,3,7,219,212
4,104,4,8,187,179
4,104,5,12,218,206
4,104,6,5,221,216
4,105,0,7,203,196
4,105,1,6,189,183
4,105,2,13,231,218
4,105,3,5,219,214
4,105,4,13,219,206
4,105,5,6,246,240
4,105,6,4,223,219
4,106,0,6,178,172
4,106,1,4,222,218
4,106,2,27,238,211
4,106,3,5,188,183
4,106,4,17,200,183
4,106,5,5,206,201
4,106,6,16,248,232
4,107,0,5,184,179
4,107,1,7,188,181
4,107,2,31,249,218
4,107,3,8,189,181
4,107,4,8,197,189
4,107,5,6,191,185
4,107,6,4,212,208
4,108,0,7,242,235
4,108,1,8,260,252
4,108,2,48,281,233
4,108,3,15,249,234
4,108,4,15,259,244
4,108,5,10,232,222
4,108,6,10,207,197
4,109,0,6,215,209
4,109,1,9,237,228
4,109,2,57,293,236
4,109,3,5,203,198
4,109,4,27,257,230
4,109,5,8,216,208
4,109,6,1,216,215
4,110,0,6,234,228
4,110,1,8,225,217
4,110,2,13,235,222
4,110,3,8,209,201
4,110,4,38,284,246
4,110,5,8,215,207
4,110,6,3,190,187
4,111,0,6,221,215
4,111,1,11,207,196
4,111,2,20,218,198
4,111,3,12,201,189
4,111,4,24,230,206
4,111,5,6,212,206
4,111,6,5,193,188
4,112,0,6,179,173
4,112,1,7,192,185
4,112,2,9,209,200
4,112,3,9,204,195
4,112,4,24,243,219
4,112,5,10,239,229
4,112,6,4,204,200
4,113,0,5,180,175
4,113,1,7,193,186
4,113,2,17,208,191
4,113,3,9,180,171
4,113,4,18,206,188
4,113,5,3,194,191
4,113,6,11,184,173
4,114,0,21,214,193
4,114,1,11,218,207
4,114,2,11,199,188
4,114,3,7,157,150
4,114,4,37,248,211
4,114,5,6,194,188
4,114,6,6,203,197
4,115,0,22,183,161
4,115,1,7,177,170
4,115,2,22,229,207
4,115,3,12,199,187
4,115,4,53,262,209
4,115,5,5,207,202
4,115,6,4,194,190
4,116,0,21,218,197
4,116,1,9,194,185
4,116,2,35,224,189
4,116,3,4,176,172
4,116,4,49,233,184
4,116,5,6,188,182
4,116,6,8,189,181
4,117,0,25,212,187
4,117,1,11,214,203
4,117,2,35,218,183
4,117,3,11,190,179
4,117,4,47,275,228
4,117,5,7,179,172
4,117,6,7,219,212
4,118,0,42,223,181
4,118,1,15,204,189
4,118,2,20,203,183
4,118,3,14,208,194
4,118,4,50,255,205
4,118,5,3,156,153
4,118,6,8,193,185
4,119,0,40,227,187
4,119,1,7,191,184
4,119,2,25,210,185
4,119,3,14,197,183
4,119,4,31,209,178
4,119,5,8,223,215
4,119,6,7,212,205
4,120,0,7,220,213
4,120,1,6,211,205
4,120,2,12,228,216
4,120,3,10,228,218
4,120,4,15,235,220
4,120,5,8,254,246
4,120,6,6,235,229
4,121,0,14,211,197
4,121,1,11,240,229
4,121,2,19,244,225
4,121,3,6,205,199
4,121,4,13,260,247
4,121,5,6,234,228
4,121,6,15,229,214
4,122,0,5,200,195
4,122,1,7,235,228
4,122,2,9,233,224
4,122,3,8,217,209
4,122,4,9,243,234
4,122,5,13,248,235
4,122,6,11,243,232
4,123,0,6,234,228
4,123,1,6,244,238
4,123,2,13,223,210
4,123,3,7,216,209
4,123,4,9,256,247
4,123,5,8,256,248
4,123,6,15,238,223
4,124,0,9,177,168
4,124,1,12,224,212
4,124,2,11,240,229
4,124,3,7,186,179
4,124,4,9,228,219
4,124,5,9,219,210
4,124,6,10,233,223
4,125,0,8,183,175
4,125,1,9,198,189
4,125,2,13,227,214
4,125,3,11,221,210
4,125,4,8,243,235
4,125,5,13,255,242
4,125,6,15,230,215
4,126,0,9,198,189
4,126,1,4,199,195
4,126,2,10,223,213
4,126,3,16,225,209
4,126,4,21,268,247
4,126,5,8,237,229
4,126,6,6,210,204
4,127,0,10,155,145
4,127,1,3,164,161
4,127,2,16,232,216
4,127,3,12,205,193
4,127,4,12,229,217
4,127,5,13,217,204
4,127,6,6,196,190
4,128,0,19,191,172
4,128,1,13,192,179
4,128,2,16,231,215
4,128,3,22,208,186
4,128,4,25,250,225
4,128,5,7,215,208
4,128,6,9,208,199
4,129,0,17,179,162
4,129,1,28,213,185
4,129,2,15,202,187
4,129,3,13,176,163
4,129,4,12,247,235
4,129,5,26,244,218
4,129,6,12,165,153
4,130,0,9,143,134
4,130,1,18,171,153
4,130,2,14,184,170
4,130,3,14,170,156
4,130,4,27,249,222
4,130,5,21,243,222
4,130,6,8,185,177
4,131,0,15,154,139
4,131,1,11,188,177
4,131,2,12,206,194
4,131,3,12,166,154
4,131,4,16,223,207
4,131,5,42,244,202
4,131,6,10,178,168
4,132,0,5,143,138
4,132,1,8,185,177
4,132,2,10,198,188
4,132,3,14,195,181
4,132,4,17,266,249
4,132,5,63,269,206
4,132,6,3,153,150
4,133,0,5,135,130
4,133,1,5,149,144
4,133,2,10,146,136
4,133,3,15,141,126
4,133,4,24,243,219
4,133,5,37,218,181
4,133,6,5,144,139
4,134,0,3,83,80
4,134,1,3,87,84
4,134,2,6,117,111
4,134,3,4,122,118
4,134,4,6,153,147
4,134,5,33,160,127
4,134,6,0,84,84
4,135,0,5,90,85
4,135,1,4,87,83
4,135,2,7,115,108
4,135,3,9,112,103
4,135,4,9,155,146
4,135,5,6,169,163
4,135,6,2,118,116
4,136,0,5,88,83
4,136,1,1,88,87
4,136,2,7,83,76
4,136,3,14,102,88
4,136,4,7,124,117
4,136,5,3,114,111
4,136,6,1,94,93
4,137,0,7,75,68
4,137,1,1,63,62
4,137,2,3,79,76
4,137,3,1,76,75
4,137,4,7,114,107
4,137,5,3,116,113
4,137,6,4,72,68
4,138,0,1,59,58
4,138,1,3,64,61
4,138,2,1,74,73
4,138,3,8,63,55
4,138,4,5,91,86
4,138,5,7,104,97
4,138,6,2,85,83
4,139,0,5,65,60
4,139,1,4,63,59
4,139,2,2,66,64
4,139,3,6,63,57
4,139,4,2,63,61
4,139,5,3,68,65
4,139,6,2,64,62
4,140,0,1,51,50
4,140,1,8,65,57
4,140,2,2,42,40
4,140,3,7,65,58
4,140,4,5,50,45
4,140,5,4,69,65
4,140,6,2,67,65
4,141,0,3,51,48
4,141,1,4,54,50
4,141,2,3,54,51
4,141,3,2,57,55
4,141,4,4,73,69
4,141,5,5,76,71
4,141,6,2,58,56
4,142,0,2,49,47
4,142,1,5,49,44
4,142,2,3,64,61
4,142,3,4,47,43
4,142,4,1,83,82
4,142,5,8,65,57
4,142,6,2,47,45
4,143,0,1,52,51
4,143,1,8,65,57
4,143,2,7,60,53
4,143,3,10,56,46
4,143,4,9,78,69
4,143,5,5,65,60
4,143,6,2,44,42
5,0,0,1,2,1
5,0,1,1,2,1
5,0,2,1,2,1
5,0,4,0,1,1
5,0,6,2,3,1
5,1,0,3,6,3
5,1,1,0,2,2
5,1,2,2,3,1
5,1,3,0,2,2
5,1,4,1,1,0
5,1,5,2,2,0
5,2,0,0,1,1
5,2,3,1,2,1
5,2,4,0,2,2
5,2,5,1,2,1
5,2,6,1,3,2
5,3,0,1,2,1
5,3,1,0,1,1
5,3,3,0,1,1
5,3,4,1,4,3
5,3,5,0,1,1
5,4,1,0,1,1
5,4,2,0,1,1
5,4,3,0,1,1
5,4,4,0,1,1
5,5,0,0,1,1
5,5,1,2,3,1
5,5,3,3,3,0
5,5,5,3,5,2
5,6,4,0,2,2
5,7,3,1,2,1
5,7,6,0,1,1
5,8,5,0,1,1
5,8,6,0,1,1
5,9,2,2,2,0
5,9,3,1,1,0
5,9,6,1,1,0
5,10,0,2,2,0
5,10,3,1,1,0
5,10,5,0,1,1
5,10,6,1,1,0
5,11,0,0,1,1
5,11,1,1,1,0
5,11,3,1,2,1
5,12,1,1,1,0
5,12,2,0,1,1
5,12,3,1,1,0
5,12,6,2,2,0
5,13,6,3,3,0
5,14,4,3,3,0
5,14,6,0,1,1
5,15,4,1,1,0
5,17,6,1,1,0
5,18,3,6,6,0
5,18,4,0,1,1
5,18,6,1,1,0
5,19,3,1,1,0
5,19,4,1,1,0
5,19,6,1,1,0
5,20,1,2,2,0
5,20,3,1,3,2
5,20,4,3,4,1
5,21,1,1,1,0
5,21,3,1,1,0
5,22,3,0,1,1
5,22,5,1,1,0
5,23,5,1,1,0
5,26,2,2,2,0
5,27,1,3,3,0
5,27,2,2,2,0
5,28,1,1,2,1
5,28,2,1,1,0
5,29,6,0,1,1
5,30,5,0,1,1
5,31,0,2,2,0
5,32,0,2,2,0
5,34,1,1,1,0
5,34,4,1,1,0
5,36,2,1,1,0
5,37,0,1,1,0
5,37,2,1,2,1
5,37,4,4,4,0
5,38,0,3,3,0
5,38,1,0,1,1
5,38,5,0,1,1
5,38,6,1,2,1
5,39,1,0,2,2
5,39,2,0,1,1
5,39,3,0,2,2
5,39,5,4,4,0
5,39,6,0,1,1
5,40,1,0,1,1
5,40,2,0,3,3
5,40,3,0,2,2
5,40,4,1,2,1
5,40,5,2,2,0
5,40,6,0,2,2
5,41,0,1,4,3
5,41,1,0,1,1
5,41,2,0,3,3
5,41,3,1,3,2
5,41,4,1,2,1
5,41,6,2,3,1
5,42,0,0,1,1
5,42,1,0,3,3
5,42,2,2,8,6
5,42,3,0,4,4
5,42,4,1,3,2
5,42,5,1,5,4
5,42,6,0,1,1
5,43,0,0,2,2
5,43,1,0,8,8
5,43,3,0,3,3
5,43,4,2,5,3
5,43,5,0,5,5
5,43,6,2,4,2
5,44,0,1,3,2
5,44,1,2,5,3
5,44,2,0,8,8
5,44,3,1,3,2
5,44,4,0,1,1
5,44,5,1,7,6
5,44,6,2,2,0
5,45,0,0,4,4
5,45,1,0,4,4
5,45,2,0,11,11
5,45,3,0,6,6
5,45,4,3,9,6
5,45,5,3,7,4
5,45,6,0,6,6
5,46,0,2,4,2
5,46,1,1,6,5
5,46,2,5,9,4
5,46,3,1,7,6
5,46,4,3,4,1
5,46,5,0,3,3
5,46,6,1,5,4
5,47,0,9,18,9
5,47,1,3,8,5
5,47,2,5,9,4
5,47,3,1,14,13
5,47,4,0,6,6
5,47,5,2,10,8
5,47,6,0,4,4
5,48,0,1,11,10
5,48,1,9,20,11
5,48,2,3,15,12
5,48,3,7,14,7
5,48,4,7,15,8
5,48,5,3,18,15
5,48,6,1,8,7
5,49,0,1,8,7
5,49,1,2,17,15
5,49,2,5,10,5
5,49,3,5,13,8
5,49,4,3,10,7
5,49,5,3,7,4
5,49,6,4,9,5
5,50,0,5,10,5
5,50,1,4,9,5
5,50,2,6,11,5
5,50,3,1,4,3
5,50,4,5,9,4
5,50,5,3,9,6
5,50,6,0,9,9
5,51,0,8,16,8
5,51,1,7,16,9
5,51,2,4,11,7
5,51,3,2,9,7
5,51,4,3,17,14
5,51,5,3,11,8
5,51,6,0,6,6
5,52,0,11,16,5
5,52,1,19,22,3
5,52,2,3,6,3
5,52,3,1,8,7
5,52,4,1,6,5
5,52,5,2,12,10
5,52,6,2,11,9
5,53,0,7,12,5
5,53,1,5,13,8
5,53,2,2,7,5
5,53,3,3,8,5
5,53,4,1,10,9
5,53,5,2,8,6
5,53,6,1,11,10
5,54,0,2,9,7
5,54,1,0,5,5
5,54,2,7,15,8
5,54,3,2,4,2
5,54,4,3,7,4
5,54,5,5,15,10
5,54,6,0,6,6
5,55,0,1,6,5
5,55,1,5,10,5
5,55,2,8,19,11
5,55,3,8,11,3
5,55,4,4,16,12
5,55,5,5,11,6
5,55,6,1,3,2
5,56,0,5,7,2
5,56,1,11,17,6
5,56,2,7,10,3
5,56,3,6,15,9
5,56,4,11,23,12
5,56,5,5,13,8
5,56,6,6,13,7
5,57,0,7,10,3
5,57,1,9,13,4
5,57,2,2,7,5
5,57,3,4,10,6
5,57,4,8,11,3
5,57,5,10,16,6
5,57,6,3,10,7
5,58,0,11,12,1
5,58,1,11,21,10
5,58,2,5,11,6
5,58,3,6,9,3
5,58,4,13,19,6
5,58,5,9,22,13
5,58,6,9,18,9
5,59,0,4,8,4
5,59,1,4,7,3
5,59,2,5,13,8
5,59,3,9,14,5
5,59,4,3,10,7
5,59,5,2,7,5
5,59,6,3,14,11
5,60,0,1,6,5
5,60,1,7,14,7
5,60,2,1,1,0
5,60,3,6,12,6
5,60,4,3,12,9
5,60,5,1,11,10
5,60,6,1,5,4
5,61,0,6,13,7
5,61,1,5,12,7
5,61,2,4,8,4
5,61,3,6,14,8
5,61,4,3,4,1
5,61,5,3,11,8
5,61,6,2,7,5
5,62,0,5,13,8
5,62,1,4,11,7
5,62,2,6,14,8
5,62,3,3,6,3
5,62,4,6,9,3
5,62,5,4,11,7
5,62,6,11,20,9
5,63,0,5,9,4
5,63,1,7,16,9
5,63,2,6,10,4
5,63,3,3,10,7
5,63,4,9,18,9
5,63,5,5,19,14
5,63,6,11,20,9
5,64,0,2,7,5
5,64,1,0,8,8
5,64,2,1,8,7
5,64,3,3,10,7
5,64,4,2,10,8
5,64,5,5,11,6
5,64,6,5,12,7
5,65,0,6,13,7
5,65,1,0,5,5
5,65,2,1,6,5
5,65,3,3,7,4
5,65,4,8,17,9
5,65,5,4,13,9
5,65,6,9,20,11
5,66,0,3,7,4
5,66,1,5,14,9
5,66,2,8,13,5
5,66,3,4,10,6
5,66,4,15,19,4
5,66,5,3,12,9
5,66,6,1,17,16
5,67,0,4,8,4
5,67,1,1,7,6
5,67,2,7,12,5
5,67,3,1,11,10
5,67,4,8,14,6
5,67,5,3,10,7
5,67,6,4,11,7
5,68,0,5,10,5
5,68,1,0,6,6
5,68,2,2,14,12
5,68,3,4,14,10
5,68,4,13,16,3
5,68,5,1,8,7
5,68,6,5,17,12
5,69,0,2,6,4
5,69,1,1,6,5
5,69,2,6,14,8
5,69,3,1,5,4
5,69,4,7,16,9
5,69,5,3,13,10
5,69,6,7,14,7
5,70,0,3,6,3
5,70,1,5,13,8
5,70,2,4,14,10
5,70,3,6,11,5
5,70,4,7,13,6
5,70,5,4,20,16
5,70,6,3,15,12
5,71,0,4,13,9
5,71,1,10,14,4
5,71,2,3,13,10
5,71,3,4,9,5
5,71,4,9,15,6
5,71,5,8,20,12
5,71,6,9,22,13
5,72,0,7,12,5
5,72,1,23,32,9
5,72,2,4,22,18
5,72,3,6,13,7
5,72,4,11,21,10
5,72,5,7,27,20
5,72,6,6,18,12
5,73,0,12,17,5
5,73,1,12,17,5
5,73,2,5,11,6
5,73,3,10,15,5
5,73,4,10,24,14
5,73,5,12,24,12
5,73,6,7,26,19
5,74,0,10,19,9
5,74,1,5,13,8
5,74,2,6,14,8
5,74,3,8,18,10
5,74,4,15,24,9
5,74,5,10,23,13
5,74,6,6,18,12
5,75,0,16,28,12
5,75,1,6,10,4
5,75,2,11,20,9
5,75,3,14,22,8
5,75,4,10,24,14
5,75,5,6,14,8
5,75,6,3,16,13
5,76,0,16,23,7
5,76,1,4,10,6
5,76,2,3,13,10
5,76,3,10,13,3
5,76,4,1,12,11
5,76,5,4,16,12
5,76,6,7,22,15
5,77,0,8,13,5
5,77,1,2,9,7
5,77,2,13,25,12
5,77,3,7,16,9
5,77,4,7,14,7
5,77,5,8,25,17
5,77,6,3,24,21
5,78,0,3,13,10
5,78,1,14,20,6
5,78,2,20,35,15
5,78,3,11,19,8
5,78,4,5,10,5
5,78,5,2,8,6
5,78,6,0,9,9
5,79,0,4,7,3
5,79,1,7,13,6
5,79,2,8,19,11
5,79,3,0,10,10
5,79,4,5,20,15
5,79,5,1,16,15
5,79,6,12,27,15
5,80,0,5,13,8
5,80,1,3,13,10
5,80,2,8,13,5
5,80,3,1,11,10
5,80,4,4,14,10
5,80,5,5,18,13
5,80,6,4,12,8
5,81,0,6,18,12
5,81,1,4,9,5
5,81,2,4,17,13
5,81,3,5,15,10
5,81,4,1,12,11
5,81,5,10,25,15
5,81,6,6,24,18
5,82,0,7,12,5
5,82,1,5,10,5
5,82,2,5,15,10
5,82,3,2,6,4
5,82,4,9,16,7
5,82,5,2,14,12
5,82,6,6,18,12
5,83,0,3,9,6
5,83,1,0,4,4
5,83,2,2,13,11
5,83,3,2,4,2
5,83,4,7,16,9
5,83,5,3,13,10
5,83,6,2,15,13
5,84,0,6,9,3
5,84,1,4,10,6
5,84,2,0,7,7
5,84,3,5,11,6
5,84,4,7,17,10
5,84,5,3,18,15
5,84,6,5,21,16
5,85,0,16,21,5
5,85,1,4,15,11
5,85,2,0,13,13
5,85,3,0,4,4
5,85,4,11,24,13
5,85,5,5,13,8
5,85,6,4,16,12
5,86,0,1,15,14
5,86,1,2,6,4
5,86,2,3,13,10
5,86,3,0,10,10
5,86,4,7,12,5
5,86,5,5,16,11
5,86,6,9,23,14
5,87,0,4,18,14
5,87,1,1,7,6
5,87,2,6,12,6
5,87,3,2,5,3
5,87,4,3,15,12
5,87,5,1,9,8
5,87,6,4,10,6
5,88,0,2,10,8
5,88,1,3,12,9
5,88,2,4,10,6
5,88,3,1,11,10
5,88,4,2,12,10
5,88,5,0,9,9
5,88,6,0,12,12
5,89,0,5,16,11
5,89,1,2,15,13
5,89,2,7,17,10
5,89,3,12,22,10
5,89,4,3,7,4
5,89,5,0,7,7
5,89,6,2,15,13
5,90,0,2,11,9
5,90,1,2,8,6
5,90,2,3,14,11
5,90,3,7,17,10
5,90,4,0,16,16
5,90,5,1,9,8
5,90,6,4,10,6
5,91,0,1,13,12
5,91,1,2,12,10
5,91,2,5,10,5
5,91,3,5,16,11
5,91,4,2,10,8
5,91,5,4,10,6
5,91,6,5,15,10
5,92,0,1,7,6
5,92,1,0,14,14
5,92,2,6,23,17
5,92,3,3,15,12
5,92,4,4,21,17
5,92,5,1,9,8
5,92,6,1,13,12
5,93,0,0,5,5
5,93,1,0,6,6
5,93,2,0,17,17
5,93,3,2,11,9
5,93,4,0,13,13
5,93,5,1,13,12
5,93,6,2,10,8
5,94,0,0,5,5
5,94,1,0,8,8
5,94,2,1,12,11
5,94,3,3,24,21
5,94,4,0,15,15
5,94,5,4,11,7
5,94,6,1,17,16
5,95,0,0,10,10
5,95,1,0,13,13
5,95,2,2,18,16
5,95,3,1,16,15
5,95,4,1,12,11
5,95,5,1,15,14
5,95,6,3,12,9
5,96,0,0,15,15
5,96,1,2,18,16
5,96,2,3,21,18
5,96,3,2,16,14
5,96,4,1,11,10
5,96,5,0,18,18
5,96,6,4,14,10
5,97,0,0,8,8
5,97,1,0,7,7
5,97,2,1,23,22
5,97,3,0,14,14
5,97,4,1,16,15
5,97,5,0,8,8
5,97,6,2,20,18
5,98,0,0,12,12
5,98,1,0,15,15
5,98,2,1,13,12
5,98,3,1,10,9
5,98,4,3,17,14
5,98,5,0,16,16
5,98,6,1,9,8
5,99,0,0,18,18
5,99,1,2,18,16
5,99,2,1,18,17
5,99,3,1,22,21
5,99,4,1,11,10
5,99,5,3,19,16
5,99,6,0,8,8
5,100,0,2,20,18
5,100,1,0,19,19
5,100,2,1,15,14
5,100,3,1,16,15
5,100,4,1,18,17
5,100,5,2,18,16
5,100,6,1,9,8
5,101,0,0,12,12
5,101,1,1,22,21
5,101,2,2,14,12
5,101,3,0,17,17
5,101,4,1,22,21
5,101,5,1,14,13
5,101,6,1,14,13
5,102,0,4,22,18
5,102,1,0,21,21
5,102,2,1,24,23
5,102,3,3,19,16
5,102,4,1,21,20
5,102,5,1,16,15
5,102,6,3,15,12
5,103,0,7,27,20
5,103,1,0,26,26
5,103,2,1,17,16
5,103,3,1,18,17
5,103,4,1,24,23
5,103,5,0,21,21
5,103,6,1,16,15
5,104,0,0,16,16
5,104,1,1,19,18
5,104,2,1,28,27
5,104,3,2,25,23
5,104,4,2,22,20
5,104,5,1,23,22
5,104,6,0,21,21
5,105,0,1,24,23
5,105,1,1,16,15
5,105,2,1,23,22
5,105,3,2,21,19
5,105,4,5,30,25
5,105,5,1,20,19
5,105,6,0,16,16
5,106,0,3,21,18
5,106,1,1,13,12
5,106,2,1,20,19
5,106,3,2,15,13
5,106,4,1,13,12
5,106,5,0,15,15
5,106,6,2,11,9
5,107,0,3,18,15
5,107,1,0,10,10
5,107,2,0,23,23
5,107,3,1,16,15
5,107,4,1,16,15
5,107,5,1,18,17
5,107,6,1,15,14
5,108,0,1,13,12
5,108,1,0,15,15
5,108,2,4,25,21
5,108,3,1,18,17
5,108,4,2,15,13
5,108,5,1,14,13
5,108,6,2,18,16
5,109,0,0,11,11
5,109,1,4,18,14
5,109,2,1,21,20
5,109,3,0,16,16
5,109,4,0,12,12
5,109,5,2,21,19
5,109,6,0,8,8
5,110,0,0,6,6
5,110,1,4,23,19
5,110,2,0,14,14
5,110,3,0,14,14
5,110,4,3,20,17
5,110,5,1,13,12
5,110,6,1,14,13
5,111,0,0,7,7
5,111,1,2,18,16
5,111,2,0,13,13
5,111,3,1,8,7
5,111,4,4,19,15
5,111,5,3,23,20
5,111,6,1,17,16
5,112,0,1,7,6
5,112,1,3,13,10
5,112,2,0,4,4
5,112,3,0,13,13
5,112,4,2,15,13
5,112,5,3,16,13
5,112,6,3,18,15
5,113,0,1,12,11
5,113,1,0,16,16
5,113,2,0,11,11
5,113,3,1,13,12
5,113,4,2,11,9
5,113,5,0,10,10
5,113,6,1,12,11
5,114,0,5,11,6
5,114,1,1,8,7
5,114,2,2,8,6
5,114,3,0,9,9
5,114,4,9,18,9
5,114,5,2,11,9
5,114,6,2,14,12
5,115,0,0,8,8
5,115,1,0,10,10
5,115,2,1,12,11
5,115,3,1,9,8
5,115,4,1,12,11
5,115,5,2,9,7
5,115,6,4,17,13
5,116,0,0,10,10
5,116,1,0,7,7
5,116,2,0,14,14
5,116,3,0,4,4
5,116,4,2,15,13
5,116,5,2,10,8
5,116,6,0,8,8
5,117,0,0,7,7
5,117,1,1,9,8
5,117,2,3,9,6
5,117,3,1,12,11
5,117,4,4,13,9
5,117,5,3,12,9
5,117,6,0,6,6
5,118,0,0,9,9
5,118,1,0,8,8
5,118,2,4,16,12
5,118,3,0,5,5
5,118,4,4,13,9
5,118,5,0,4,4
5,118,6,0,5,5
5,119,0,1,10,9
5,119,1,0,4,4
5,119,2,0,4,4
5,119,3,0,5,5
5,119,4,5,11,6
5,119,5,2,7,5
5,119,6,1,11,10
5,120,0,1,8,7
5,120,1,5,14,9
5,120,2,0,10,10
5,120,3,1,7,6
5,120,4,5,20,15
5,120,5,1,11,10
5,120,6,0,6,6
5,121,1,1,9,8
5,121,2,2,13,11
5,121,3,1,10,9
5,121,4,1,8,7
5,121,5,2,8,6
5,121,6,0,7,7
5,122,0,0,5,5
5,122,1,1,9,8
5,122,2,1,8,7
5,122,3,3,8,5
5,122,4,0,8,8
5,122,5,1,6,5
5,122,6,0,6,6
5,123,0,1,3,2
5,123,1,0,6,6
5,123,2,1,9,8
5,123,3,2,6,4
5,123,4,0,7,7
5,123,5,0,11,11
5,123,6,2,5,3
5,124,0,2,7,5
5,124,1,1,10,9
5,124,2,0,6,6
5,124,3,1,11,10
5,124,4,0,8,8
5,124,5,1,6,5
5,124,6,0,5,5
5,125,0,0,5,5
5,125,1,1,10,9
5,125,2,0,9,9
5,125,3,0,7,7
5,125,4,0,7,7
5,125,5,2,8,6
5,125,6,2,4,2
5,126,0,2,5,3
5,126,1,0,4,4
5,126,2,6,15,9
5,126,3,1,8,7
5,126,4,2,9,7
5,126,5,0,6,6
5,126,6,5,15,10
5,127,0,2,9,7
5,127,1,5,20,15
5,127,2,1,11,10
5,127,3,0,4,4
5,127,4,2,14,12
5,127,5,0,6,6
5,127,6,0,7,7
5,128,0,9,17,8
5,128,1,0,7,7
5,128,2,0,5,5
5,128,3,0,5,5
5,128,4,0,6,6
5,128,5,1,11,10
5,128,6,0,6,6
5,129,0,1,7,6
5,129,1,0,4,4
5,129,2,0,9,9
5,129,3,0,4,4
5,129,4,1,6,5
5,129,5,1,5,4
5,129,6,1,2,1
5,130,0,2,9,7
5,130,1,0,1,1
5,130,2,1,5,4
5,130,3,0,3,3
5,130,4,0,6,6
5,130,5,0,10,10
5,130,6,1,6,5
5,131,0,0,4,4
5,131,1,2,10,8
5,131,2,1,11,10
5,131,3,0,4,4
5,131,4,0,5,5
5,131,5,1,7,6
5,131,6,1,4,3
5,132,0,0,4,4
5,132,1,1,4,3
5,132,2,0,9,9
5,132,3,1,3,2
5,132,4,2,9,7
5,132,5,1,5,4
5,132,6,0,3,3
5,133,0,1,6,5
5,133,1,0,1,1
5,133,2,0,7,7
5,133,3,3,7,4
5,133,4,0,1,1
5,133,5,0,1,1
5,134,0,0,4,4
5,134,1,1,6,5
5,134,2,2,2,0
5,134,3,2,6,4
5,134,5,0,2,2
5,134,6,2,7,5
5,135,0,1,2,1
5,135,1,1,5,4
5,135,2,0,3,3
5,135,3,0,2,2
5,135,4,0,3,3
5,135,5,0,1,1
5,135,6,3,6,3
5,136,0,0,4,4
5,136,1,0,2,2
5,136,2,0,6,6
5,136,3,0,1,1
5,136,4,0,5,5
5,136,5,0,1,1
5,136,6,1,4,3
5,137,0,0,2,2
5,137,1,0,4,4
5,137,2,0,3,3
5,137,3,1,4,3
5,137,4,0,2,2
5,137,5,1,3,2
5,137,6,2,5,3
5,138,0,0,1,1
5,138,1,0,3,3
5,138,2,0,2,2
5,138,3,0,2,2
5,138,4,1,4,3
5,138,6,0,1,1
5,139,1,0,1,1
5,139,2,1,1,0
5,139,4,1,5,4
5,139,6,0,2,2
5,140,0,0,2,2
5,140,1,3,7,4
5,140,4,0,1,1
5,140,5,0,2,2
5,140,6,1,3,2
5,141,0,0,2,2
5,141,1,2,4,2
5,141,2,2,4,2
5,141,3,1,2,1
5,141,4,0,3,3
5,141,5,0,2,2
5,141,6,0,2,2
5,142,1,0,4,4
5,142,2,0,2,2
5,142,3,0,1,1
5,142,4,1,2,1
5,142,6,2,4,2
5,143,1,2,3,1
5,143,2,0,1,1
5,143,3,1,3,2
5,143,4,0,2,2
5,143,5,1,1,0
5,143,6,2,3,1
6,0,0,1,8,7
6,0,1,2,9,7
6,0,2,2,15,13
6,0,3,2,9,7
6,0,4,1,16,15
6,0,5,3,10,7
6,0,6,1,13,12
6,1,0,1,10,9
6,1,1,1,4,3
6,1,2,1,9,8
6,1,3,1,10,9
6,1,4,0,11,11
6,1,5,3,13,10
6,1,6,0,11,11
6,2,0,1,7,6
6,2,1,2,12,10
6,2,2,1,6,5
6,2,3,0,4,4
6,2,4,2,13,11
6,2,5,1,16,15
6,2,6,2,14,12
6,3,0,0,3,3
6,3,1,1,4,3
6,3,2,0,8,8
6,3,3,2,9,7
6,3,4,0,10,10
6,3,5,1,8,7
6,3,6,0,9,9
6,4,0,3,11,8
6,4,1,1,7,6
6,4,2,1,6,5
6,4,3,0,5,5
6,4,4,1,7,6
6,4,5,0,5,5
6,4,6,0,8,8
6,5,0,1,9,8
6,5,1,2,11,9
6,5,2,1,13,12
6,5,3,1,7,6
6,5,4,2,13,11
6,5,5,2,11,9
6,5,6,1,10,9
6,6,0,3,9,6
6,6,1,1,3,2
6,6,2,0,5,5
6,6,3,0,3,3
6,6,4,1,10,9
6,6,5,0,8,8
6,6,6,0,5,5
6,7,0,0,3,3
6,7,1,1,8,7
6,7,2,0,2,2
6,7,3,0,2,2
6,7,4,1,11,10
6,7,5,0,4,4
6,7,6,1,8,7
6,8,0,0,4,4
6,8,1,0,2,2
6,8,2,0,4,4
6,8,3,0,3,3
6,8,4,1,10,9
6,8,5,1,5,4
6,8,6,0,3,3
6,9,0,0,2,2
6,9,1,0,2,2
6,9,2,0,3,3
6,9,3,3,9,6
6,9,4,0,4,4
6,9,5,0,4,4
6,9,6,0,4,4
6,10,0,0,2,2
6,10,1,5,7,2
6,10,2,0,5,5
6,10,3,2,7,5
6,10,4,1,9,8
6,10,5,1,7,6
6,10,6,3,6,3
6,11,0,0,4,4
6,11,1,0,2,2
6,11,2,5,9,4
6,11,3,2,3,1
6,11,4,1,5,4
6,11,5,4,6,2
6,11,6,1,4,3
6,12,0,0,3,3
6,12,1,2,5,3
6,12,2,3,5,2
6,12,3,1,3,2
6,12,4,0,2,2
6,12,5,0,3,3
6,12,6,0,5,5
6,13,0,0,1,1
6,13,1,0,1,1
6,13,2,4,7,3
6,13,3,1,5,4
6,13,4,1,4,3
6,13,5,2,6,4
6,13,6,2,6,4
6,14,0,0,1,1
6,14,1,1,3,2
6,14,2,0,1,1
6,14,5,2,4,2
6,14,6,0,4,4
6,15,0,1,4,3
6,15,1,3,6,3
6,15,2,1,2,1
6,15,3,0,2,2
6,15,4,0,5,5
6,15,5,2,6,4
6,15,6,0,4,4
6,16,0,0,5,5
6,16,1,5,5,0
6,16,2,0,1,1
6,16,3,0,1,1
6,16,4,2,7,5
6,16,5,2,4,2
6,16,6,1,6,5
6,17,0,1,2,1
6,17,1,2,4,2
6,17,2,0,2,2
6,17,3,4,6,2
6,17,4,2,6,4
6,17,5,0,3,3
6,17,6,0,1,1
6,18,0,0,1,1
6,18,1,1,2,1
6,18,3,0,2,2
6,18,4,0,3,3
6,18,5,4,9,5
6,18,6,1,2,1
6,19,0,3,4,1
6,19,1,2,3,1
6,19,2,1,1,0
6,19,3,2,3,1
6,19,4,0,3,3
6,19,5,1,4,3
6,19,6,0,2,2
6,20,1,1,4,3
6,20,2,4,6,2
6,20,3,3,4,1
6,20,4,3,6,3
6,20,5,1,3,2
6,20,6,1,2,1
6,21,0,2,3,1
6,21,1,3,4,1
6,21,2,3,3,0
6,21,3,1,2,1
6,21,4,4,7,3
6,21,5,0,2,2
6,21,6,0,1,1
6,22,0,3,4,1
6,22,1,0,2,2
6,22,2,1,3,2
6,22,4,0,2,2
6,22,5,0,1,1
6,22,6,0,2,2
6,23,0,1,1,0
6,23,1,1,1,0
6,23,2,0,1,1
6,23,3,0,1,1
6,23,4,3,5,2
6,23,5,1,2,1
6,23,6,1,3,2
6,24,0,1,3,2
6,24,5,2,3,1
6,24,6,0,1,1
6,25,1,3,3,0
6,25,2,1,1,0
6,25,3,1,3,2
6,25,4,3,3,0
6,25,5,0,1,1
6,25,6,0,2,2
6,26,1,4,5,1
6,26,2,1,2,1
6,26,4,2,3,1
6,26,5,0,1,1
6,26,6,0,1,1
6,27,0,3,3,0
6,27,1,0,2,2
6,27,2,0,1,1
6,27,3,1,1,0
6,27,4,2,2,0
6,27,6,0,3,3
6,28,0,1,1,0
6,28,1,0,2,2
6,28,2,2,2,0
6,28,4,0,2,2
6,28,5,1,1,0
6,29,0,0,1,1
6,29,2,2,3,1
6,29,4,4,5,1
6,29,5,0,1,1
6,29,6,1,2,1
6,30,0,1,1,0
6,30,1,0,2,2
6,30,4,0,3,3
6,30,5,2,2,0
6,30,6,2,3,1
6,31,0,5,6,1
6,31,2,2,2,0
6,31,4,3,5,2
6,31,6,7,9,2
6,32,0,5,8,3
6,32,1,0,2,2
6,32,2,1,2,1
6,32,3,2,4,2
6,32,4,4,5,1
6,32,5,0,1,1
6,32,6,6,6,0
6,33,0,1,3,2
6,33,1,2,4,2
6,33,2,1,3,2
6,33,3,1,4,3
6,33,4,10,15,5
6,33,5,2,2,0
6,33,6,0,1,1
6,34,0,1,1,0
6,34,1,1,2,1
6,34,2,0,2,2
6,34,3,0,1,1
6,34,4,5,7,2
6,34,5,1,3,2
6,34,6,3,5,2
6,35,0,3,4,1
6,35,1,1,4,3
6,35,2,4,5,1
6,35,3,4,5,1
6,35,4,6,8,2
6,35,5,6,11,5
6,35,6,1,3,2
6,36,0,4,5,1
6,36,1,2,5,3
6,36,2,2,3,1
6,36,3,2,3,1
6,36,4,10,12,2
6,36,5,4,8,4
6,36,6,1,3,2
6,37,0,9,9,0
6,37,1,2,7,5
6,37,2,0,2,2
6,37,3,17,20,3
6,37,4,17,19,2
6,37,5,4,8,4
6,37,6,2,5,3
6,38,0,5,9,4
6,38,1,3,10,7
6,38,2,3,4,1
6,38,3,12,15,3
6,38,4,16,26,10
6,38,5,2,5,3
6,38,6,8,12,4
6,39,0,1,15,14
6,39,1,1,14,13
6,39,2,3,16,13
6,39,3,3,14,11
6,39,4,4,16,12
6,39,5,6,16,10
6,39,6,1,7,6
6,40,0,1,21,20
6,40,1,3,21,18
6,40,2,2,26,24
6,40,3,1,22,21
6,40,4,3,21,18
6,40,5,2,10,8
6,40,6,1,6,5
6,41,0,2,28,26
6,41,1,3,29,26
6,41,2,0,21,21
6,41,3,2,28,26
6,41,4,6,26,20
6,41,5,1,17,16
6,41,6,5,10,5
6,42,0,1,41,40
6,42,1,4,37,33
6,42,2,4,41,37
6,42,3,3,47,44
6,42,4,8,37,29
6,42,5,2,21,19
6,42,6,7,24,17
6,43,0,2,55,53
6,43,1,2,50,48
6,43,2,10,92,82
6,43,3,2,69,67
6,43,4,9,61,52
6,43,5,9,42,33
6,43,6,3,25,22
6,44,0,3,81,78
6,44,1,4,89,85
6,44,2,4,89,85
6,44,3,5,82,77
6,44,4,3,50,47
6,44,5,4,33,29
6,44,6,11,40,29
6,45,0,10,109,99
6,45,1,28,132,104
6,45,2,20,118,98
6,45,3,24,127,103
6,45,4,16,101,85
6,45,5,6,52,46
6,45,6,2,36,34
6,46,0,33,136,103
6,46,1,27,138,111
6,46,2,31,153,122
6,46,3,19,126,107
6,46,4,26,122,96
6,46,5,9,67,58
6,46,6,8,41,33
6,47,0,56,163,107
6,47,1,51,165,114
6,47,2,73,185,112
6,47,3,44,172,128
6,47,4,25,123,98
6,47,5,8,63,55
6,47,6,26,67,41
6,48,0,79,173,94
6,48,1,78,192,114
6,48,2,127,220,93
6,48,3,65,177,112
6,48,4,57,133,76
6,48,5,29,91,62
6,48,6,22,75,53
6,49,0,103,178,75
6,49,1,109,196,87
6,49,2,143,227,84
6,49,3,117,216,99
6,49,4,86,161,75
6,49,5,45,93,48
6,49,6,14,52,38
6,50,0,77,146,69
6,50,1,127,200,73
6,50,2,125,192,67
6,50,3,102,192,90
6,50,4,105,159,54
6,50,5,36,86,50
6,50,6,11,58,47
6,51,0,108,173,65
6,51,1,120,166,46
6,51,2,135,204,69
6,51,3,155,234,79
6,51,4,81,149,68
6,51,5,23,68,45
6,51,6,14,63,49
6,52,0,87,129,42
6,52,1,67,115,48
6,52,2,101,153,52
6,52,3,118,173,55
6,52,4,78,133,55
6,52,5,27,87,60
6,52,6,5,47,42
6,53,0,57,96,39
6,53,1,73,141,68
6,53,2,58,131,73
6,53,3,78,151,73
6,53,4,59,104,45
6,53,5,44,93,49
6,53,6,17,71,54
6,54,0,74,116,42
6,54,1,60,114,54
6,54,2,48,117,69
6,54,3,75,143,68
6,54,4,55,114,59
6,54,5,20,74,54
6,54,6,16,54,38
6,55,0,63,109,46
6,55,1,72,132,60
6,55,2,87,159,72
6,55,3,100,156,56
6,55,4,57,104,47
6,55,5,20,72,52
6,55,6,21,57,36
6,56,0,58,107,49
6,56,1,91,143,52
6,56,2,89,138,49
6,56,3,102,148,46
6,56,4,71,123,52
6,56,5,34,81,47
6,56,6,21,67,46
6,57,0,39,70,31
6,57,1,67,100,33
6,57,2,79,104,25
6,57,3,81,116,35
6,57,4,62,99,37
6,57,5,37,83,46
6,57,6,9,58,49
6,58,0,44,80,36
6,58,1,71,123,52
6,58,2,84,113,29
6,58,3,105,134,29
6,58,4,47,84,37
6,58,5,42,89,47
6,58,6,7,55,48
6,59,0,30,58,28
6,59,1,56,86,30
6,59,2,88,119,31
6,59,3,95,130,35
6,59,4,48,85,37
6,59,5,34,82,48
6,59,6,22,71,49
6,60,0,18,48,30
6,60,1,42,70,28
6,60,2,46,74,28
6,60,3,65,89,24
6,60,4,60,105,45
6,60,5,36,80,44
6,60,6,18,57,39
6,61,0,27,63,36
6,61,1,37,71,34
6,61,2,37,62,25
6,61,3,46,81,35
6,61,4,53,88,35
6,61,5,27,76,49
6,61,6,12,56,44
6,62,0,24,53,29
6,62,1,30,56,26
6,62,2,41,71,30
6,62,3,30,75,45
6,62,4,58,89,31
6,62,5,31,80,49
6,62,6,11,60,49
6,63,0,33,65,32
6,63,1,15,40,25
6,63,2,38,83,45
6,63,3,31,60,29
6,63,4,58,99,41
6,63,5,16,61,45
6,63,6,16,60,44
6,64,0,32,70,38
6,64,1,12,39,27
6,64,2,10,46,36
6,64,3,42,73,31
6,64,4,53,96,43
6,64,5,23,68,45
6,64,6,25,65,40
6,65,0,16,44,28
6,65,1,14,51,37
6,65,2,15,43,28
6,65,3,34,87,53
6,65,4,61,84,23
6,65,5,17,60,43
6,65,6,18,56,38
6,66,0,5,30,25
6,66,1,8,42,34
6,66,2,45,78,33
6,66,3,37,74,37
6,66,4,56,103,47
6,66,5,27,74,47
6,66,6,23,71,48
6,67,0,22,42,20
6,67,1,26,60,34
6,67,2,12,38,26
6,67,3,61,101,40
6,67,4,55,83,28
6,67,5,31,75,44
6,67,6,8,51,43
6,68,0,16,48,32
6,68,1,11,46,35
6,68,2,20,50,30
6,68,3,57,96,39
6,68,4,53,97,44
6,68,5,35,91,56
6,68,6,17,74,57
6,69,0,9,47,38
6,69,1,10,42,32
6,69,2,25,62,37
6,69,3,61,92,31
6,69,4,44,74,30
6,69,5,30,97,67
6,69,6,16,71,55
6,70,0,7,41,34
6,70,1,23,52,29
6,70,2,8,47,39
6,70,3,57,93,36
6,70,4,55,83,28
6,70,5,25,91,66
6,70,6,9,56,47
6,71,0,4,38,34
6,71,1,7,41,34
6,71,2,28,63,35
6,71,3,65,96,31
6,71,4,33,65,32
6,71,5,38,86,48
6,71,6,15,64,49
6,72,0,11,36,25
6,72,1,15,50,35
6,72,2,22,58,36
6,72,3,50,107,57
6,72,4,49,87,38
6,72,5,22,89,67
6,72,6,10,58,48
6,73,0,12,41,29
6,73,1,20,56,36
6,73,2,16,46,30
6,73,3,37,70,33
6,73,4,42,94,52
6,73,5,33,84,51
6,73,6,11,66,55
6,74,0,10,54,44
6,74,1,12,45,33
6,74,2,13,57,44
6,74,3,32,68,36
6,74,4,56,107,51
6,74,5,33,94,61
6,74,6,10,60,50
6,75,0,3,44,41
6,75,1,20,48,28
6,75,2,20,63,43
6,75,3,36,92,56
6,75,4,59,93,34
6,75,5,34,83,49
6,75,6,16,69,53
6,76,0,6,38,32
6,76,1,31,73,42
6,76,2,28,79,51
6,76,3,39,77,38
6,76,4,56,95,39
6,76,5,34,90,56
6,76,6,16,66,50
6,77,0,19,59,40
6,77,1,20,61,41
6,77,2,21,54,33
6,77,3,22,71,49
6,77,4,53,88,35
6,77,5,21,74,53
6,77,6,13,70,57
6,78,0,20,59,39
6,78,1,18,69,51
6,78,2,17,44,27
6,78,3,30,70,40
6,78,4,52,87,35
6,78,5,36,96,60
6,78,6,11,63,52
6,79,0,22,61,39
6,79,1,21,59,38
6,79,2,26,93,67
6,79,3,35,76,41
6,79,4,68,110,42
6,79,5,34,88,54
6,79,6,4,63,59
6,80,0,8,36,28
6,80,1,29,65,36
6,80,2,14,50,36
6,80,3,17,58,41
6,80,4,51,85,34
6,80,5,17,73,56
6,80,6,11,56,45
6,81,0,3,46,43
6,81,1,19,55,36
6,81,2,22,58,36
6,81,3,34,72,38
6,81,4,67,98,31
6,81,5,10,64,54
6,81,6,14,71,57
6,82,0,9,46,37
6,82,1,14,51,37
6,82,2,25,62,37
6,82,3,30,75,45
6,82,4,57,91,34
6,82,5,14,64,50
6,82,6,17,72,55
6,83,0,5,40,35
6,83,1,26,65,39
6,83,2,26,72,46
6,83,3,29,72,43
6,83,4,49,89,40
6,83,5,13,71,58
6,83,6,22,68,46
6,84,0,5,36,31
6,84,1,21,59,38
6,84,2,23,58,35
6,84,3,13,39,26
6,84,4,58,99,41
6,84,5,8,57,49
6,84,6,15,49,34
6,85,0,14,52,38
6,85,1,10,37,27
6,85,2,25,57,32
6,85,3,20,55,35
6,85,4,55,90,35
6,85,5,5,48,43
6,85,6,16,63,47
6,86,0,8,47,39
6,86,1,8,38,30
6,86,2,13,56,43
6,86,3,17,59,42
6,86,4,49,82,33
6,86,5,13,61,48
6,86,6,11,55,44
6,87,0,2,33,31
6,87,1,19,54,35
6,87,2,24,53,29
6,87,3,11,46,35
6,87,4,73,105,32
6,87,5,12,48,36
6,87,6,11,53,42
6,88,0,4,37,33
6,88,1,9,39,30
6,88,2,15,46,31
6,88,3,12,49,37
6,88,4,46,84,38
6,88,5,8,54,46
6,88,6,5,49,44
6,89,0,8,35,27
6,89,1,7,42,35
6,89,2,21,57,36
6,89,3,14,60,46
6,89,4,71,109,38
6,89,5,16,58,42
6,89,6,7,57,50
6,90,0,4,45,41
6,90,1,4,43,39
6,90,2,30,80,50
6,90,3,17,57,40
6,90,4,46,92,46
6,90,5,9,53,44
6,90,6,1,61,60
6,91,0,10,35,25
6,91,1,20,55,35
6,91,2,25,60,35
6,91,3,11,44,33
6,91,4,50,91,41
6,91,5,19,76,57
6,91,6,4,63,59
6,92,0,23,66,43
6,92,1,12,60,48
6,92,2,32,70,38
6,92,3,12,43,31
6,92,4,53,102,49
6,92,5,10,63,53
6,92,6,12,70,58
6,93,0,2,45,43
6,93,1,1,39,38
6,93,2,10,54,44
6,93,3,3,45,42
6,93,4,6,96,90
6,93,5,7,53,46
6,93,6,9,56,47
6,94,0,1,47,46
6,94,1,5,43,38
6,94,2,4,55,51
6,94,3,1,45,44
6,94,4,3,62,59
6,94,5,8,50,42
6,94,6,6,51,45
6,95,0,3,39,36
6,95,1,4,47,43
6,95,2,14,61,47
6,95,3,5,50,45
6,95,4,3,48,45
6,95,5,14,61,47
6,95,6,12,55,43
6,96,0,1,53,52
6,96,1,0,57,57
6,96,2,11,70,59
6,96,3,3,62,59
6,96,4,7,73,66
6,96,5,5,74,69
6,96,6,0,54,54
6,97,0,4,61,57
6,97,1,0,51,51
6,97,2,12,55,43
6,97,3,7,57,50
6,97,4,6,62,56
6,97,5,3,65,62
6,97,6,2,59,57
6,98,0,2,46,44
6,98,1,1,53,52
6,98,2,10,63,53
6,98,3,3,65,62
6,98,4,5,78,73
6,98,5,1,59,58
6,98,6,3,61,58
6,99,0,0,44,44
6,99,1,4,62,58
6,99,2,14,65,51
6,99,3,4,61,57
6,99,4,5,65,60
6,99,5,6,69,63
6,99,6,2,75,73
6,100,0,1,57,56
6,100,1,2,49,47
6,100,2,6,55,49
6,100,3,6,70,64
6,100,4,5,70,65
6,100,5,2,65,63
6,100,6,1,63,62
6,101,0,1,56,55
6,101,1,1,61,60
6,101,2,9,67,58
6,101,3,0,49,49
6,101,4,5,66,61
6,101,5,0,51,51
6,101,6,2,54,52
6,102,0,7,66,59
6,102,1,1,46,45
6,102,2,14,72,58
6,102,3,3,69,66
6,102,4,15,62,47
6,102,5,1,75,74
6,102,6,3,72,69
6,103,0,4,52,48
6,103,1,6,63,57
6,103,2,6,70,64
6,103,3,3,70,67
6,103,4,10,76,66
6,103,5,1,54,53
6,103,6,3,56,53
6,104,0,3,55,52
6,104,1,12,77,65
6,104,2,7,54,47
6,104,3,4,71,67
6,104,4,26,93,67
6,104,5,3,62,59
6,104,6,2,61,59
6,105,0,7,84,77
6,105,1,11,72,61
6,105,2,10,70,60
6,105,3,4,56,52
6,105,4,21,97,76
6,105,5,1,46,45
6,105,6,4,68,64
6,106,0,4,47,43
6,106,1,7,72,65
6,106,2,9,68,59
6,106,3,2,62,60
6,106,4,12,68,56
6,106,5,2,64,62
6,106,6,2,45,43
6,107,0,2,49,47
6,107,1,4,55,51
6,107,2,9,63,54
6,107,3,3,51,48
6,107,4,8,61,53
6,107,5,6,66,60
6,107,6,2,62,60
6,108,0,3,37,34
6,108,1,4,53,49
6,108,2,4,69,65
6,108,3,2,59,57
6,108,4,9,67,58
6,108,5,5,71,66
6,108,6,4,49,45
6,109,0,2,50,48
6,109,1,1,47,46
6,109,2,7,61,54
6,109,3,5,52,47
6,109,4,1,57,56
6,109,5,1,54,53
6,109,6,6,57,51
6,110,0,2,40,38
6,110,1,2,44,42
6,110,2,7,47,40
6,110,3,1,55,54
6,110,4,1,53,52
6,110,5,2,58,56
6,110,6,2,45,43
6,111,0,1,38,37
6,111,1,1,49,48
6,111,2,0,25,25
6,111,3,1,54,53
6,111,4,5,53,48
6,111,5,2,60,58
6,111,6,1,57,56
6,112,0,2,39,37
6,112,1,1,41,40
6,112,2,3,32,29
6,112,3,8,45,37
6,112,4,1,42,41
6,112,5,1,44,43
6,112,6,3,46,43
6,113,0,1,36,35
6,113,1,3,35,32
6,113,2,3,40,37
6,113,3,1,28,27
6,113,4,0,42,42
6,113,5,1,58,57
6,113,6,5,46,41
6,114,0,2,33,31
6,114,1,4,36,32
6,114,2,4,38,34
6,114,3,3,43,40
6,114,4,3,49,46
6,114,5,4,45,41
6,114,6,2,45,43
6,115,0,3,30,27
6,115,1,0,37,37
6,115,2,1,38,37
6,115,3,9,44,35
6,115,4,1,55,54
6,115,5,1,35,34
6,115,6,6,48,42
6,116,0,3,31,28
6,116,1,2,36,34
6,116,2,2,28,26
6,116,3,5,43,38
6,116,4,2,42,40
6,116,5,2,40,38
6,116,6,2,33,31
6,117,0,0,34,34
6,117,1,2,25,23
6,117,2,4,44,40
6,117,3,3,37,34
6,117,4,2,42,40
6,117,5,3,43,40
6,117,6,3,51,48
6,118,0,0,48,48
6,118,1,2,38,36
6,118,2,2,39,37
6,118,3,0,25,25
6,118,4,2,35,33
6,118,5,5,42,37
6,118,6,2,38,36
6,119,0,1,26,25
6,119,1,2,37,35
6,119,2,3,46,43
6,119,3,0,24,24
6,119,4,2,52,50
6,119,5,1,32,31
6,119,6,5,40,35
6,120,0,2,36,34
6,120,1,1,28,27
6,120,2,1,22,21
6,120,3,2,30,28
6,120,4,1,47,46
6,120,5,1,39,38
6,120,6,7,44,37
6,121,0,2,32,30
6,121,1,0,39,39
6,121,2,3,38,35
6,121,3,2,33,31
6,121,4,5,38,33
6,121,5,2,35,33
6,121,6,1,40,39
6,122,0,2,33,31
6,122,1,1,32,31
6,122,2,2,38,36
6,122,3,1,37,36
6,122,4,6,52,46
6,122,5,1,34,33
6,122,6,2,44,42
6,123,0,0,28,28
6,123,1,0,40,40
6,123,2,1,33,32
6,123,3,1,32,31
6,123,4,0,38,38
6,123,5,0,39,39
6,123,6,1,30,29
6,124,0,1,28,27
6,124,1,0,29,29
6,124,2,2,39,37
6,124,3,1,37,36
6,124,4,6,43,37
6,124,5,1,34,33
6,124,6,3,36,33
6,125,0,0,24,24
6,125,1,2,39,37
6,125,2,1,36,35
6,125,3,2,30,28
6,125,4,1,50,49
6,125,5,2,26,24
6,125,6,4,35,31
6,126,0,0,33,33
6,126,1,0,27,27
6,126,2,3,30,27
6,126,3,0,30,30
6,126,4,1,37,36
6,126,5,0,34,34
6,126,6,1,40,39
6,127,0,1,33,32
6,127,1,1,34,33
6,127,2,1,33,32
6,127,3,1,26,25
6,127,4,2,34,32
6,127,5,1,35,34
6,127,6,2,46,44
6,128,0,2,43,41
6,128,1,0,34,34
6,128,2,0,30,30
6,128,3,2,29,27
6,128,4,1,41,40
6,128,5,0,33,33
6,128,6,1,39,38
6,129,0,0,16,16
6,129,1,0,37,37
6,129,2,0,27,27
6,129,3,0,29,29
6,129,4,3,39,36
6,129,5,2,30,28
6,129,6,2,37,35
6,130,0,2,27,25
6,130,1,1,36,35
6,130,2,4,42,38
6,130,3,1,25,24
6,130,4,0,36,36
6,130,5,0,36,36
6,130,6,1,22,21
6,131,0,2,33,31
6,131,1,0,23,23
6,131,2,3,40,37
6,131,3,2,30,28
6,131,4,3,35,32
6,131,5,2,33,31
6,131,6,4,36,32
6,132,0,0,26,26
6,132,1,2,32,30
6,132,2,2,28,26
6,132,3,0,18,18
6,132,4,2,36,34
6,132,5,4,43,39
6,132,6,2,33,31
6,133,0,0,22,22
6,133,1,5,28,23
6,133,2,1,28,27
6,133,3,3,19,16
6,133,4,2,21,19
6,133,5,4,47,43
6,133,6,1,27,26
6,134,0,2,22,20
6,134,1,1,30,29
6,134,2,0,26,26
6,134,3,0,8,8
6,134,4,1,32,31
6,134,5,7,39,32
6,134,6,2,35,33
6,135,0,0,21,21
6,135,1,0,22,22
6,135,2,2,26,24
6,135,3,2,28,26
6,135,4,1,29,28
6,135,5,0,24,24
6,135,6,1,27,26
6,136,0,1,13,12
6,136,1,2,17,15
6,136,2,1,29,28
6,136,3,4,20,16
6,136,4,7,23,16
6,136,5,1,23,22
6,136,6,0,32,32
6,137,0,1,13,12
6,137,1,2,22,20
6,137,2,1,14,13
6,137,3,2,11,9
6,137,4,3,27,24
6,137,5,5,23,18
6,137,6,0,21,21
6,138,0,4,18,14
6,138,1,2,17,15
6,138,2,0,11,11
6,138,3,0,15,15
6,138,4,0,16,16
6,138,5,0,13,13
6,138,6,1,21,20
6,139,0,1,13,12
6,139,1,1,14,13
6,139,2,1,11,10
6,139,3,1,13,12
6,139,4,2,15,13
6,139,5,1,12,11
6,139,6,2,17,15
6,140,0,0,10,10
6,140,1,0,8,8
6,140,2,3,19,16
6,140,3,0,8,8
6,140,4,0,21,21
6,140,5,1,12,11
6,140,6,1,16,15
6,141,0,2,10,8
6,141,1,1,12,11
6,141,2,0,8,8
6,141,3,1,9,8
6,141,4,3,20,17
6,141,5,0,10,10
6,141,6,1,10,9
6,142,0,1,11,10
6,142,1,2,16,14
6,142,2,1,12,11
6,142,3,0,7,7
6,142,4,0,13,13
6,142,5,0,11,11
6,142,6,1,9,8
6,143,0,3,10,7
6,143,1,1,15,14
6,143,2,2,17,15
6,143,3,2,15,13
6,143,4,0,10,10
6,143,5,2,18,16
6,143,6,1,6,5
7,0,0,21,169,148
7,0,1,11,171,160
7,0,2,25,179,154
7,0,3,8,195,187
7,0,4,23,261,238
7,0,5,20,219,199
7,0,6,41,265,224
7,1,0,17,146,129
7,1,1,24,164,140
7,1,2,22,178,156
7,1,3,24,177,153
7,1,4,21,305,284
7,1,5,12,186,174
7,1,6,49,236,187
7,2,0,10,127,117
7,2,1,23,181,158
7,2,2,52,207,155
7,2,3,35,185,150
7,2,4,26,265,239
7,2,5,12,160,148
7,2,6,37,212,175
7,3,0,12,118,106
7,3,1,44,168,124
7,3,2,62,189,127
7,3,3,27,133,106
7,3,4,32,329,297
7,3,5,14,178,164
7,3,6,38,224,186
7,4,0,22,132,110
7,4,1,37,161,124
7,4,2,48,177,129
7,4,3,32,163,131
7,4,4,106,379,273
7,4,5,16,166,150
7,4,6,54,216,162
7,5,0,15,129,114
7,5,1,34,149,115
7,5,2,36,172,136
7,5,3,45,156,111
7,5,4,171,437,266
7,5,5,30,188,158
7,5,6,18,158,140
7,6,0,14,117,103
7,6,1,24,142,118
7,6,2,50,157,107
7,6,3,53,177,124
7,6,4,151,453,302
7,6,5,23,186,163
7,6,6,83,222,139
7,7,0,20,119,99
7,7,1,26,126,100
7,7,2,31,112,81
7,7,3,63,163,100
7,7,4,144,399,255
7,7,5,48,204,156
7,7,6,68,198,130
7,8,0,15,122,107
7,8,1,31,124,93
7,8,2,21,115,94
7,8,3,66,167,101
7,8,4,128,392,264
7,8,5,39,170,131
7,8,6,81,210,129
7,9,0,17,98,81
7,9,1,30,115,85
7,9,2,40,168,128
7,9,3,51,144,93
7,9,4,71,321,250
7,9,5,29,156,127
7,9,6,61,153,92
7,10,0,16,96,80
7,10,1,50,128,78
7,10,2,24,108,84
7,10,3,78,177,99
7,10,4,64,252,188
7,10,5,42,166,124
7,10,6,55,177,122
7,11,0,22,112,90
7,11,1,26,115,89
7,11,2,28,119,91
7,11,3,66,153,87
7,11,4,83,257,174
7,11,5,29,126,97
7,11,6,56,177,121
7,12,0,23,92,69
7,12,1,37,113,76
7,12,2,36,130,94
7,12,3,50,134,84
7,12,4,97,266,169
7,12,5,76,183,107
7,12,6,50,170,120
7,13,0,18,75,57
7,13,1,15,80,65
7,13,2,14,110,96
7,13,3,30,112,82
7,13,4,152,324,172
7,13,5,104,194,90
7,13,6,45,131,86
7,14,0,15,84,69
7,14,1,15,87,72
7,14,2,12,73,61
7,14,3,21,94,73
7,14,4,147,295,148
7,14,5,51,148,97
7,14,6,49,147,98
7,15,0,8,64,56
7,15,1,19,82,63
7,15,2,20,98,78
7,15,3,29,92,63
7,15,4,142,281,139
7,15,5,41,116,75
7,15,6,43,148,105
7,16,0,6,65,59
7,16,1,29,90,61
7,16,2,20,92,72
7,16,3,31,105,74
7,16,4,106,217,111
7,16,5,75,164,89
7,16,6,63,158,95
7,17,0,7,59,52
7,17,1,13,69,56
7,17,2,14,85,71
7,17,3,17,77,60
7,17,4,87,190,103
7,17,5,51,121,70
7,17,6,38,116,78
7,18,0,17,78,61
7,18,1,14,66,52
7,18,2,9,63,54
7,18,3,24,74,50
7,18,4,166,259,93
7,18,5,34,105,71
7,18,6,39,114,75
7,19,0,16,58,42
7,19,1,19,80,61
7,19,2,18,82,64
7,19,3,24,83,59
7,19,4,182,248,66
7,19,5,41,116,75
7,19,6,39,123,84
7,20,0,18,68,50
7,20,1,45,104,59
7,20,2,33,88,55
7,20,3,36,97,61
7,20,4,160,243,83
7,20,5,47,122,75
7,20,6,50,127,77
7,21,0,30,75,45
7,21,1,40,103,63
7,21,2,25,77,52
7,21,3,45,107,62
7,21,4,181,261,80
7,21,5,74,155,81
7,21,6,47,105,58
7,22,0,21,80,59
7,22,1,39,96,57
7,22,2,25,86,61
7,22,3,37,81,44
7,22,4,130,193,63
7,22,5,58,129,71
7,22,6,35,96,61
7,23,0,31,77,46
7,23,1,15,58,43
7,23,2,56,110,54
7,23,3,54,101,47
7,23,4,107,167,60
7,23,5,24,85,61
7,23,6,28,96,68
7,24,0,47,97,50
7,24,1,28,76,48
7,24,2,52,110,58
7,24,3,69,116,47
7,24,4,120,171,51
7,24,5,35,97,62
7,24,6,32,86,54
7,25,0,29,71,42
7,25,1,40,77,37
7,25,2,47,91,44
7,25,3,21,67,46
7,25,4,132,189,57
7,25,5,17,72,55
7,25,6,50,103,53
7,26,0,36,71,35
7,26,1,17,62,45
7,26,2,37,89,52
7,26,3,25,70,45
7,26,4,124,173,49
7,26,5,43,90,47
7,26,6,53,102,49
7,27,0,39,82,43
7,27,1,23,73,50
7,27,2,39,72,33
7,27,3,46,86,40
7,27,4,96,138,42
7,27,5,28,62,34
7,27,6,35,83,48
7,28,0,31,70,39
7,28,1,22,57,35
7,28,2,41,85,44
7,28,3,26,58,32
7,28,4,69,103,34
7,28,5,25,63,38
7,28,6,26,71,45
7,29,0,22,47,25
7,29,1,17,45,28
7,29,2,19,51,32
7,29,3,8,38,30
7,29,4,89,116,27
7,29,5,28,58,30
7,29,6,42,88,46
7,30,0,20,37,17
7,30,1,37,65,28
7,30,2,20,54,34
7,30,3,11,40,29
7,30,4,84,117,33
7,30,5,13,44,31
7,30,6,26,51,25
7,31,0,18,43,25
7,31,1,24,46,22
7,31,2,12,46,34
7,31,3,8,39,31
7,31,4,91,108,17
7,31,5,19,44,25
7,31,6,27,48,21
7,32,0,21,43,22
7,32,1,17,39,22
7,32,2,20,40,20
7,32,3,10,33,23
7,32,4,100,122,22
7,32,5,19,47,28
7,32,6,18,45,27
7,33,0,7,25,18
7,33,1,24,42,18
7,33,2,11,35,24
7,33,3,8,25,17
7,33,4,129,148,19
7,33,5,11,25,14
7,33,6,20,45,25
7,34,0,15,29,14
7,34,1,23,32,9
7,34,2,9,29,20
7,34,3,14,37,23
7,34,4,119,143,24
7,34,5,21,32,11
7,34,6,23,46,23
7,35,0,12,23,11
7,35,1,18,36,18
7,35,2,16,34,18
7,35,3,14,30,16
7,35,4,201,223,22
7,35,5,8,27,19
7,35,6,17,38,21
7,36,0,27,43,16
7,36,1,28,50,22
7,36,2,27,44,17
7,36,3,18,49,31
7,36,4,183,207,24
7,36,5,16,38,22
7,36,6,17,40,23
7,37,0,25,47,22
7,37,1,16,35,19
7,37,2,25,45,20
7,37,3,19,33,14
7,37,4,167,188,21
7,37,5,13,42,29
7,37,6,21,47,26
7,38,0,19,42,23
7,38,1,22,49,27
7,38,2,19,31,12
7,38,3,20,35,15
7,38,4,239,262,23
7,38,5,8,25,17
7,38,6,13,31,18
7,39,0,8,80,72
7,39,1,3,76,73
7,39,2,2,69,67
7,39,3,7,79,72
7,39,4,195,257,62
7,39,5,18,62,44
7,39,6,16,57,41
7,40,0,20,114,94
7,40,1,11,102,91
7,40,2,10,112,102
7,40,3,4,95,91
7,40,4,176,246,70
7,40,5,14,64,50
7,40,6,10,42,32
7,41,0,86,216,130
7,41,1,9,146,137
7,41,2,19,155,136
7,41,3,5,151,146
7,41,4,120,210,90
7,41,5,14,81,67
7,41,6,18,71,53
7,42,0,177,328,151
7,42,1,15,215,200
7,42,2,31,239,208
7,42,3,26,205,179
7,42,4,165,323,158
7,42,5,22,127,105
7,42,6,29,86,57
7,43,0,239,480,241
7,43,1,37,283,246
7,43,2,46,283,237
7,43,3,30,261,231
7,43,4,139,314,175
7,43,5,24,126,102
7,43,6,28,109,81
7,44,0,296,517,221
7,44,1,70,306,236
7,44,2,78,337,259
7,44,3,41,305,264
7,44,4,142,352,210
7,44,5,20,142,122
7,44,6,47,154,107
7,45,0,235,481,246
7,45,1,204,486,282
7,45,2,207,477,270
7,45,3,88,385,297
7,45,4,130,348,218
7,45,5,13,160,147
7,45,6,24,154,130
7,46,0,267,514,247
7,46,1,319,618,299
7,46,2,285,610,325
7,46,3,84,405,321
7,46,4,153,418,265
7,46,5,17,185,168
7,46,6,36,192,156
7,47,0,269,551,282
7,47,1,338,661,323
7,47,2,275,594,319
7,47,3,93,436,343
7,47,4,154,439,285
7,47,5,31,228,197
7,47,6,36,200,164
7,48,0,343,685,342
7,48,1,342,725,383
7,48,2,271,636,365
7,48,3,118,500,382
7,48,4,175,459,284
7,48,5,37,249,212
7,48,6,21,203,182
7,49,0,285,653,368
7,49,1,269,654,385
7,49,2,242,667,425
7,49,3,138,566,428
7,49,4,126,448,322
7,49,5,37,264,227
7,49,6,27,221,194
7,50,0,235,674,439
7,50,1,263,698,435
7,50,2,186,646,460
7,50,3,80,541,461
7,50,4,129,499,370
7,50,5,24,263,239
7,50,6,24,207,183
7,51,0,257,771,514
7,51,1,221,708,487
7,51,2,153,653,500
7,51,3,93,582,489
7,51,4,105,477,372
7,51,5,30,299,269
7,51,6,23,276,253
7,52,0,232,734,502
7,52,1,134,648,514
7,52,2,97,569,472
7,52,3,77,586,509
7,52,4,102,517,415
7,52,5,48,314,266
7,52,6,26,279,253
7,53,0,97,561,464
7,53,1,53,527,474
7,53,2,54,516,462
7,53,3,20,465,445
7,53,4,35,386,351
7,53,5,27,266,239
7,53,6,8,202,194
7,54,0,48,520,472
7,54,1,24,488,464
7,54,2,12,485,473
7,54,3,17,501,484
7,54,4,16,397,381
7,54,5,11,294,283
7,54,6,7,220,213
7,55,0,40,524,484
7,55,1,27,515,488
7,55,2,12,450,438
7,55,3,20,507,487
7,55,4,41,478,437
7,55,5,9,279,270
7,55,6,5,246,241
7,56,0,16,418,402
7,56,1,21,490,469
7,56,2,16,438,422
7,56,3,13,443,430
7,56,4,38,428,390
7,56,5,11,323,312
7,56,6,7,267,260
7,57,0,12,349,337
7,57,1,23,422,399
7,57,2,15,429,414
7,57,3,16,403,387
7,57,4,47,401,354
7,57,5,16,306,290
7,57,6,8,313,305
7,58,0,10,404,394
7,58,1,15,372,357
7,58,2,20,461,441
7,58,3,17,450,433
7,58,4,49,401,352
7,58,5,32,378,346
7,58,6,11,269,258
7,59,0,11,329,318
7,59,1,11,330,319
7,59,2,14,379,365
7,59,3,12,356,344
7,59,4,51,370,319
7,59,5,16,299,283
7,59,6,12,281,269
7,60,0,10,345,335
7,60,1,11,320,309
7,60,2,7,314,307
7,60,3,9,335,326
7,60,4,54,363,309
7,60,5,19,361,342
7,60,6,8,309,301
7,61,0,9,323,314
7,61,1,15,341,326
7,61,2,7,314,307
7,61,3,7,298,291
7,61,4,68,382,314
7,61,5,18,320,302
7,61,6,4,268,264
7,62,0,9,292,283
7,62,1,6,283,277
7,62,2,7,313,306
7,62,3,13,344,331
7,62,4,53,403,350
7,62,5,13,359,346
7,62,6,7,281,274
7,63,0,9,290,281
7,63,1,15,319,304
7,63,2,2,292,290
7,63,3,5,315,310
7,63,4,78,366,288
7,63,5,14,357,343
7,63,6,15,342,327
7,64,0,1,277,276
7,64,1,13,322,309
7,64,2,14,331,317
7,64,3,16,328,312
7,64,4,58,363,305
7,64,5,16,348,332
7,64,6,10,343,333
7,65,0,6,303,297
7,65,1,11,333,322
7,65,2,10,306,296
7,65,3,6,288,282
7,65,4,82,398,316
7,65,5,12,349,337
7,65,6,19,321,302
7,66,0,10,266,256
7,66,1,8,309,301
7,66,2,15,320,305
7,66,3,11,374,363
7,66,4,89,416,327
7,66,5,24,419,395
7,66,6,38,396,358
7,67,0,6,340,334
7,67,1,5,314,309
7,67,2,15,321,306
7,67,3,9,339,330
7,67,4,107,474,367
7,67,5,18,386,368
7,67,6,59,417,358
7,68,0,9,348,339
7,68,1,10,337,327
7,68,2,11,312,301
7,68,3,12,390,378
7,68,4,100,431,331
7,68,5,19,408,389
7,68,6,41,415,374
7,69,0,11,360,349
7,69,1,18,369,351
7,69,2,55,416,361
7,69,3,11,386,375
7,69,4,100,494,394
7,69,5,37,479,442
7,69,6,59,422,363
7,70,0,9,351,342
7,70,1,22,404,382
7,70,2,70,404,334
7,70,3,12,341,329
7,70,4,156,556,400
7,70,5,44,473,429
7,70,6,71,449,378
7,71,0,19,379,360
7,71,1,38,387,349
7,71,2,85,428,343
7,71,3,16,391,375
7,71,4,119,511,392
7,71,5,30,439,409
7,71,6,77,485,408
7,72,0,27,378,351
7,72,1,18,390,372
7,72,2,38,392,354
7,72,3,30,448,418
7,72,4,107,467,360
7,72,5,20,465,445
7,72,6,69,501,432
7,73,0,15,380,365
7,73,1,30,363,333
7,73,2,44,390,346
7,73,3,13,369,356
7,73,4,110,478,368
7,73,5,54,509,455
7,73,6,106,531,425
7,74,0,19,364,345
7,74,1,22,358,336
7,74,2,41,400,359
7,74,3,13,376,363
7,74,4,105,474,369
7,74,5,52,530,478
7,74,6,118,579,461
7,75,0,31,401,370
7,75,1,37,402,365
7,75,2,34,393,359
7,75,3,12,376,364
7,75,4,100,501,401
7,75,5,54,508,454
7,75,6,117,553,436
7,76,0,31,367,336
7,76,1,44,415,371
7,76,2,34,424,390
7,76,3,12,413,401
7,76,4,101,456,355
7,76,5,56,512,456
7,76,6,106,546,440
7,77,0,57,434,377
7,77,1,52,418,366
7,77,2,16,388,372
7,77,3,21,428,407
7,77,4,112,498,386
7,77,5,67,573,506
7,77,6,79,534,455
7,78,0,40,403,363
7,78,1,86,514,428
7,78,2,111,531,420
7,78,3,33,442,409
7,78,4,145,573,428
7,78,5,79,550,471
7,78,6,78,529,451
7,79,0,77,440,363
7,79,1,95,468,373
7,79,2,82,465,383
7,79,3,42,453,411
7,79,4,166,541,375
7,79,5,137,643,506
7,79,6,111,587,476
7,80,0,101,489,388
7,80,1,67,445,378
7,80,2,114,526,412
7,80,3,73,503,430
7,80,4,194,614,420
7,80,5,135,691,556
7,80,6,110,578,468
7,81,0,80,444,364
7,81,1,72,456,384
7,81,2,142,550,408
7,81,3,80,499,419
7,81,4,197,618,421
7,81,5,149,679,530
7,81,6,102,556,454
7,82,0,69,488,419
7,82,1,59,466,407
7,82,2,102,503,401
7,82,3,78,516,438
7,82,4,232,673,441
7,82,5,147,676,529
7,82,6,78,565,487
7,83,0,78,440,362
7,83,1,68,469,401
7,83,2,111,501,390
7,83,3,27,407,380
7,83,4,212,596,384
7,83,5,199,793,594
7,83,6,72,573,501
7,84,0,57,424,367
7,84,1,57,426,369
7,84,2,69,471,402
7,84,3,59,481,422
7,84,4,219,596,377
7,84,5,110,676,566
7,84,6,95,627,532
7,85,0,62,437,375
7,85,1,76,447,371
7,85,2,60,444,384
7,85,3,24,421,397
7,85,4,232,629,397
7,85,5,177,724,547
7,85,6,80,579,499
7,86,0,87,463,376
7,86,1,74,451,377
7,86,2,71,430,359
7,86,3,46,455,409
7,86,4,199,570,371
7,86,5,207,738,531
7,86,6,123,613,490
7,87,0,63,455,392
7,87,1,58,443,385
7,87,2,53,480,427
7,87,3,38,421,383
7,87,4,235,650,415
7,87,5,176,754,578
7,87,6,136,635,499
7,88,0,73,495,422
7,88,1,55,433,378
7,88,2,51,442,391
7,88,3,40,424,384
7,88,4,227,645,418
7,88,5,186,741,555
7,88,6,148,612,464
7,89,0,73,431,358
7,89,1,76,447,371
7,89,2,43,443,400
7,89,3,59,462,403
7,89,4,221,651,430
7,89,5,200,697,497
7,89,6,127,594,467
7,90,0,150,528,378
7,90,1,90,510,420
7,90,2,77,487,410
7,90,3,88,481,393
7,90,4,286,695,409
7,90,5,199,753,554
7,90,6,190,681,491
7,91,0,207,568,361
7,91,1,107,485,378
7,91,2,197,588,391
7,91,3,106,546,440
7,91,4,317,727,410
7,91,5,233,755,522
7,91,6,285,755,470
7,92,0,231,580,349
7,92,1,212,597,385
7,92,2,261,647,386
7,92,3,87,474,387
7,92,4,332,700,368
7,92,5,282,756,474
7,92,6,320,757,437
7,93,0,56,568,512
7,93,1,108,591,483
7,93,2,115,567,452
7,93,3,22,533,511
7,93,4,167,807,640
7,93,5,237,767,530
7,93,6,299,829,530
7,94,0,57,482,425
7,94,1,56,471,415
7,94,2,103,517,414
7,94,3,27,485,458
7,94,4,279,786,507
7,94,5,307,818,511
7,94,6,396,867,471
7,95,0,73,439,366
7,95,1,77,499,422
7,95,2,122,534,412
7,95,3,99,526,427
7,95,4,302,807,505
7,95,5,374,861,487
7,95,6,310,770,460
7,96,0,42,487,445
7,96,1,25,466,441
7,96,2,94,555,461
7,96,3,34,567,533
7,96,4,383,886,503
7,96,5,241,910,669
7,96,6,163,784,621
7,97,0,44,460,416
7,97,1,46,484,438
7,97,2,185,613,428
7,97,3,32,556,524
7,97,4,465,951,486
7,97,5,321,876,555
7,97,6,181,699,518
7,98,0,49,539,490
7,98,1,73,554,481
7,98,2,190,635,445
7,98,3,44,585,541
7,98,4,443,941,498
7,98,5,393,1007,614
7,98,6,277,812,535
7,99,0,68,582,514
7,99,1,96,604,508
7,99,2,222,691,469
7,99,3,35,596,561
7,99,4,409,908,499
7,99,5,464,1101,637
7,99,6,318,868,550
7,100,0,65,559,494
7,100,1,160,694,534
7,100,2,238,714,476
7,100,3,54,605,551
7,100,4,496,1058,562
7,100,5,497,1126,629
7,100,6,312,837,525
7,101,0,155,794,639
7,101,1,181,832,651
7,101,2,270,849,579
7,101,3,225,889,664
7,101,4,504,1072,568
7,101,5,579,1184,605
7,101,6,318,885,567
7,102,0,624,1264,640
7,102,1,630,1405,775
7,102,2,467,1157,690
7,102,3,584,1406,822
7,102,4,867,1497,630
7,102,5,504,1206,702
7,102,6,253,820,567
7,103,0,622,1153,531
7,103,1,459,1111,652
7,103,2,481,1089,608
7,103,3,636,1331,695
7,103,4,919,1425,506
7,103,5,455,1158,703
7,103,6,163,738,575
7,104,0,713,1273,560
7,104,1,493,1151,658
7,104,2,633,1182,549
7,104,3,549,1188,639
7,104,4,939,1431,492
7,104,5,419,1069,650
7,104,6,221,795,574
7,105,0,813,1375,562
7,105,1,970,1639,669
7,105,2,923,1536,613
7,105,3,912,1657,745
7,105,4,1069,1623,554
7,105,5,413,1160,747
7,105,6,158,740,582
7,106,0,778,1311,533
7,106,1,868,1471,603
7,106,2,661,1223,562
7,106,3,464,1092,628
7,106,4,900,1399,499
7,106,5,298,968,670
7,106,6,47,564,517
7,107,0,633,1140,507
7,107,1,613,1193,580
7,107,2,719,1221,502
7,107,3,384,999,615
7,107,4,872,1336,464
7,107,5,216,853,637
7,107,6,16,516,500
7,108,0,738,1299,561
7,108,1,753,1392,639
7,108,2,836,1391,555
7,108,3,397,1028,631
7,108,4,730,1286,556
7,108,5,164,815,651
7,108,6,19,558,539
7,109,0,688,1241,553
7,109,1,628,1263,635
7,109,2,662,1240,578
7,109,3,342,983,641
7,109,4,641,1180,539
7,109,5,76,607,531
7,109,6,15,464,449
7,110,0,433,1068,635
7,110,1,357,1050,693
7,110,2,324,926,602
7,110,3,570,1244,674
7,110,4,466,1065,599
7,110,5,38,572,534
7,110,6,6,469,463
7,111,0,130,812,682
7,111,1,162,887,725
7,111,2,168,820,652
7,111,3,292,927,635
7,111,4,218,934,716
7,111,5,26,529,503
7,111,6,13,403,390
7,112,0,51,698,647
7,112,1,130,784,654
7,112,2,120,679,559
7,112,3,83,783,700
7,112,4,94,720,626
7,112,5,22,444,422
7,112,6,10,392,382
7,113,0,22,614,592
7,113,1,51,652,601
7,113,2,190,736,546
7,113,3,25,585,560
7,113,4,32,568,536
7,113,5,15,429,414
7,113,6,16,400,384
7,114,0,23,559,536
7,114,1,62,638,576
7,114,2,327,862,535
7,114,3,36,581,545
7,114,4,70,597,527
7,114,5,14,441,427
7,114,6,14,378,364
7,115,0,31,568,537
7,115,1,86,574,488
7,115,2,198,731,533
7,115,3,39,615,576
7,115,4,63,576,513
7,115,5,17,349,332
7,115,6,14,389,375
7,116,0,30,510,480
7,116,1,67,585,518
7,116,2,302,844,542
7,116,3,27,527,500
7,116,4,55,537,482
7,116,5,13,376,363
7,116,6,27,406,379
7,117,0,30,506,476
7,117,1,55,574,519
7,117,2,309,789,480
7,117,3,28,496,468
7,117,4,50,484,434
7,117,5,10,376,366
7,117,6,16,352,336
7,118,0,68,576,508
7,118,1,122,643,521
7,118,2,252,720,468
7,118,3,23,510,487
7,118,4,48,496,448
7,118,5,20,398,378
7,118,6,62,417,355
7,119,0,125,591,466
7,119,1,182,687,505
7,119,2,258,849,591
7,119,3,28,533,505
7,119,4,80,536,456
7,119,5,33,395,362
7,119,6,107,459,352
7,120,0,41,642,601
7,120,1,77,651,574
7,120,2,193,860,667
7,120,3,32,611,579
7,120,4,35,562,527
7,120,5,25,483,458
7,120,6,52,503,451
7,121,0,83,664,581
7,121,1,93,641,548
7,121,2,299,926,627
7,121,3,68,600,532
7,121,4,58,540,482
7,121,5,32,496,464
7,121,6,37,410,373
7,122,0,114,661,547
7,122,1,82,571,489
7,122,2,348,968,620
7,122,3,159,739,580
7,122,4,36,510,474
7,122,5,38,390,352
7,122,6,58,438,380
7,123,0,195,728,533
7,123,1,131,733,602
7,123,2,352,948,596
7,123,3,203,774,571
7,123,4,32,501,469
7,123,5,21,434,413
7,123,6,50,458,408
7,124,0,120,639,519
7,124,1,109,610,501
7,124,2,249,810,561
7,124,3,127,679,552
7,124,4,132,567,435
7,124,5,19,413,394
7,124,6,54,425,371
7,125,0,95,576,481
7,125,1,98,541,443
7,125,2,179,712,533
7,125,3,150,656,506
7,125,4,160,600,440
7,125,5,26,431,405
7,125,6,35,337,302
7,126,0,293,740,447
7,126,1,256,785,529
7,126,2,405,984,579
7,126,3,198,690,492
7,126,4,183,625,442
7,126,5,43,496,453
7,126,6,19,308,289
7,127,0,428,818,390
7,127,1,317,725,408
7,127,2,459,979,520
7,127,3,285,771,486
7,127,4,235,658,423
7,127,5,36,460,424
7,127,6,22,354,332
7,128,0,343,698,355
7,128,1,367,788,421
7,128,2,355,827,472
7,128,3,296,727,431
7,128,4,212,655,443
7,128,5,19,372,353
7,128,6,28,371,343
7,129,0,343,708,365
7,129,1,413,860,447
7,129,2,328,797,469
7,129,3,269,705,436
7,129,4,198,615,417
7,129,5,34,390,356
7,129,6,12,325,313
7,130,0,269,643,374
7,130,1,286,704,418
7,130,2,268,746,478
7,130,3,273,695,422
7,130,4,183,600,417
7,130,5,52,405,353
7,130,6,21,315,294
7,131,0,95,435,340
7,131,1,220,630,410
7,131,2,99,556,457
7,131,3,159,557,398
7,131,4,111,485,374
7,131,5,113,515,402
7,131,6,8,279,271
7,132,0,111,524,413
7,132,1,194,580,386
7,132,2,93,597,504
7,132,3,91,518,427
7,132,4,130,541,411
7,132,5,154,497,343
7,132,6,11,317,306
7,133,0,98,449,351
7,133,1,138,513,375
7,133,2,63,509,446
7,133,3,51,430,379
7,133,4,105,466,361
7,133,5,177,493,316
7,133,6,17,284,267
7,134,0,15,310,295
7,134,1,42,335,293
7,134,2,18,346,328
7,134,3,50,411,361
7,134,4,30,380,350
7,134,5,77,403,326
7,134,6,4,238,234
7,135,0,18,308,290
7,135,1,13,320,307
7,135,2,11,359,348
7,135,3,24,371,347
7,135,4,29,345,316
7,135,5,41,307,266
7,135,6,11,247,236
7,136,0,10,233,223
7,136,1,12,287,275
7,136,2,17,317,300
7,136,3,19,297,278
7,136,4,15,323,308
7,136,5,33,293,260
7,136,6,7,204,197
7,137,0,6,209,203
7,137,1,17,263,246
7,137,2,11,248,237
7,137,3,11,219,208
7,137,4,10,287,277
7,137,5,63,422,359
7,137,6,10,191,181
7,138,0,9,205,196
7,138,1,13,212,199
7,138,2,9,250,241
7,138,3,10,244,234
7,138,4,11,224,213
7,138,5,282,655,373
7,138,6,9,168,159
7,139,0,12,191,179
7,139,1,8,207,199
7,139,2,13,203,190
7,139,3,10,218,208
7,139,4,6,242,236
7,139,5,279,602,323
7,139,6,7,156,149
7,140,0,9,154,145
7,140,1,16,216,200
7,140,2,10,227,217
7,140,3,20,256,236
7,140,4,15,215,200
7,140,5,125,398,273
7,140,6,6,154,148
7,141,0,12,201,189
7,141,1,19,222,203
7,141,2,9,226,217
7,141,3,22,206,184
7,141,4,5,193,188
7,141,5,22,295,273
7,141,6,9,144,135
7,142,0,13,176,163
7,142,1,15,189,174
7,142,2,8,188,180
7,142,3,32,194,162
7,142,4,9,203,194
7,142,5,19,230,211
7,142,6,8,172,164
7,143,0,16,165,149
7,143,1,12,170,158
7,143,2,12,180,168
7,143,3,24,198,174
7,143,4,8,182,174
7,143,5,14,201,187
7,143,6,2,148,146
8,0,0,30,318,288
8,0,1,18,265,247
8,0,2,22,300,278
8,0,3,14,265,251
8,0,4,24,404,380
8,0,5,12,336,324
8,0,6,30,382,352
8,1,0,35,253,218
8,1,1,15,233,218
8,1,2,26,282,256
8,1,3,25,242,217
8,1,4,26,464,438
8,1,5,6,283,277
8,1,6,23,345,322
8,2,0,17,222,205
8,2,1,25,212,187
8,2,2,20,234,214
8,2,3,28,227,199
8,2,4,17,429,412
8,2,5,20,280,260
8,2,6,25,312,287
8,3,0,15,188,173
8,3,1,30,226,196
8,3,2,17,191,174
8,3,3,20,227,207
8,3,4,15,375,360
8,3,5,19,288,269
8,3,6,26,270,244
8,4,0,14,182,168
8,4,1,12,178,166
8,4,2,21,208,187
8,4,3,25,185,160
8,4,4,14,348,334
8,4,5,14,244,230
8,4,6,24,236,212
8,5,0,11,150,139
8,5,1,18,167,149
8,5,2,11,151,140
8,5,3,18,166,148
8,5,4,26,341,315
8,5,5,9,216,207
8,5,6,17,267,250
8,6,0,14,177,163
8,6,1,16,159,143
8,6,2,15,162,147
8,6,3,19,172,153
8,6,4,12,315,303
8,6,5,13,220,207
8,6,6,41,274,233
8,7,0,15,138,123
8,7,1,17,168,151
8,7,2,18,176,158
8,7,3,24,169,145
8,7,4,20,284,264
8,7,5,10,175,165
8,7,6,21,206,185
8,8,0,14,117,103
8,8,1,15,120,105
8,8,2,6,141,135
8,8,3,23,160,137
8,8,4,10,272,262
8,8,5,12,170,158
8,8,6,19,177,158
8,9,0,14,116,102
8,9,1,16,153,137
8,9,2,7,102,95
8,9,3,13,116,103
8,9,4,8,231,223
8,9,5,16,168,152
8,9,6,32,202,170
8,10,0,8,95,87
8,10,1,18,145,127
8,10,2,12,121,109
8,10,3,19,106,87
8,10,4,8,212,204
8,10,5,8,137,129
8,10,6,19,147,128
8,11,0,2,98,96
8,11,1,24,121,97
8,11,2,10,107,97
8,11,3,23,119,96
8,11,4,7,190,183
8,11,5,8,128,120
8,11,6,29,167,138
8,12,0,28,136,108
8,12,1,28,117,89
8,12,2,8,95,87
8,12,3,21,111,90
8,12,4,13,205,192
8,12,5,15,135,120
8,12,6,50,192,142
8,13,0,17,102,85
8,13,1,6,86,80
8,13,2,9,85,76
8,13,3,23,107,84
8,13,4,20,181,161
8,13,5,76,200,124
8,13,6,27,149,122
8,14,0,9,95,86
8,14,1,5,65,60
8,14,2,7,89,82
8,14,3,18,96,78
8,14,4,26,180,154
8,14,5,79,182,103
8,14,6,33,132,99
8,15,0,5,67,62
8,15,1,4,55,51
8,15,2,5,84,79
8,15,3,9,77,68
8,15,4,31,168,137
8,15,5,41,140,99
8,15,6,7,95,88
8,16,0,6,57,51
8,16,1,7,63,56
8,16,2,13,66,53
8,16,3,4,67,63
8,16,4,20,137,117
8,16,5,22,114,92
8,16,6,17,114,97
8,17,0,5,69,64
8,17,1,6,63,57
8,17,2,2,60,58
8,17,3,2,56,54
8,17,4,37,151,114
8,17,5,33,120,87
8,17,6,17,108,91
8,18,0,9,54,45
8,18,1,6,60,54
8,18,2,1,66,65
8,18,3,9,60,51
8,18,4,80,161,81
8,18,5,14,84,70
8,18,6,15,105,90
8,19,0,3,60,57
8,19,1,5,59,54
8,19,2,4,61,57
8,19,3,5,56,51
8,19,4,96,178,82
8,19,5,9,72,63
8,19,6,15,78,63
8,20,0,6,60,54
8,20,1,12,55,43
8,20,2,1,43,42
8,20,3,3,48,45
8,20,4,59,115,56
8,20,5,4,65,61
8,20,6,8,74,66
8,21,0,5,46,41
8,21,1,1,43,42
8,21,2,1,42,41
8,21,3,4,47,43
8,21,4,36,105,69
8,21,5,5,66,61
8,21,6,10,71,61
8,22,0,9,29,20
8,22,1,1,26,25
8,22,2,5,44,39
8,22,3,2,36,34
8,22,4,44,92,48
8,22,5,10,53,43
8,22,6,7,57,50
8,23,0,3,26,23
8,23,1,0,36,36
8,23,2,0,31,31
8,23,3,5,46,41
8,23,4,33,81,48
8,23,5,10,58,48
8,23,6,11,77,66
8,24,0,3,37,34
8,24,1,3,43,40
8,24,2,10,41,31
8,24,3,4,44,40
8,24,4,35,85,50
8,24,5,7,49,42
8,24,6,4,53,49
8,25,0,6,45,39
8,25,1,1,21,20
8,25,2,4,27,23
8,25,3,3,36,33
8,25,4,25,66,41
8,25,5,3,31,28
8,25,6,4,54,50
8,26,0,5,25,20
8,26,1,7,36,29
8,26,2,8,42,34
8,26,3,13,44,31
8,26,4,58,102,44
8,26,5,5,35,30
8,26,6,12,47,35
8,27,0,4,31,27
8,27,1,3,33,30
8,27,2,6,44,38
8,27,3,11,45,34
8,27,4,59,97,38
8,27,5,8,43,35
8,27,6,5,41,36
8,28,0,2,33,31
8,28,1,8,34,26
8,28,2,9,31,22
8,28,3,11,36,25
8,28,4,33,61,28
8,28,5,7,35,28
8,28,6,0,35,35
8,29,0,11,43,32
8,29,1,9,44,35
8,29,2,4,30,26
8,29,3,5,37,32
8,29,4,53,96,43
8,29,5,12,50,38
8,29,6,9,37,28
8,30,0,11,36,25
8,30,1,4,27,23
8,30,2,12,52,40
8,30,3,13,52,39
8,30,4,73,111,38
8,30,5,11,40,29
8,30,6,13,47,34
8,31,0,7,35,28
8,31,1,7,42,35
8,31,2,9,40,31
8,31,3,15,42,27
8,31,4,61,85,24
8,31,5,13,44,31
8,31,6,14,45,31
8,32,0,12,50,38
8,32,1,9,47,38
8,32,2,11,51,40
8,32,3,17,51,34
8,32,4,96,123,27
8,32,5,14,50,36
8,32,6,8,40,32
8,33,0,24,54,30
8,33,1,13,44,31
8,33,2,13,52,39
8,33,3,18,44,26
8,33,4,101,141,40
8,33,5,12,49,37
8,33,6,25,57,32
8,34,0,20,46,26
8,34,1,22,50,28
8,34,2,15,60,45
8,34,3,19,55,36
8,34,4,129,158,29
8,34,5,13,45,32
8,34,6,32,63,31
8,35,0,33,60,27
8,35,1,30,58,28
8,35,2,19,56,37
8,35,3,23,61,38
8,35,4,164,205,41
8,35,5,12,48,36
8,35,6,24,64,40
8,36,0,58,102,44
8,36,1,31,82,51
8,36,2,21,68,47
8,36,3,39,72,33
8,36,4,230,275,45
8,36,5,51,94,43
8,36,6,45,83,38
8,37,0,61,102,41
8,37,1,47,84,37
8,37,2,42,93,51
8,37,3,44,85,41
8,37,4,284,328,44
8,37,5,63,108,45
8,37,6,34,72,38
8,38,0,64,134,70
8,38,1,83,138,55
8,38,2,71,136,65
8,38,3,54,112,58
8,38,4,355,410,55
8,38,5,57,101,44
8,38,6,39,76,37
8,39,0,14,303,289
8,39,1,12,275,263
8,39,2,3,238,235
8,39,3,14,252,238
8,39,4,293,474,181
8,39,5,23,144,121
8,39,6,22,107,85
8,40,0,42,364,322
8,40,1,14,318,304
8,40,2,11,289,278
8,40,3,16,295,279
8,40,4,352,550,198
8,40,5,32,175,143
8,40,6,44,164,120
8,41,0,175,603,428
8,41,1,19,406,387
8,41,2,37,457,420
8,41,3,11,360,349
8,41,4,384,701,317
8,41,5,49,199,150
8,41,6,59,191,132
8,42,0,407,925,518
8,42,1,57,677,620
8,42,2,82,691,609
8,42,3,70,594,524
8,42,4,401,834,433
8,42,5,49,264,215
8,42,6,56,211,155
8,43,0,711,1282,571
8,43,1,111,759,648
8,43,2,147,867,720
8,43,3,226,823,597
8,43,4,410,908,498
8,43,5,92,360,268
8,43,6,82,254,172
8,44,0,1271,1829,558
8,44,1,480,1222,742
8,44,2,442,1161,719
8,44,3,433,1179,746
8,44,4,604,1155,551
8,44,5,114,453,339
8,44,6,121,374,253
8,45,0,1247,1775,528
8,45,1,874,1493,619
8,45,2,1011,1716,705
8,45,3,807,1566,759
8,45,4,753,1323,570
8,45,5,111,507,396
8,45,6,132,416,284
8,46,0,1169,1727,558
8,46,1,1222,1839,617
8,46,2,1349,2029,680
8,46,3,688,1459,771
8,46,4,829,1379,550
8,46,5,196,602,406
8,46,6,162,457,295
8,47,0,1442,2035,593
8,47,1,1987,2596,609
8,47,2,1471,2152,681
8,47,3,855,1625,770
8,47,4,1064,1623,559
8,47,5,233,742,509
8,47,6,192,536,344
8,48,0,1603,2223,620
8,48,1,2342,2987,645
8,48,2,1620,2288,668
8,48,3,1093,1856,763
8,48,4,1103,1651,548
8,48,5,433,983,550
8,48,6,155,600,445
8,49,0,1677,2312,635
8,49,1,1820,2567,747
8,49,2,1537,2351,814
8,49,3,1090,2027,937
8,49,4,921,1614,693
8,49,5,417,1028,611
8,49,6,207,686,479
8,50,0,1548,2308,760
8,50,1,1922,2778,856
8,50,2,1427,2361,934
8,50,3,991,1973,982
8,50,4,789,1507,718
8,50,5,282,910,628
8,50,6,109,629,520
8,51,0,1769,2646,877
8,51,1,1583,2503,920
8,51,2,1504,2504,1000
8,51,3,1040,2105,1065
8,51,4,819,1610,791
8,51,5,380,1003,623
8,51,6,141,677,536
8,52,0,1674,2626,952
8,52,1,1200,2210,1010
8,52,2,1196,2277,1081
8,52,3,736,1907,1171
8,52,4,667,1551,884
8,52,5,343,985,642
8,52,6,131,674,543
8,53,0,966,2113,1147
8,53,1,853,2075,1222
8,53,2,614,1885,1271
8,53,3,404,1643,1239
8,53,4,490,1455,965
8,53,5,72,744,672
8,53,6,40,579,539
8,54,0,450,1633,1183
8,54,1,371,1736,1365
8,54,2,149,1476,1327
8,54,3,164,1475,1311
8,54,4,163,1185,1022
8,54,5,33,706,673
8,54,6,34,609,575
8,55,0,484,1697,1213
8,55,1,422,1625,1203
8,55,2,133,1385,1252
8,55,3,119,1343,1224
8,55,4,219,1186,967
8,55,5,41,715,674
8,55,6,22,561,539
8,56,0,253,1360,1107
8,56,1,275,1465,1190
8,56,2,108,1235,1127
8,56,3,74,1167,1093
8,56,4,195,1073,878
8,56,5,56,781,725
8,56,6,16,626,610
8,57,0,221,1084,863
8,57,1,347,1255,908
8,57,2,287,1279,992
8,57,3,126,1076,950
8,57,4,234,1019,785
8,57,5,111,804,693
8,57,6,33,635,602
8,58,0,182,957,775
8,58,1,398,1275,877
8,58,2,267,1201,934
8,58,3,150,1059,909
8,58,4,263,978,715
8,58,5,167,899,732
8,58,6,49,666,617
8,59,0,89,815,726
8,59,1,214,1013,799
8,59,2,157,1080,923
8,59,3,87,923,836
8,59,4,222,858,636
8,59,5,142,836,694
8,59,6,64,662,598
8,60,0,57,748,691
8,60,1,109,814,705
8,60,2,121,849,728
8,60,3,66,808,742
8,60,4,237,845,608
8,60,5,96,850,754
8,60,6,23,701,678
8,61,0,28,659,631
8,61,1,81,784,703
8,61,2,86,717,631
8,61,3,42,750,708
8,61,4,279,844,565
8,61,5,94,763,669
8,61,6,40,669,629
8,62,0,23,654,631
8,62,1,63,667,604
8,62,2,87,754,667
8,62,3,50,729,679
8,62,4,233,822,589
8,62,5,91,818,727
8,62,6,28,693,665
8,63,0,20,658,638
8,63,1,41,669,628
8,63,2,38,640,602
8,63,3,44,669,625
8,63,4,271,823,552
8,63,5,124,811,687
8,63,6,34,682,648
8,64,0,18,604,586
8,64,1,32,576,544
8,64,2,69,648,579
8,64,3,40,656,616
8,64,4,274,822,548
8,64,5,134,844,710
8,64,6,75,707,632
8,65,0,28,605,577
8,65,1,38,581,543
8,65,2,82,677,595
8,65,3,16,572,556
8,65,4,288,832,544
8,65,5,90,798,708
8,65,6,69,719,650
8,66,0,26,551,525
8,66,1,24,584,560
8,66,2,74,645,571
8,66,3,22,585,563
8,66,4,269,855,586
8,66,5,145,871,726
8,66,6,127,781,654
8,67,0,23,565,542
8,67,1,27,598,571
8,67,2,81,652,571
8,67,3,26,581,555
8,67,4,269,795,526
8,67,5,139,789,650
8,67,6,206,866,660
8,68,0,17,562,545
8,68,1,65,674,609
8,68,2,117,712,595
8,68,3,27,640,613
8,68,4,280,823,543
8,68,5,131,860,729
8,68,6,170,859,689
8,69,0,20,613,593
8,69,1,77,688,611
8,69,2,172,742,570
8,69,3,21,656,635
8,69,4,309,878,569
8,69,5,214,919,705
8,69,6,251,942,691
8,70,0,22,608,586
8,70,1,92,667,575
8,70,2,139,716,577
8,70,3,33,669,636
8,70,4,304,891,587
8,70,5,206,943,737
8,70,6,224,889,665
8,71,0,32,655,623
8,71,1,57,616,559
8,71,2,120,701,581
8,71,3,28,636,608
8,71,4,303,846,543
8,71,5,174,924,750
8,71,6,264,999,735
8,72,0,48,697,649
8,72,1,110,690,580
8,72,2,57,712,655
8,72,3,29,719,690
8,72,4,236,849,613
8,72,5,145,917,772
8,72,6,90,774,684
8,73,0,39,636,597
8,73,1,128,701,573
8,73,2,113,718,605
8,73,3,22,625,603
8,73,4,195,737,542
8,73,5,242,986,744
8,73,6,145,908,763
8,74,0,46,678,632
8,74,1,132,743,611
8,74,2,78,699,621
8,74,3,28,641,613
8,74,4,185,767,582
8,74,5,209,943,734
8,74,6,127,923,796
8,75,0,110,747,637
8,75,1,125,710,585
8,75,2,71,718,647
8,75,3,24,656,632
8,75,4,197,797,600
8,75,5,223,1022,799
8,75,6,158,1009,851
8,76,0,103,790,687
8,76,1,112,706,594
8,76,2,76,731,655
8,76,3,45,701,656
8,76,4,223,887,664
8,76,5,209,1091,882
8,76,6,121,936,815
8,77,0,97,710,613
8,77,1,205,860,655
8,77,2,81,774,693
8,77,3,66,728,662
8,77,4,197,878,681
8,77,5,224,1019,795
8,77,6,105,967,862
8,78,0,122,799,677
8,78,1,175,833,658
8,78,2,169,826,657
8,78,3,129,823,694
8,78,4,267,917,650
8,78,5,412,1290,878
8,78,6,148,983,835
8,79,0,192,821,629
8,79,1,190,823,633
8,79,2,218,891,673
8,79,3,186,844,658
8,79,4,273,915,642
8,79,5,435,1215,780
8,79,6,126,1000,874
8,80,0,233,844,611
8,80,1,220,911,691
8,80,2,299,995,696
8,80,3,160,850,690
8,80,4,328,947,619
8,80,5,408,1271,863
8,80,6,127,1013,886
8,81,0,189,848,659
8,81,1,184,861,677
8,81,2,300,961,661
8,81,3,180,850,670
8,81,4,341,991,650
8,81,5,436,1260,824
8,81,6,279,1158,879
8,82,0,176,812,636
8,82,1,153,797,644
8,82,2,283,944,661
8,82,3,156,834,678
8,82,4,370,1012,642
8,82,5,356,1119,763
8,82,6,314,1260,946
8,83,0,182,798,616
8,83,1,178,796,618
8,83,2,318,1018,700
8,83,3,177,845,668
8,83,4,279,897,618
8,83,5,336,1197,861
8,83,6,287,1207,920
8,84,0,135,814,679
8,84,1,130,748,618
8,84,2,244,884,640
8,84,3,126,791,665
8,84,4,284,925,641
8,84,5,263,1121,858
8,84,6,168,1115,947
8,85,0,193,808,615
8,85,1,133,807,674
8,85,2,247,916,669
8,85,3,76,727,651
8,85,4,305,923,618
8,85,5,278,1195,917
8,85,6,124,1043,919
8,86,0,183,786,603
8,86,1,135,735,600
8,86,2,228,871,643
8,86,3,78,736,658
8,86,4,338,988,650
8,86,5,207,1093,886
8,86,6,183,1156,973
8,87,0,200,855,655
8,87,1,104,781,677
8,87,2,111,877,766
8,87,3,99,751,652
8,87,4,291,940,649
8,87,5,164,972,808
8,87,6,242,1158,916
8,88,0,153,825,672
8,88,1,111,796,685
8,88,2,145,807,662
8,88,3,97,715,618
8,88,4,284,880,596
8,88,5,170,1036,866
8,88,6,202,1182,980
8,89,0,145,765,620
8,89,1,115,749,634
8,89,2,149,807,658
8,89,3,109,745,636
8,89,4,299,941,642
8,89,5,133,952,819
8,89,6,88,1003,915
8,90,0,178,838,660
8,90,1,76,725,649
8,90,2,134,801,667
8,90,3,143,794,651
8,90,4,389,1049,660
8,90,5,80,928,848
8,90,6,149,1056,907
8,91,0,429,1034,605
8,91,1,192,857,665
8,91,2,254,948,694
8,91,3,119,753,634
8,91,4,398,1014,616
8,91,5,97,860,763
8,91,6,170,1102,932
8,92,0,475,1080,605
8,92,1,333,992,659
8,92,2,310,980,670
8,92,3,142,811,669
8,92,4,393,1008,615
8,92,5,153,982,829
8,92,6,243,1191,948
8,93,0,50,834,784
8,93,1,164,900,736
8,93,2,205,929,724
8,93,3,28,734,706
8,93,4,41,899,858
8,93,5,61,914,853
8,93,6,218,1210,992
8,94,0,28,670,642
8,94,1,143,820,677
8,94,2,150,808,658
8,94,3,24,758,734
8,94,4,22,800,778
8,94,5,104,959,855
8,94,6,283,1140,857
8,95,0,62,706,644
8,95,1,113,755,642
8,95,2,222,890,668
8,95,3,81,804,723
8,95,4,32,822,790
8,95,5,235,1087,852
8,95,6,379,1279,900
8,96,0,35,762,727
8,96,1,24,827,803
8,96,2,92,877,785
8,96,3,21,795,774
8,96,4,43,873,830
8,96,5,33,967,934
8,96,6,28,1103,1075
8,97,0,35,734,699
8,97,1,50,860,810
8,97,2,206,963,757
8,97,3,28,764,736
8,97,4,95,965,870
8,97,5,26,893,867
8,97,6,28,987,959
8,98,0,18,813,795
8,98,1,48,854,806
8,98,2,159,910,751
8,98,3,26,838,812
8,98,4,87,907,820
8,98,5,19,876,857
8,98,6,39,1030,991
8,99,0,38,812,774
8,99,1,60,929,869
8,99,2,209,1011,802
8,99,3,36,868,832
8,99,4,157,1048,891
8,99,5,36,949,913
8,99,6,52,1046,994
8,100,0,53,914,861
8,100,1,55,857,802
8,100,2,212,986,774
8,100,3,40,897,857
8,100,4,130,980,850
8,100,5,27,970,943
8,100,6,64,1092,1028
8,101,0,43,1021,978
8,101,1,55,966,911
8,101,2,352,1281,929
8,101,3,86,1129,1043
8,101,4,147,1097,950
8,101,5,30,1027,997
8,101,6,61,1049,988
8,102,0,145,1226,1081
8,102,1,251,1374,1123
8,102,2,541,1598,1057
8,102,3,221,1418,1197
8,102,4,286,1331,1045
8,102,5,30,1093,1063
8,102,6,46,1142,1096
8,103,0,205,1223,1018
8,103,1,313,1347,1034
8,103,2,499,1513,1014
8,103,3,311,1389,1078
8,103,4,375,1341,966
8,103,5,30,1135,1105
8,103,6,53,1140,1087
8,104,0,272,1276,1004
8,104,1,357,1494,1137
8,104,2,587,1595,1008
8,104,3,306,1493,1187
8,104,4,531,1528,997
8,104,5,50,1125,1075
8,104,6,55,1091,1036
8,105,0,654,1888,1234
8,105,1,596,1863,1267
8,105,2,928,2107,1179
8,105,3,668,1930,1262
8,105,4,894,1928,1034
8,105,5,39,1170,1131
8,105,6,35,1082,1047
8,106,0,732,1790,1058
8,106,1,509,1663,1154
8,106,2,855,1955,1100
8,106,3,450,1593,1143
8,106,4,687,1654,967
8,106,5,48,1167,1119
8,106,6,19,987,968
8,107,0,515,1554,1039
8,107,1,422,1545,1123
8,107,2,894,1929,1035
8,107,3,389,1439,1050
8,107,4,696,1607,911
8,107,5,36,1034,998
8,107,6,24,983,959
8,108,0,553,1677,1124
8,108,1,538,1813,1275
8,108,2,1063,2200,1137
8,108,3,447,1674,1227
8,108,4,761,1773,1012
8,108,5,37,1095,1058
8,108,6,23,1031,1008
8,109,0,564,1678,1114
8,109,1,476,1679,1203
8,109,2,899,2019,1120
8,109,3,326,1496,1170
8,109,4,636,1634,998
8,109,5,34,972,938
8,109,6,16,990,974
8,110,0,322,1498,1176
8,110,1,336,1541,1205
8,110,2,483,1498,1015
8,110,3,293,1459,1166
8,110,4,387,1469,1082
8,110,5,27,1050,1023
8,110,6,25,895,870
8,111,0,81,1212,1131
8,111,1,123,1281,1158
8,111,2,358,1453,1095
8,111,3,98,1197,1099
8,111,4,141,1232,1091
8,111,5,30,1006,976
8,111,6,20,922,902
8,112,0,41,1091,1050
8,112,1,104,1160,1056
8,112,2,261,1296,1035
8,112,3,51,1071,1020
8,112,4,95,1137,1042
8,112,5,38,1022,984
8,112,6,16,870,854
8,113,0,44,995,951
8,113,1,57,1016,959
8,113,2,185,1258,1073
8,113,3,31,975,944
8,113,4,57,1072,1015
8,113,5,25,885,860
8,113,6,18,898,880
8,114,0,32,957,925
8,114,1,60,1017,957
8,114,2,251,1213,962
8,114,3,29,936,907
8,114,4,68,1075,1007
8,114,5,26,855,829
8,114,6,31,903,872
8,115,0,44,928,884
8,115,1,53,1006,953
8,115,2,161,1142,981
8,115,3,34,907,873
8,115,4,61,977,916
8,115,5,22,798,776
8,115,6,24,887,863
8,116,0,46,994,948
8,116,1,44,916,872
8,116,2,246,1249,1003
8,116,3,34,897,863
8,116,4,70,998,928
8,116,5,28,869,841
8,116,6,29,896,867
8,117,0,52,990,938
8,117,1,42,913,871
8,117,2,208,1172,964
8,117,3,41,941,900
8,117,4,50,885,835
8,117,5,20,837,817
8,117,6,36,885,849
8,118,0,44,895,851
8,118,1,53,911,858
8,118,2,131,1035,904
8,118,3,22,791,769
8,118,4,62,973,911
8,118,5,28,828,800
8,118,6,21,797,776
8,119,0,87,984,897
8,119,1,162,1117,955
8,119,2,103,1032,929
8,119,3,31,887,856
8,119,4,77,937,860
8,119,5,43,835,792
8,119,6,60,899,839
8,120,0,41,970,929
8,120,1,54,1082,1028
8,120,2,68,1050,982
8,120,3,38,1012,974
8,120,4,25,983,958
8,120,5,25,915,890
8,120,6,25,938,913
8,121,0,63,1010,947
8,121,1,81,1151,1070
8,121,2,66,1114,1048
8,121,3,32,939,907
8,121,4,36,956,920
8,121,5,28,938,910
8,121,6,28,871,843
8,122,0,51,1003,952
8,122,1,81,1108,1027
8,122,2,79,1139,1060
8,122,3,37,927,890
8,122,4,51,1018,967
8,122,5,20,933,913
8,122,6,34,934,900
8,123,0,84,1073,989
8,123,1,114,1214,1100
8,123,2,61,1230,1169
8,123,3,66,1104,1038
8,123,4,67,1096,1029
8,123,5,35,983,948
8,123,6,57,977,920
8,124,0,65,1046,981
8,124,1,93,1137,1044
8,124,2,87,1171,1084
8,124,3,61,1025,964
8,124,4,115,1117,1002
8,124,5,27,1007,980
8,124,6,52,938,886
8,125,0,60,982,922
8,125,1,85,1093,1008
8,125,2,74,1157,1083
8,125,3,74,1042,968
8,125,4,112,1132,1020
8,125,5,38,1015,977
8,125,6,34,862,828
8,126,0,247,1343,1096
8,126,1,269,1442,1173
8,126,2,179,1437,1258
8,126,3,104,1133,1029
8,126,4,232,1238,1006
8,126,5,36,1023,987
8,126,6,45,906,861
8,127,0,359,1348,989
8,127,1,281,1358,1077
8,127,2,222,1350,1128
8,127,3,135,1157,1022
8,127,4,305,1306,1001
8,127,5,67,1029,962
8,127,6,46,934,888
8,128,0,331,1316,985
8,128,1,311,1334,1023
8,128,2,135,1215,1080
8,128,3,182,1138,956
8,128,4,290,1301,1011
8,128,5,66,964,898
8,128,6,53,883,830
8,129,0,281,1232,951
8,129,1,394,1460,1066
8,129,2,97,1216,1119
8,129,3,140,1164,1024
8,129,4,326,1322,996
8,129,5,169,1164,995
8,129,6,38,816,778
8,130,0,183,1038,855
8,130,1,216,1206,990
8,130,2,78,1057,979
8,130,3,106,992,886
8,130,4,307,1272,965
8,130,5,337,1291,954
8,130,6,21,725,704
8,131,0,84,918,834
8,131,1,159,1006,847
8,131,2,37,1015,978
8,131,3,85,930,845
8,131,4,203,1154,951
8,131,5,406,1268,862
8,131,6,16,698,682
8,132,0,64,835,771
8,132,1,157,1038,881
8,132,2,46,986,940
8,132,3,49,872,823
8,132,4,233,1154,921
8,132,5,515,1394,879
8,132,6,18,726,708
8,133,0,51,770,719
8,133,1,91,855,764
8,133,2,36,865,829
8,133,3,38,758,720
8,133,4,177,1038,861
8,133,5,483,1232,749
8,133,6,22,608,586
8,134,0,15,607,592
8,134,1,41,676,635
8,134,2,37,703,666
8,134,3,22,619,597
8,134,4,54,762,708
8,134,5,297,1002,705
8,134,6,13,542,529
8,135,0,16,503,487
8,135,1,19,598,579
8,135,2,20,622,602
8,135,3,21,604,583
8,135,4,37,708,671
8,135,5,164,801,637
8,135,6,15,496,481
8,136,0,16,468,452
8,136,1,14,472,458
8,136,2,14,507,493
8,136,3,23,495,472
8,136,4,19,552,533
8,136,5,34,607,573
8,136,6,14,439,425
8,137,0,21,421,400
8,137,1,15,477,462
8,137,2,12,429,417
8,137,3,11,406,395
8,137,4,22,496,474
8,137,5,29,565,536
8,137,6,13,411,398
8,138,0,21,415,394
8,138,1,15,363,348
8,138,2,16,407,391
8,138,3,22,443,421
8,138,4,15,441,426
8,138,5,17,498,481
8,138,6,11,388,377
8,139,0,13,339,326
8,139,1,8,360,352
8,139,2,8,364,356
8,139,3,19,358,339
8,139,4,12,404,392
8,139,5,31,497,466
8,139,6,33,356,323
8,140,0,10,254,244
8,140,1,11,284,273
8,140,2,12,364,352
8,140,3,19,346,327
8,140,4,7,374,367
8,140,5,19,392,373
8,140,6,14,279,265
8,141,0,7,278,271
8,141,1,7,243,236
8,141,2,17,333,316
8,141,3,17,307,290
8,141,4,14,365,351
8,141,5,15,376,361
8,141,6,16,308,292
8,142,0,13,263,250
8,142,1,6,258,252
8,142,2,8,287,279
8,142,3,16,319,303
8,142,4,15,333,318
8,142,5,12,372,360
8,142,6,9,310,301
8,143,0,15,248,233
8,143,1,18,258,240
8,143,2,8,285,277
8,143,3,14,247,233
8,143,4,13,333,320
8,143,5,21,369,348
8,143,6,12,268,256
9,0,0,22,60,38
9,0,1,6,51,45
9,0,2,13,52,39
9,0,3,6,43,37
9,0,4,0,34,34
9,0,5,2,49,47
9,0,6,8,42,34
9,1,0,7,27,20
9,1,1,8,28,20
9,1,2,8,31,23
9,1,3,3,33,30
9,1,4,4,37,33
9,1,5,2,34,32
9,1,6,6,36,30
9,2,0,5,28,23
9,2,1,6,36,30
9,2,2,6,24,18
9,2,3,7,39,32
9,2,4,4,39,35
9,2,5,7,30,23
9,2,6,7,32,25
9,3,0,2,26,24
9,3,1,6,27,21
9,3,2,5,21,16
9,3,3,9,33,24
9,3,4,5,55,50
9,3,5,7,27,20
9,3,6,1,33,32
9,4,0,4,28,24
9,4,1,5,25,20
9,4,2,1,27,26
9,4,3,3,22,19
9,4,4,6,51,45
9,4,5,5,31,26
9,4,6,4,30,26
9,5,0,2,21,19
9,5,1,5,18,13
9,5,2,4,16,12
9,5,3,2,27,25
9,5,4,2,37,35
9,5,5,3,29,26
9,5,6,3,28,25
9,6,0,8,20,12
9,6,1,5,20,15
9,6,2,3,23,20
9,6,3,4,18,14
9,6,4,2,33,31
9,6,5,5,28,23
9,6,6,13,33,20
9,7,0,5,14,9
9,7,1,4,24,20
9,7,2,4,20,16
9,7,3,2,14,12
9,7,4,1,23,22
9,7,5,7,34,27
9,7,6,5,25,20
9,8,0,2,15,13
9,8,1,0,9,9
9,8,2,1,9,8
9,8,3,3,15,12
9,8,4,1,24,23
9,8,5,4,27,23
9,8,6,15,35,20
9,9,0,7,20,13
9,9,1,3,16,13
9,9,2,0,17,17
9,9,3,1,10,9
9,9,4,5,34,29
9,9,5,0,13,13
9,9,6,6,17,11
9,10,0,1,13,12
9,10,1,3,9,6
9,10,2,1,16,15
9,10,3,0,12,12
9,10,4,9,27,18
9,10,5,1,14,13
9,10,6,8,22,14
9,11,0,7,15,8
9,11,1,8,20,12
9,11,2,3,15,12
9,11,3,3,17,14
9,11,4,3,22,19
9,11,5,2,8,6
9,11,6,4,13,9
9,12,0,17,28,11
9,12,1,14,24,10
9,12,2,0,11,11
9,12,3,8,16,8
9,12,4,2,18,16
9,12,5,7,20,13
9,12,6,9,23,14
9,13,0,6,9,3
9,13,1,3,9,6
9,13,2,0,5,5
9,13,3,8,12,4
9,13,4,4,18,14
9,13,5,11,26,15
9,13,6,6,11,5
9,14,0,1,9,8
9,14,1,2,11,9
9,14,2,5,9,4
9,14,3,7,15,8
9,14,4,2,18,16
9,14,5,1,7,6
9,14,6,2,7,5
9,15,0,8,11,3
9,15,1,1,7,6
9,15,2,6,14,8
9,15,3,3,9,6
9,15,4,10,20,10
9,15,5,7,15,8
9,15,6,5,15,10
9,16,0,10,15,5
9,16,1,2,9,7
9,16,2,2,7,5
9,16,3,2,6,4
9,16,4,10,16,6
9,16,5,2,8,6
9,16,6,4,7,3
9,17,0,1,8,7
9,17,1,1,7,6
9,17,2,2,9,7
9,17,3,0,3,3
9,17,4,14,30,16
9,17,5,0,6,6
9,17,6,1,6,5
9,18,0,7,12,5
9,18,1,0,7,7
9,18,2,0,3,3
9,18,3,8,11,3
9,18,4,5,10,5
9,18,5,7,11,4
9,18,6,0,6,6
9,19,0,2,6,4
9,19,1,1,1,0
9,19,2,0,2,2
9,19,3,6,8,2
9,19,4,8,19,11
9,19,5,3,4,1
9,19,6,0,2,2
9,20,0,2,7,5
9,20,1,0,3,3
9,20,2,2,5,3
9,20,3,4,8,4
9,20,4,8,18,10
9,20,5,4,11,7
9,20,6,2,3,1
9,21,0,2,5,3
9,21,1,2,4,2
9,21,2,3,9,6
9,21,3,6,8,2
9,21,4,6,10,4
9,21,5,3,6,3
9,21,6,0,2,2
9,22,0,5,8,3
9,22,1,2,6,4
9,22,2,4,8,4
9,22,3,3,5,2
9,22,4,0,5,5
9,22,5,1,5,4
9,22,6,0,2,2
9,23,0,10,10,0
9,23,1,1,2,1
9,23,2,2,4,2
9,23,3,2,6,4
9,23,4,3,8,5
9,23,5,8,10,2
9,23,6,0,6,6
9,24,0,14,15,1
9,24,1,2,4,2
9,24,2,0,1,1
9,24,3,2,2,0
9,24,4,15,21,6
9,24,5,7,14,7
9,24,6,0,1,1
9,25,0,9,11,2
9,25,1,3,3,0
9,25,2,1,1,0
9,25,3,2,5,3
9,25,4,8,10,2
9,25,5,14,15,1
9,25,6,2,8,6
9,26,0,4,5,1
9,26,1,1,2,1
9,26,2,0,2,2
9,26,3,7,8,1
9,26,4,6,10,4
9,26,5,4,5,1
9,26,6,6,8,2
9,27,0,10,12,2
9,27,1,10,11,1
9,27,2,1,3,2
9,27,3,1,2,1
9,27,4,1,5,4
9,27,5,1,5,4
9,27,6,2,4,2
9,28,0,3,4,1
9,28,1,0,5,5
9,28,2,0,4,4
9,28,3,5,7,2
9,28,4,2,5,3
9,28,5,1,4,3
9,28,6,6,7,1
9,29,0,1,3,2
9,29,1,1,1,0
9,29,2,2,4,2
9,29,3,0,2,2
9,29,4,4,10,6
9,29,5,0,1,1
9,29,6,0,2,2
9,30,0,1,2,1
9,30,1,1,4,3
9,30,2,1,3,2
9,30,3,3,6,3
9,30,4,4,8,4
9,30,5,0,6,6
9,30,6,0,3,3
9,31,0,2,4,2
9,31,1,0,3,3
9,31,2,2,4,2
9,31,3,3,4,1
9,31,4,1,5,4
9,31,5,2,4,2
9,31,6,3,7,4
9,32,0,0,1,1
9,32,1,0,2,2
9,32,2,1,4,3
9,32,3,3,3,0
9,32,4,0,2,2
9,32,5,0,1,1
9,32,6,2,9,7
9,33,0,6,8,2
9,33,1,0,3,3
9,33,2,4,4,0
9,33,3,3,7,4
9,33,4,2,9,7
9,33,5,1,4,3
9,33,6,0,2,2
9,34,0,6,9,3
9,34,1,1,3,2
9,34,2,1,4,3
9,34,3,4,7,3
9,34,4,8,14,6
9,34,5,3,7,4
9,34,6,0,2,2
9,35,0,9,12,3
9,35,1,1,2,1
9,35,2,1,4,3
9,35,3,0,3,3
9,35,4,7,15,8
9,35,5,3,4,1
9,35,6,1,5,4
9,36,0,10,13,3
9,36,1,8,10,2
9,36,2,3,7,4
9,36,3,3,8,5
9,36,4,5,9,4
9,36,5,9,15,6
9,36,6,1,4,3
9,37,0,5,12,7
9,37,1,9,11,2
9,37,2,1,7,6
9,37,3,9,12,3
9,37,4,12,14,2
9,37,5,2,6,4
9,37,6,0,1,1
9,38,0,3,11,8
9,38,1,1,12,11
9,38,2,2,6,4
9,38,3,4,9,5
9,38,4,23,32,9
9,38,5,2,4,2
9,38,6,3,9,6
9,39,0,4,25,21
9,39,1,1,20,19
9,39,2,2,14,12
9,39,3,1,13,12
9,39,4,10,31,21
9,39,5,0,11,11
9,39,6,5,19,14
9,40,0,0,18,18
9,40,1,0,10,10
9,40,2,0,17,17
9,40,3,1,16,15
9,40,4,8,27,19
9,40,5,3,16,13
9,40,6,5,18,13
9,41,0,0,24,24
9,41,1,0,17,17
9,41,2,0,21,21
9,41,3,3,25,22
9,41,4,11,33,22
9,41,5,6,31,25
9,41,6,1,21,20
9,42,0,5,62,57
9,42,1,1,41,40
9,42,2,1,53,52
9,42,3,4,49,45
9,42,4,9,47,38
9,42,5,17,41,24
9,42,6,4,24,20
9,43,0,3,48,45
9,43,1,3,48,45
9,43,2,4,57,53
9,43,3,1,47,46
9,43,4,11,72,61
9,43,5,7,37,30
9,43,6,6,25,19
9,44,0,2,68,66
9,44,1,1,71,70
9,44,2,3,70,67
9,44,3,4,85,81
9,44,4,8,62,54
9,44,5,5,53,48
9,44,6,7,31,24
9,45,0,0,102,102
9,45,1,1,66,65
9,45,2,3,98,95
9,45,3,2,81,79
9,45,4,31,96,65
9,45,5,3,44,41
9,45,6,6,52,46
9,46,0,4,91,87
9,46,1,4,74,70
9,46,2,3,78,75
9,46,3,5,83,78
9,46,4,18,84,66
9,46,5,2,54,52
9,46,6,5,51,46
9,47,0,1,95,94
9,47,1,4,95,91
9,47,2,3,108,105
9,47,3,2,95,93
9,47,4,7,91,84
9,47,5,2,58,56
9,47,6,8,62,54
9,48,0,7,130,123
9,48,1,8,116,108
9,48,2,8,135,127
9,48,3,4,129,125
9,48,4,12,80,68
9,48,5,10,79,69
9,48,6,7,70,63
9,49,0,16,146,130
9,49,1,16,164,148
9,49,2,4,135,131
9,49,3,23,146,123
9,49,4,14,118,104
9,49,5,7,89,82
9,49,6,10,85,75
9,50,0,19,131,112
9,50,1,20,142,122
9,50,2,20,166,146
9,50,3,16,156,140
9,50,4,22,125,103
9,50,5,8,78,70
9,50,6,11,90,79
9,51,0,33,160,127
9,51,1,48,171,123
9,51,2,25,154,129
9,51,3,37,155,118
9,51,4,16,113,97
9,51,5,17,112,95
9,51,6,4,80,76
9,52,0,62,201,139
9,52,1,56,194,138
9,52,2,21,147,126
9,52,3,31,152,121
9,52,4,29,141,112
9,52,5,32,116,84
9,52,6,13,93,80
9,53,0,63,190,127
9,53,1,42,180,138
9,53,2,17,138,121
9,53,3,23,149,126
9,53,4,25,134,109
9,53,5,15,87,72
9,53,6,7,81,74
9,54,0,60,161,101
9,54,1,21,120,99
9,54,2,20,125,105
9,54,3,30,146,116
9,54,4,5,101,96
9,54,5,6,98,92
9,54,6,6,73,67
9,55,0,53,177,124
9,55,1,11,107,96
9,55,2,27,152,125
9,55,3,38,162,124
9,55,4,10,109,99
9,55,5,12,92,80
9,55,6,6,80,74
9,56,0,38,141,103
9,56,1,14,96,82
9,56,2,27,132,105
9,56,3,23,134,111
9,56,4,12,123,111
9,56,5,2,82,80
9,56,6,14,87,73
9,57,0,34,115,81
9,57,1,17,91,74
9,57,2,4,73,69
9,57,3,45,120,75
9,57,4,16,98,82
9,57,5,3,85,82
9,57,6,5,57,52
9,58,0,52,119,67
9,58,1,12,105,93
9,58,2,9,89,80
9,58,3,39,111,72
9,58,4,29,111,82
9,58,5,7,90,83
9,58,6,8,84,76
9,59,0,14,87,73
9,59,1,11,89,78
9,59,2,9,98,89
9,59,3,65,143,78
9,59,4,29,111,82
9,59,5,4,103,99
9,59,6,0,74,74
9,60,0,21,100,79
9,60,1,4,70,66
9,60,2,5,68,63
9,60,3,23,97,74
9,60,4,29,110,81
9,60,5,5,86,81
9,60,6,4,72,68
9,61,0,23,98,75
9,61,1,3,82,79
9,61,2,0,62,62
9,61,3,12,105,93
9,61,4,25,93,68
9,61,5,5,88,83
9,61,6,6,90,84
9,62,0,15,98,83
9,62,1,7,85,78
9,62,2,10,67,57
9,62,3,23,105,82
9,62,4,16,91,75
9,62,5,7,92,85
9,62,6,5,82,77
9,63,0,17,85,68
9,63,1,1,64,63
9,63,2,8,82,74
9,63,3,14,86,72
9,63,4,29,108,79
9,63,5,5,80,75
9,63,6,7,78,71
9,64,0,15,91,76
9,64,1,7,72,65
9,64,2,7,84,77
9,64,3,4,85,81
9,64,4,30,99,69
9,64,5,6,90,84
9,64,6,6,91,85
9,65,0,5,73,68
9,65,1,4,67,63
9,65,2,2,57,55
9,65,3,20,95,75
9,65,4,34,107,73
9,65,5,4,91,87
9,65,6,10,82,72
9,66,0,7,72,65
9,66,1,0,54,54
9,66,2,13,85,72
9,66,3,4,61,57
9,66,4,16,92,76
9,66,5,3,84,81
9,66,6,4,81,77
9,67,0,9,77,68
9,67,1,0,62,62
9,67,2,14,87,73
9,67,3,8,81,73
9,67,4,21,99,78
9,67,5,4,91,87
9,67,6,4,80,76
9,68,0,19,93,74
9,68,1,2,67,65
9,68,2,1,81,80
9,68,3,16,101,85
9,68,4,46,128,82
9,68,5,3,83,80
9,68,6,8,84,76
9,69,0,8,90,82
9,69,1,4,70,66
9,69,2,11,81,70
9,69,3,18,96,78
9,69,4,22,97,75
9,69,5,3,103,100
9,69,6,8,81,73
9,70,0,23,115,92
9,70,1,5,78,73
9,70,2,3,76,73
9,70,3,38,127,89
9,70,4,22,95,73
9,70,5,8,98,90
9,70,6,21,127,106
9,71,0,13,94,81
9,71,1,7,80,73
9,71,2,7,81,74
9,71,3,29,112,83
9,71,4,30,123,93
9,71,5,13,121,108
9,71,6,11,96,85
9,72,0,9,104,95
9,72,1,7,85,78
9,72,2,1,82,81
9,72,3,12,107,95
9,72,4,37,124,87
9,72,5,11,113,102
9,72,6,10,93,83
9,73,0,7,106,99
9,73,1,21,108,87
9,73,2,2,90,88
9,73,3,13,90,77
9,73,4,23,125,102
9,73,5,5,121,116
9,73,6,2,102,100
9,74,0,10,98,88
9,74,1,23,122,99
9,74,2,7,87,80
9,74,3,18,102,84
9,74,4,13,109,96
9,74,5,7,99,92
9,74,6,7,117,110
9,75,0,9,94,85
9,75,1,19,96,77
9,75,2,12,114,102
9,75,3,36,125,89
9,75,4,13,108,95
9,75,5,9,121,112
9,75,6,3,85,82
9,76,0,9,98,89
9,76,1,16,100,84
9,76,2,24,126,102
9,76,3,24,120,96
9,76,4,14,111,97
9,76,5,7,98,91
9,76,6,3,103,100
9,77,0,10,93,83
9,77,1,10,95,85
9,77,2,56,149,93
9,77,3,34,150,116
9,77,4,36,138,102
9,77,5,6,127,121
9,77,6,8,111,103
9,78,0,2,101,99
9,78,1,10,111,101
9,78,2,59,149,90
9,78,3,32,130,98
9,78,4,40,142,102
9,78,5,5,125,120
9,78,6,6,119,113
9,79,0,27,139,112
9,79,1,8,132,124
9,79,2,26,117,91
9,79,3,54,162,108
9,79,4,22,124,102
9,79,5,6,139,133
9,79,6,0,128,128
9,80,0,17,118,101
9,80,1,6,97,91
9,80,2,4,107,103
9,80,3,31,117,86
9,80,4,8,106,98
9,80,5,3,105,102
9,80,6,3,133,130
9,81,0,9,101,92
9,81,1,4,103,99
9,81,2,6,98,92
9,81,3,21,121,100
9,81,4,16,111,95
9,81,5,5,119,114
9,81,6,8,99,91
9,82,0,2,101,99
9,82,1,8,99,91
9,82,2,9,84,75
9,82,3,39,150,111
9,82,4,23,115,92
9,82,5,4,110,106
9,82,6,4,133,129
9,83,0,5,89,84
9,83,1,8,105,97
9,83,2,8,99,91
9,83,3,22,116,94
9,83,4,14,114,100
9,83,5,6,125,119
9,83,6,6,141,135
9,84,0,8,91,83
9,84,1,5,78,73
9,84,2,13,92,79
9,84,3,21,110,89
9,84,4,9,101,92
9,84,5,8,107,99
9,84,6,5,108,103
9,85,0,4,90,86
9,85,1,12,104,92
9,85,2,9,102,93
9,85,3,8,76,68
9,85,4,19,98,79
9,85,5,3,127,124
9,85,6,5,101,96
9,86,0,9,107,98
9,86,1,11,95,84
9,86,2,10,73,63
9,86,3,0,90,90
9,86,4,7,84,77
9,86,5,7,105,98
9,86,6,4,144,140
9,87,0,3,93,90
9,87,1,9,94,85
9,87,2,2,107,105
9,87,3,7,91,84
9,87,4,10,103,93
9,87,5,4,99,95
9,87,6,3,115,112
9,88,0,2,97,95
9,88,1,1,90,89
9,88,2,9,101,92
9,88,3,2,83,81
9,88,4,4,105,101
9,88,5,12,106,94
9,88,6,5,117,112
9,89,0,3,107,104
9,89,1,5,76,71
9,89,2,8,100,92
9,89,3,4,81,77
9,89,4,14,116,102
9,89,5,5,119,114
9,89,6,6,129,123
9,90,0,7,116,109
9,90,1,4,80,76
9,90,2,9,98,89
9,90,3,5,96,91
9,90,4,40,168,128
9,90,5,3,95,92
9,90,6,14,143,129
9,91,0,6,118,112
9,91,1,15,120,105
9,91,2,23,108,85
9,91,3,15,97,82
9,91,4,61,186,125
9,91,5,3,127,124
9,91,6,17,162,145
9,92,0,25,134,109
9,92,1,14,97,83
9,92,2,22,118,96
9,92,3,24,125,101
9,92,4,85,224,139
9,92,5,15,132,117
9,92,6,18,152,134
9,93,0,6,108,102
9,93,1,1,103,102
9,93,2,3,114,111
9,93,3,1,104,103
9,93,4,12,146,134
9,93,5,10,133,123
9,93,6,17,156,139
9,94,0,2,116,114
9,94,1,5,110,105
9,94,2,6,99,93
9,94,3,1,88,87
9,94,4,4,129,125
9,94,5,15,156,141
9,94,6,34,189,155
9,95,0,2,123,121
9,95,1,7,105,98
9,95,2,4,113,109
9,95,3,4,110,106
9,95,4,11,153,142
9,95,5,16,151,135
9,95,6,52,201,149
9,96,0,4,127,123
9,96,1,9,121,112
9,96,2,5,142,137
9,96,3,2,112,110
9,96,4,11,142,131
9,96,5,6,134,128
9,96,6,18,197,179
9,97,0,4,129,125
9,97,1,0,124,124
9,97,2,3,147,144
9,97,3,7,103,96
9,97,4,6,132,126
9,97,5,7,151,144
9,97,6,5,178,173
9,98,0,5,132,127
9,98,1,8,124,116
9,98,2,3,138,135
9,98,3,12,139,127
9,98,4,7,152,145
9,98,5,4,147,143
9,98,6,5,116,111
9,99,0,4,146,142
9,99,1,3,138,135
9,99,2,3,137,134
9,99,3,6,136,130
9,99,4,10,162,152
9,99,5,5,185,180
9,99,6,9,173,164
9,100,0,5,148,143
9,100,1,9,137,128
9,100,2,13,140,127
9,100,3,6,136,130
9,100,4,22,178,156
9,100,5,8,159,151
9,100,6,5,149,144
9,101,0,3,162,159
9,101,1,7,163,156
9,101,2,6,122,116
9,101,3,14,147,133
9,101,4,10,162,152
9,101,5,7,179,172
9,101,6,5,156,151
9,102,0,8,175,167
9,102,1,1,158,157
9,102,2,13,162,149
9,102,3,5,138,133
9,102,4,30,180,150
9,102,5,5,183,178
9,102,6,5,162,157
9,103,0,3,152,149
9,103,1,8,147,139
9,103,2,7,144,137
9,103,3,0,128,128
9,103,4,20,207,187
9,103,5,8,171,163
9,103,6,4,158,154
9,104,0,6,156,150
9,104,1,1,115,114
9,104,2,9,144,135
9,104,3,6,123,117
9,104,4,22,172,150
9,104,5,8,143,135
9,104,6,4,160,156
9,105,0,7,138,131
9,105,1,4,158,154
9,105,2,7,159,152
9,105,3,3,140,137
9,105,4,15,163,148
9,105,5,8,161,153
9,105,6,2,131,129
9,106,0,7,139,132
9,106,1,2,125,123
9,106,2,12,137,125
9,106,3,2,143,141
9,106,4,9,163,154
9,106,5,7,153,146
9,106,6,3,134,131
9,107,0,17,134,117
9,107,1,7,123,116
9,107,2,10,147,137
9,107,3,8,120,112
9,107,4,13,147,134
9,107,5,7,124,117
9,107,6,5,127,122
9,108,0,9,141,132
9,108,1,10,142,132
9,108,2,3,148,145
9,108,3,6,135,129
9,108,4,15,140,125
9,108,5,4,137,133
9,108,6,5,136,131
9,109,0,4,112,108
9,109,1,7,147,140
9,109,2,6,166,160
9,109,3,1,131,130
9,109,4,9,117,108
9,109,5,2,114,112
9,109,6,0,128,128
9,110,0,5,128,123
9,110,1,6,115,109
9,110,2,5,118,113
9,110,3,5,110,105
9,110,4,2,113,111
9,110,5,4,121,117
9,110,6,1,93,92
9,111,0,9,122,113
9,111,1,10,131,121
9,111,2,5,125,120
9,111,3,2,123,121
9,111,4,6,132,126
9,111,5,2,105,103
9,111,6,9,132,123
9,112,0,5,104,99
9,112,1,2,101,99
9,112,2,10,140,130
9,112,3,4,107,103
9,112,4,5,136,131
9,112,5,5,99,94
9,112,6,7,123,116
9,113,0,2,115,113
9,113,1,5,106,101
9,113,2,6,134,128
9,113,3,5,123,118
9,113,4,4,136,132
9,113,5,5,114,109
9,113,6,5,129,124
9,114,0,0,87,87
9,114,1,4,98,94
9,114,2,4,121,117
9,114,3,2,106,104
9,114,4,13,116,103
9,114,5,6,117,111
9,114,6,3,116,113
9,115,0,4,101,97
9,115,1,2,103,101
9,115,2,10,124,114
9,115,3,3,112,109
9,115,4,6,132,126
9,115,5,20,143,123
9,115,6,5,99,94
9,116,0,4,117,113
9,116,1,0,98,98
9,116,2,8,114,106
9,116,3,0,100,100
9,116,4,2,111,109
9,116,5,26,138,112
9,116,6,6,114,108
9,117,0,3,101,98
9,117,1,5,93,88
9,117,2,2,119,117
9,117,3,6,106,100
9,117,4,3,114,111
9,117,5,42,173,131
9,117,6,1,99,98
9,118,0,4,118,114
9,118,1,3,106,103
9,118,2,4,110,106
9,118,3,10,88,78
9,118,4,2,104,102
9,118,5,22,125,103
9,118,6,3,98,95
9,119,0,7,97,90
9,119,1,3,96,93
9,119,2,6,109,103
9,119,3,6,87,81
9,119,4,4,81,77
9,119,5,14,139,125
9,119,6,1,80,79
9,120,0,2,105,103
9,120,1,6,97,91
9,120,2,3,118,115
9,120,3,8,129,121
9,120,4,10,168,158
9,120,5,10,145,135
9,120,6,4,112,108
9,121,0,7,96,89
9,121,1,2,113,111
9,121,2,3,104,101
9,121,3,5,102,97
9,121,4,5,134,129
9,121,5,7,119,112
9,121,6,4,104,100
9,122,0,2,102,100
9,122,1,1,101,100
9,122,2,4,118,114
9,122,3,6,119,113
9,122,4,2,115,113
9,122,5,9,154,145
9,122,6,5,139,134
9,123,0,1,112,111
9,123,1,5,117,112
9,123,2,3,113,110
9,123,3,4,97,93
9,123,4,1,142,141
9,123,5,3,134,131
9,123,6,11,135,124
9,124,0,3,100,97
9,124,1,3,114,111
9,124,2,7,135,128
9,124,3,8,122,114
9,124,4,2,153,151
9,124,5,5,106,101
9,124,6,6,94,88
9,125,0,5,116,111
9,125,1,3,106,103
9,125,2,4,123,119
9,125,3,7,114,107
9,125,4,5,112,107
9,125,5,8,130,122
9,125,6,2,94,92
9,126,0,5,115,110
9,126,1,2,99,97
9,126,2,2,115,113
9,126,3,6,95,89
9,126,4,1,154,153
9,126,5,6,115,109
9,126,6,2,101,99
9,127,0,2,103,101
9,127,1,4,115,111
9,127,2,13,111,98
9,127,3,5,94,89
9,127,4,1,119,118
9,127,5,9,120,111
9,127,6,4,105,101
9,128,0,3,108,105
9,128,1,0,90,90
9,128,2,7,131,124
9,128,3,3,96,93
9,128,4,7,124,117
9,128,5,6,109,103
9,128,6,6,114,108
9,129,0,7,115,108
9,129,1,5,88,83
9,129,2,4,131,127
9,129,3,8,100,92
9,129,4,2,114,112
9,129,5,3,115,112
9,129,6,2,103,101
9,130,0,0,92,92
9,130,1,4,91,87
9,130,2,3,114,111
9,130,3,4,113,109
9,130,4,5,118,113
9,130,5,3,138,135
9,130,6,5,118,113
9,131,0,4,84,80
9,131,1,2,86,84
9,131,2,1,128,127
9,131,3,8,108,100
9,131,4,2,126,124
9,131,5,3,129,126
9,131,6,0,96,96
9,132,0,0,99,99
9,132,1,4,108,104
9,132,2,7,110,103
9,132,3,3,92,89
9,132,4,6,132,126
9,132,5,7,119,112
9,132,6,2,110,108
9,133,0,2,80,78
9,133,1,0,81,81
9,133,2,7,99,92
9,133,3,3,82,79
9,133,4,3,128,125
9,133,5,8,122,114
9,133,6,4,95,91
9,134,0,9,79,70
9,134,1,5,87,82
9,134,2,2,80,78
9,134,3,8,86,78
9,134,4,3,88,85
9,134,5,3,92,89
9,134,6,1,77,76
9,135,0,6,81,75
9,135,1,6,80,74
9,135,2,1,85,84
9,135,3,3,82,79
9,135,4,2,88,86
9,135,5,3,77,74
9,135,6,5,73,68
9,136,0,2,66,64
9,136,1,5,77,72
9,136,2,0,65,65
9,136,3,3,81,78
9,136,4,4,91,87
9,136,5,2,81,79
9,136,6,5,65,60
9,137,0,1,70,69
9,137,1,2,70,68
9,137,2,8,84,76
9,137,3,3,55,52
9,137,4,3,70,67
9,137,5,4,84,80
9,137,6,2,75,73
9,138,0,0,56,56
9,138,1,2,52,50
9,138,2,2,43,41
9,138,3,1,52,51
9,138,4,2,60,58
9,138,5,6,82,76
9,138,6,2,52,50
9,139,0,2,39,37
9,139,1,2,48,46
9,139,2,1,40,39
9,139,3,6,53,47
9,139,4,1,68,67
9,139,5,6,62,56
9,139,6,2,62,60
9,140,0,2,42,40
9,140,1,6,43,37
9,140,2,1,47,46
9,140,3,6,55,49
9,140,4,0,40,40
9,140,5,5,65,60
9,140,6,3,55,52
9,141,0,2,45,43
9,141,1,2,37,35
9,141,2,2,38,36
9,141,3,6,55,49
9,141,4,0,51,51
9,141,5,1,45,44
9,141,6,1,53,52
9,142,0,5,50,45
9,142,1,5,36,31
9,142,2,5,50,45
9,142,3,8,49,41
9,142,4,13,82,69
9,142,5,3,56,53
9,142,6,1,51,50
9,143,0,8,42,34
9,143,1,5,40,35
9,143,2,3,39,36
9,143,3,3,34,31
9,143,4,4,42,38
9,143,5,1,49,48
9,143,6,10,46,36
10,0,1,1,1,0
10,0,2,0,1,1
10,0,4,0,1,1
10,0,6,0,1,1
10,1,1,2,2,0
10,1,2,1,2,1
10,1,4,0,2,2
10,1,5,0,2,2
10,1,6,0,1,1
10,2,1,1,1,0
10,2,5,0,1,1
10,3,1,0,1,1
10,3,2,0,1,1
10,3,3,1,2,1
10,3,4,1,1,0
10,3,5,1,3,2
10,3,6,0,1,1
10,4,4,0,3,3
10,5,5,1,1,0
10,5,6,0,1,1
10,6,5,2,2,0
10,6,6,0,1,1
10,7,0,1,2,1
10,7,4,2,3,1
10,8,2,0,2,2
10,8,4,1,2,1
10,8,6,0,2,2
10,9,5,0,1,1
10,10,2,0,1,1
10,11,1,0,1,1
10,11,5,0,1,1
10,12,1,0,1,1
10,12,2,1,3,2
10,12,4,0,2,2
10,14,0,0,1,1
10,14,1,0,1,1
10,14,2,0,1,1
10,14,6,1,1,0
10,15,5,1,1,0
10,16,4,0,1,1
10,17,1,0,1,1
10,17,4,0,1,1
10,18,2,0,1,1
10,20,4,1,2,1
10,21,3,1,2,1
10,21,6,0,1,1
10,22,0,1,1,0
10,22,3,0,1,1
10,22,5,3,3,0
10,22,6,1,2,1
10,23,5,1,1,0
10,24,0,1,1,0
10,24,3,0,1,1
10,25,1,0,1,1
10,25,6,0,2,2
10,26,2,1,2,1
10,26,6,0,1,1
10,27,2,0,1,1
10,28,6,0,1,1
10,29,6,1,3,2
10,30,6,0,1,1
10,31,0,0,1,1
10,31,4,0,2,2
10,31,5,0,1,1
10,31,6,0,1,1
10,32,0,2,2,0
10,32,1,1,1,0
10,33,4,2,2,0
10,33,6,1,2,1
10,34,4,2,3,1
10,34,6,1,5,4
10,35,1,0,1,1
10,35,3,1,1,0
10,35,4,2,2,0
10,35,5,3,3,0
10,35,6,8,11,3
10,36,1,1,1,0
10,36,2,1,2,1
10,36,3,2,2,0
10,36,4,4,5,1
10,36,5,0,1,1
10,36,6,2,3,1
10,37,0,1,1,0
10,37,3,1,3,2
10,37,4,1,1,0
10,37,6,0,3,3
10,38,0,0,2,2
10,38,1,1,1,0
10,38,2,1,1,0
10,38,3,2,2,0
10,38,4,6,7,1
10,38,5,1,1,0
10,38,6,0,2,2
10,39,0,2,2,0
10,39,1,0,1,1
10,39,2,0,1,1
10,39,3,2,3,1
10,39,4,0,2,2
10,39,5,0,1,1
10,39,6,0,1,1
10,40,0,0,3,3
10,40,1,0,3,3
10,40,2,0,6,6
10,40,3,1,6,5
10,40,4,2,6,4
10,40,5,2,4,2
10,40,6,0,2,2
10,41,0,0,6,6
10,41,1,1,10,9
10,41,2,0,5,5
10,41,3,0,4,4
10,41,4,1,2,1
10,41,5,1,4,3
10,41,6,1,4,3
10,42,0,2,4,2
10,42,1,0,3,3
10,42,2,2,12,10
10,42,3,0,4,4
10,42,4,1,8,7
10,42,5,0,2,2
10,42,6,0,3,3
10,43,0,1,20,19
10,43,1,0,14,14
10,43,2,1,10,9
10,43,3,2,18,16
10,43,4,1,11,10
10,43,5,0,6,6
10,43,6,1,3,2
10,44,0,2,15,13
10,44,1,1,18,17
10,44,2,3,18,15
10,44,3,4,14,10
10,44,4,1,9,8
10,44,5,1,3,2
10,44,6,1,5,4
10,45,0,0,22,22
10,45,1,0,16,16
10,45,2,2,23,21
10,45,3,4,25,21
10,45,4,3,22,19
10,45,5,0,3,3
10,45,6,1,11,10
10,46,0,4,22,18
10,46,1,2,12,10
10,46,2,9,20,11
10,46,3,2,13,11
10,46,4,5,13,8
10,46,5,1,10,9
10,46,6,6,9,3
10,47,0,3,17,14
10,47,1,3,16,13
10,47,2,10,29,19
10,47,3,2,9,7
10,47,4,7,16,9
10,47,5,0,5,5
10,47,6,3,8,5
10,48,0,1,11,10
10,48,1,13,23,10
10,48,2,4,11,7
10,48,3,4,12,8
10,48,4,8,12,4
10,48,5,1,4,3
10,48,6,2,8,6
10,49,0,4,12,8
10,49,1,12,25,13
10,49,2,16,25,9
10,49,3,7,19,12
10,49,4,3,9,6
10,49,5,2,8,6
10,49,6,1,2,1
10,50,0,9,12,3
10,50,1,11,19,8
10,50,2,16,23,7
10,50,3,6,17,11
10,50,4,6,10,4
10,50,5,2,9,7
10,50,6,6,10,4
10,51,0,16,24,8
10,51,1,29,41,12
10,51,2,13,29,16
10,51,3,15,24,9
10,51,4,4,14,10
10,51,5,2,12,10
10,51,6,7,12,5
10,52,0,11,22,11
10,52,1,11,26,15
10,52,2,6,15,9
10,52,3,12,22,10
10,52,4,4,13,9
10,52,5,5,10,5
10,52,6,3,14,11
10,53,0,9,18,9
10,53,1,9,18,9
10,53,2,9,20,11
10,53,3,12,28,16
10,53,4,6,21,15
10,53,5,4,15,11
10,53,6,0,11,11
10,54,0,7,13,6
10,54,1,6,17,11
10,54,2,6,14,8
10,54,3,6,18,12
10,54,4,6,20,14
10,54,5,6,16,10
10,54,6,0,6,6
10,55,0,6,14,8
10,55,1,5,13,8
10,55,2,2,11,9
10,55,3,19,27,8
10,55,4,3,10,7
10,55,5,1,9,8
10,55,6,0,6,6
10,56,0,19,26,7
10,56,1,15,17,2
10,56,2,9,14,5
10,56,3,12,20,8
10,56,4,7,17,10
10,56,5,1,9,8
10,56,6,1,10,9
10,57,0,6,12,6
10,57,1,14,24,10
10,57,2,9,20,11
10,57,3,12,14,2
10,57,4,4,10,6
10,57,5,3,11,8
10,57,6,3,9,6
10,58,0,7,10,3
10,58,1,17,21,4
10,58,2,9,14,5
10,58,3,23,30,7
10,58,4,3,14,11
10,58,5,0,9,9
10,58,6,1,14,13
10,59,0,4,9,5
10,59,1,5,12,7
10,59,2,5,12,7
10,59,3,10,15,5
10,59,4,4,9,5
10,59,5,1,9,8
10,59,6,6,15,9
10,60,0,2,8,6
10,60,1,11,18,7
10,60,2,14,25,11
10,60,3,7,17,10
10,60,4,8,15,7
10,60,5,0,8,8
10,60,6,1,16,15
10,61,0,2,7,5
10,61,1,4,11,7
10,61,2,5,13,8
10,61,3,3,13,10
10,61,4,8,15,7
10,61,5,2,9,7
10,61,6,0,11,11
10,62,0,3,9,6
10,62,1,4,10,6
10,62,2,8,13,5
10,62,3,2,8,6
10,62,4,5,10,5
10,62,5,4,11,7
10,62,6,0,16,16
10,63,0,5,13,8
10,63,1,0,6,6
10,63,2,0,6,6
10,63,3,8,12,4
10,63,4,6,20,14
10,63,5,2,11,9
10,63,6,0,15,15
10,64,0,2,9,7
10,64,1,3,9,6
10,64,2,1,7,6
10,64,3,2,7,5
10,64,4,4,16,12
10,64,5,2,7,5
10,64,6,7,20,13
10,65,0,6,10,4
10,65,1,2,9,7
10,65,2,3,10,7
10,65,3,2,8,6
10,65,4,6,17,11
10,65,5,0,18,18
10,65,6,0,12,12
10,66,0,3,8,5
10,66,1,0,5,5
10,66,2,0,2,2
10,66,3,2,8,6
10,66,4,4,12,8
10,66,5,1,9,8
10,66,6,2,19,17
10,67,0,2,6,4
10,67,1,1,7,6
10,67,2,3,11,8
10,67,3,5,10,5
10,67,4,6,16,10
10,67,5,5,22,17
10,67,6,2,19,17
10,68,0,0,3,3
10,68,1,2,5,3
10,68,2,2,13,11
10,68,3,6,14,8
10,68,4,11,23,12
10,68,5,5,18,13
10,68,6,2,22,20
10,69,0,3,6,3
10,69,1,2,6,4
10,69,2,4,11,7
10,69,3,4,14,10
10,69,4,6,14,8
10,69,5,2,17,15
10,69,6,1,19,18
10,70,0,2,6,4
10,70,2,2,10,8
10,70,3,6,16,10
10,70,4,5,13,8
10,70,5,1,10,9
10,70,6,4,31,27
10,71,0,8,13,5
10,71,1,5,8,3
10,71,2,3,8,5
10,71,3,1,6,5
10,71,4,8,14,6
10,71,5,7,18,11
10,71,6,3,25,22
10,72,0,2,9,7
10,72,1,3,8,5
10,72,2,6,9,3
10,72,3,1,7,6
10,72,4,6,18,12
10,72,5,4,16,12
10,72,6,13,25,12
10,73,0,2,9,7
10,73,1,4,10,6
10,73,2,0,1,1
10,73,3,1,12,11
10,73,4,3,8,5
10,73,5,3,19,16
10,73,6,14,27,13
10,74,0,3,8,5
10,74,1,0,6,6
10,74,2,2,8,6
10,74,3,0,3,3
10,74,4,4,14,10
10,74,5,3,13,10
10,74,6,11,32,21
10,75,0,2,6,4
10,75,1,2,9,7
10,75,2,6,10,4
10,75,3,3,10,7
10,75,4,3,13,10
10,75,5,1,12,11
10,75,6,15,30,15
10,76,0,0,3,3
10,76,1,1,7,6
10,76,2,3,11,8
10,76,3,9,17,8
10,76,4,7,15,8
10,76,5,7,20,13
10,76,6,7,25,18
10,77,0,0,16,16
10,77,1,5,10,5
10,77,2,2,5,3
10,77,3,5,8,3
10,77,4,10,14,4
10,77,5,4,25,21
10,77,6,15,26,11
10,78,0,1,7,6
10,78,1,3,9,6
10,78,2,1,8,7
10,78,3,3,6,3
10,78,4,10,19,9
10,78,5,7,19,12
10,78,6,4,16,12
10,79,0,2,10,8
10,79,1,1,9,8
10,79,2,9,20,11
10,79,3,1,4,3
10,79,4,9,18,9
10,79,5,12,35,23
10,79,6,11,21,10
10,80,0,0,7,7
10,80,1,6,11,5
10,80,2,7,16,9
10,80,3,6,12,6
10,80,4,10,20,10
10,80,5,5,18,13
10,80,6,10,21,11
10,81,0,2,10,8
10,81,1,7,11,4
10,81,2,2,8,6
10,81,3,2,7,5
10,81,4,6,9,3
10,81,5,5,25,20
10,81,6,4,15,11
10,82,0,0,5,5
10,82,1,1,9,8
10,82,2,1,8,7
10,82,3,4,12,8
10,82,4,8,15,7
10,82,5,1,12,11
10,82,6,3,19,16
10,83,0,3,7,4
10,83,1,6,10,4
10,83,2,8,12,4
10,83,3,8,12,4
10,83,4,11,19,8
10,83,5,8,24,16
10,83,6,3,18,15
10,84,0,0,5,5
10,84,1,2,7,5
10,84,2,3,10,7
10,84,3,5,14,9
10,84,4,2,8,6
10,84,5,16,31,15
10,84,6,3,17,14
10,85,0,7,11,4
10,85,1,5,9,4
10,85,2,4,10,6
10,85,3,5,9,4
10,85,4,8,12,4
10,85,5,15,30,15
10,85,6,9,21,12
10,86,0,2,7,5
10,86,1,8,16,8
10,86,2,0,6,6
10,86,3,3,11,8
10,86,4,3,9,6
10,86,5,16,29,13
10,86,6,4,14,10
10,87,0,0,6,6
10,87,1,2,11,9
10,87,2,0,6,6
10,87,3,0,1,1
10,87,4,3,11,8
10,87,5,13,31,18
10,87,6,5,12,7
10,88,0,0,4,4
10,88,1,1,5,4
10,88,2,6,12,6
10,88,3,6,10,4
10,88,4,6,11,5
10,88,5,5,19,14
10,88,6,8,20,12
10,89,0,1,7,6
10,89,1,0,7,7
10,89,2,1,9,8
10,89,3,3,10,7
10,89,4,8,15,7
10,89,5,11,19,8
10,89,6,8,16,8
10,90,0,1,7,6
10,90,1,2,12,10
10,90,2,1,6,5
10,90,3,2,4,2
10,90,4,3,8,5
10,90,5,10,26,16
10,90,6,24,33,9
10,91,0,1,6,5
10,91,1,7,13,6
10,91,2,2,7,5
10,91,3,4,8,4
10,91,4,13,20,7
10,91,5,8,18,10
10,91,6,7,16,9
10,92,0,2,5,3
10,92,1,6,10,4
10,92,2,4,9,5
10,92,3,1,11,10
10,92,4,17,21,4
10,92,5,5,18,13
10,92,6,12,28,16
10,93,0,2,5,3
10,93,1,3,10,7
10,93,2,3,7,4
10,93,3,0,7,7
10,93,4,6,11,5
10,93,5,12,21,9
10,93,6,12,22,10
10,94,0,0,2,2
10,94,1,1,6,5
10,94,2,1,4,3
10,94,3,2,8,6
10,94,4,14,22,8
10,94,5,18,28,10
10,94,6,7,18,11
10,95,0,1,7,6
10,95,1,0,2,2
10,95,2,3,6,3
10,95,3,0,5,5
10,95,4,16,23,7
10,95,5,14,23,9
10,95,6,11,19,8
10,96,0,0,3,3
10,96,1,3,7,4
10,96,2,1,4,3
10,96,3,0,3,3
10,96,4,16,27,11
10,96,5,6,21,15
10,96,6,8,20,12
10,97,0,0,3,3
10,97,1,0,3,3
10,97,2,1,11,10
10,97,3,0,7,7
10,97,4,15,25,10
10,97,5,9,18,9
10,97,6,4,16,12
10,98,0,0,6,6
10,98,1,1,4,3
10,98,2,2,7,5
10,98,3,1,6,5
10,98,4,11,16,5
10,98,5,8,18,10
10,98,6,12,23,11
10,99,0,3,7,4
10,99,1,1,4,3
10,99,2,3,8,5
10,99,3,1,9,8
10,99,4,6,18,12
10,99,5,17,28,11
10,99,6,16,30,14
10,100,0,1,11,10
10,100,1,9,13,4
10,100,2,5,7,2
10,100,3,1,8,7
10,100,4,15,27,12
10,100,5,23,34,11
10,100,6,16,29,13
10,101,0,3,7,4
10,101,1,3,7,4
10,101,2,3,7,4
10,101,3,3,7,4
10,101,4,12,22,10
10,101,5,18,26,8
10,101,6,17,33,16
10,102,0,5,12,7
10,102,1,3,10,7
10,102,2,4,8,4
10,102,3,3,6,3
10,102,4,15,22,7
10,102,5,10,17,7
10,102,6,21,27,6
10,103,0,3,10,7
10,103,1,2,11,9
10,103,2,6,10,4
10,103,3,0,4,4
10,103,4,10,16,6
10,103,5,13,28,15
10,103,6,8,16,8
10,104,0,2,7,5
10,104,1,1,8,7
10,104,2,1,9,8
10,104,3,1,8,7
10,104,4,5,16,11
10,104,5,16,27,11
10,104,6,5,18,13
10,105,0,1,9,8
10,105,1,1,7,6
10,105,2,3,9,6
10,105,3,0,6,6
10,105,4,11,16,5
10,105,5,13,19,6
10,105,6,8,18,10
10,106,0,5,9,4
10,106,1,5,18,13
10,106,2,1,7,6
10,106,3,0,6,6
10,106,4,21,26,5
10,106,5,4,10,6
10,106,6,3,12,9
10,107,0,0,5,5
10,107,1,3,9,6
10,107,2,1,5,4
10,107,3,2,8,6
10,107,4,3,8,5
10,107,5,11,25,14
10,107,6,4,14,10
10,108,0,0,9,9
10,108,1,3,8,5
10,108,2,0,9,9
10,108,3,6,11,5
10,108,4,6,21,15
10,108,5,2,15,13
10,108,6,3,13,10
10,109,0,1,5,4
10,109,1,1,4,3
10,109,2,2,5,3
10,109,3,12,20,8
10,109,4,1,7,6
10,109,5,2,16,14
10,109,6,1,10,9
10,110,0,3,8,5
10,110,1,1,8,7
10,110,2,2,9,7
10,110,3,1,9,8
10,110,4,5,14,9
10,110,5,6,18,12
10,110,6,0,8,8
10,111,0,2,12,10
10,111,1,0,9,9
10,111,2,4,13,9
10,111,3,0,6,6
10,111,4,0,5,5
10,111,5,3,15,12
10,111,6,2,15,13
10,112,0,1,5,4
10,112,1,2,12,10
10,112,2,3,10,7
10,112,3,0,6,6
10,112,4,0,8,8
10,112,5,6,15,9
10,112,6,2,9,7
10,113,0,1,7,6
10,113,1,2,12,10
10,113,2,4,18,14
10,113,3,0,6,6
10,113,4,4,8,4
10,113,5,10,18,8
10,113,6,1,13,12
10,114,0,0,5,5
10,114,1,0,9,9
10,114,2,1,5,4
10,114,3,0,6,6
10,114,4,2,7,5
10,114,5,5,23,18
10,114,6,1,4,3
10,115,0,0,8,8
10,115,1,2,6,4
10,115,2,0,4,4
10,115,3,1,6,5
10,115,4,3,10,7
10,115,5,5,15,10
10,115,6,1,9,8
10,116,0,0,5,5
10,116,1,4,13,9
10,116,2,0,4,4
10,116,3,1,8,7
10,116,4,1,8,7
10,116,5,3,15,12
10,116,6,3,6,3
10,117,0,3,12,9
10,117,1,3,5,2
10,117,2,4,10,6
10,117,3,1,6,5
10,117,4,2,6,4
10,117,5,3,9,6
10,117,6,9,17,8
10,118,0,0,5,5
10,118,1,5,10,5
10,118,2,1,8,7
10,118,3,0,3,3
10,118,4,0,6,6
10,118,5,1,4,3
10,118,6,1,6,5
10,119,0,2,9,7
10,119,1,13,24,11
10,119,2,3,9,6
10,119,3,2,5,3
10,119,4,1,8,7
10,119,5,1,7,6
10,119,6,4,11,7
10,120,0,1,11,10
10,120,1,3,7,4
10,120,2,2,7,5
10,120,3,2,13,11
10,120,4,7,10,3
10,120,5,1,4,3
10,120,6,6,13,7
10,121,0,3,11,8
10,121,1,2,5,3
10,121,2,8,13,5
10,121,3,1,6,5
10,121,4,4,10,6
10,121,5,5,11,6
10,121,6,10,22,12
10,122,0,10,20,10
10,122,1,4,10,6
10,122,2,1,7,6
10,122,3,1,7,6
10,122,4,5,12,7
10,122,5,2,7,5
10,122,6,5,15,10
10,123,0,6,11,5
10,123,1,8,16,8
10,123,2,1,9,8
10,123,3,0,4,4
10,123,4,9,15,6
10,123,5,6,13,7
10,123,6,7,13,6
10,124,0,4,9,5
10,124,1,0,2,2
10,124,2,2,8,6
10,124,3,1,3,2
10,124,4,15,23,8
10,124,5,2,7,5
10,124,6,3,8,5
10,125,0,2,5,3
10,125,1,5,11,6
10,125,2,4,8,4
10,125,3,0,5,5
10,125,4,11,15,4
10,125,5,2,9,7
10,125,6,6,11,5
10,126,0,1,5,4
10,126,1,2,10,8
10,126,2,0,8,8
10,126,3,0,6,6
10,126,4,2,6,4
10,126,5,5,9,4
10,126,6,7,12,5
10,127,0,1,4,3
10,127,1,2,4,2
10,127,2,5,11,6
10,127,3,0,5,5
10,127,4,2,6,4
10,127,5,0,4,4
10,127,6,0,6,6
10,128,0,3,8,5
10,128,1,1,6,5
10,128,2,5,12,7
10,128,3,2,7,5
10,128,4,3,8,5
10,128,5,0,2,2
10,128,6,1,2,1
10,129,0,3,9,6
10,129,1,0,3,3
10,129,2,0,1,1
10,129,3,4,5,1
10,129,4,0,3,3
10,129,5,2,7,5
10,129,6,1,5,4
10,130,0,0,4,4
10,130,1,4,5,1
10,130,2,3,7,4
10,130,3,1,5,4
10,130,4,2,5,3
10,130,5,1,3,2
10,130,6,1,3,2
10,131,0,0,1,1
10,131,1,1,3,2
10,131,2,5,9,4
10,131,3,2,4,2
10,131,4,0,2,2
10,131,5,0,6,6
10,131,6,0,3,3
10,132,0,1,3,2
10,132,1,0,1,1
10,132,2,0,7,7
10,132,3,1,5,4
10,132,4,0,4,4
10,132,5,1,9,8
10,132,6,2,5,3
10,133,0,1,4,3
10,133,1,3,8,5
10,133,2,0,5,5
10,133,3,2,6,4
10,133,4,0,4,4
10,133,5,2,6,4
10,133,6,1,2,1
10,134,0,2,3,1
10,134,1,0,1,1
10,134,2,2,6,4
10,134,3,0,8,8
10,134,4,0,2,2
10,134,5,3,9,6
10,134,6,0,3,3
10,135,1,0,2,2
10,135,2,0,7,7
10,135,3,0,2,2
10,135,4,0,4,4
10,135,5,1,8,7
10,135,6,1,6,5
10,136,0,0,2,2
10,136,1,1,2,1
10,136,3,1,3,2
10,136,4,0,3,3
10,136,5,1,4,3
10,136,6,0,4,4
10,137,0,0,4,4
10,137,3,0,3,3
10,137,4,0,1,1
10,137,5,3,7,4
10,138,0,0,2,2
10,138,1,0,4,4
10,138,2,0,1,1
10,138,3,0,2,2
10,138,4,1,2,1
10,138,5,0,5,5
10,138,6,2,2,0
10,139,1,0,1,1
10,139,2,1,2,1
10,139,3,0,1,1
10,139,4,0,4,4
10,139,5,0,3,3
10,140,0,0,1,1
10,140,3,0,3,3
10,140,4,1,3,2
10,140,5,0,2,2
10,140,6,0,1,1
10,141,2,0,2,2
10,141,3,3,4,1
10,141,4,0,3,3
10,142,2,0,1,1
10,142,3,1,6,5
10,142,4,1,1,0
10,142,5,0,1,1
10,143,1,1,2,1
10,143,3,0,1,1
10,143,4,0,2,2
10,143,5,1,1,0
10,143,6,0,1,1
11,0,0,6,32,26
11,0,1,5,30,25
11,0,2,2,27,25
11,0,3,4,33,29
11,0,4,4,30,26
11,0,5,4,25,21
11,0,6,2,30,28
11,1,0,11,33,22
11,1,1,2,18,16
11,1,2,5,16,11
11,1,3,4,22,18
11,1,4,1,25,24
11,1,5,1,29,28
11,1,6,3,18,15
11,2,0,1,23,22
11,2,1,0,16,16
11,2,2,0,13,13
11,2,3,2,23,21
11,2,4,1,26,25
11,2,5,4,22,18
11,2,6,0,19,19
11,3,0,2,19,17
11,3,1,2,20,18
11,3,2,1,10,9
11,3,3,3,22,19
11,3,4,0,19,19
11,3,5,6,23,17
11,3,6,1,14,13
11,4,0,2,16,14
11,4,1,3,22,19
11,4,2,2,18,16
11,4,3,4,18,14
11,4,4,4,32,28
11,4,5,4,14,10
11,4,6,2,21,19
11,5,0,2,12,10
11,5,1,2,19,17
11,5,2,4,15,11
11,5,3,0,15,15
11,5,4,0,29,29
11,5,5,1,22,21
11,5,6,0,16,16
11,6,0,2,19,17
11,6,1,4,16,12
11,6,2,3,14,11
11,6,3,6,19,13
11,6,4,0,20,20
11,6,5,1,16,15
11,6,6,1,17,16
11,7,0,3,19,16
11,7,1,1,11,10
11,7,2,2,10,8
11,7,3,0,13,13
11,7,4,0,16,16
11,7,5,6,27,21
11,7,6,3,12,9
11,8,0,1,10,9
11,8,1,2,17,15
11,8,2,1,11,10
11,8,3,3,17,14
11,8,4,4,20,16
11,8,5,2,18,16
11,8,6,1,14,13
11,9,0,1,14,13
11,9,1,1,7,6
11,9,2,0,7,7
11,9,3,2,13,11
11,9,4,3,18,15
11,9,5,2,7,5
11,9,6,7,20,13
11,10,0,4,12,8
11,10,1,1,7,6
11,10,2,1,12,11
11,10,3,0,7,7
11,10,4,5,20,15
11,10,5,1,7,6
11,10,6,0,14,14
11,11,0,2,8,6
11,11,1,2,9,7
11,11,2,0,6,6
11,11,3,1,5,4
11,11,4,2,12,10
11,11,5,1,12,11
11,11,6,1,15,14
11,12,0,0,7,7
11,12,1,1,7,6
11,12,2,1,12,11
11,12,3,1,6,5
11,12,4,6,19,13
11,12,5,1,12,11
11,12,6,1,9,8
11,13,0,0,4,4
11,13,1,0,10,10
11,13,2,1,8,7
11,13,3,2,11,9
11,13,4,0,7,7
11,13,5,1,9,8
11,13,6,1,9,8
11,14,0,0,5,5
11,14,1,2,6,4
11,14,2,2,11,9
11,14,3,0,4,4
11,14,4,3,11,8
11,14,5,2,20,18
11,14,6,4,11,7
11,15,0,3,9,6
11,15,1,4,5,1
11,15,2,1,6,5
11,15,3,2,9,7
11,15,4,1,14,13
11,15,5,5,17,12
11,15,6,9,16,7
11,16,0,5,8,3
11,16,1,0,5,5
11,16,2,1,5,4
11,16,3,1,6,5
11,16,4,1,9,8
11,16,5,3,13,10
11,16,6,1,7,6
11,17,0,4,8,4
11,17,1,0,5,5
11,17,2,1,3,2
11,17,3,0,7,7
11,17,4,7,15,8
11,17,5,7,18,11
11,17,6,1,3,2
11,18,0,1,5,4
11,18,1,0,1,1
11,18,2,2,7,5
11,18,3,1,4,3
11,18,4,1,5,4
11,18,5,2,7,5
11,18,6,1,6,5
11,19,0,1,2,1
11,19,1,0,4,4
11,19,2,3,9,6
11,19,3,1,5,4
11,19,4,2,4,2
11,19,5,4,5,1
11,19,6,3,7,4
11,20,0,1,5,4
11,20,1,0,1,1
11,20,2,3,5,2
11,20,3,0,1,1
11,20,4,1,5,4
11,20,5,2,12,10
11,20,6,0,4,4
11,21,0,0,5,5
11,21,1,2,3,1
11,21,2,3,5,2
11,21,3,1,3,2
11,21,4,2,4,2
11,21,5,0,2,2
11,21,6,1,3,2
11,22,0,6,10,4
11,22,1,1,9,8
11,22,2,1,3,2
11,22,3,1,1,0
11,22,4,7,7,0
11,22,5,5,10,5
11,22,6,7,8,1
11,23,0,0,3,3
11,23,1,2,6,4
11,23,2,1,2,1
11,23,3,1,2,1
11,23,4,1,3,2
11,23,5,1,5,4
11,23,6,3,8,5
11,24,0,0,2,2
11,24,1,4,6,2
11,24,2,0,3,3
11,24,3,0,1,1
11,24,4,0,2,2
11,24,5,8,8,0
11,24,6,0,2,2
11,25,0,0,1,1
11,25,1,1,2,1
11,25,2,1,2,1
11,25,3,0,2,2
11,25,4,5,8,3
11,25,5,2,5,3
11,25,6,0,1,1
11,26,0,1,3,2
11,26,1,0,3,3
11,26,2,1,6,5
11,26,4,1,5,4
11,26,5,1,1,0
11,26,6,0,2,2
11,27,0,2,3,1
11,27,1,1,3,2
11,27,2,0,1,1
11,27,3,2,4,2
11,27,4,0,3,3
11,27,5,4,5,1
11,27,6,2,4,2
11,28,0,2,5,3
11,28,1,0,1,1
11,28,2,0,1,1
11,28,3,1,4,3
11,28,4,0,1,1
11,28,5,7,10,3
11,28,6,0,1,1
11,29,0,1,2,1
11,29,1,4,8,4
11,29,2,1,4,3
11,29,3,0,1,1
11,29,4,2,7,5
11,29,5,2,5,3
11,29,6,1,3,2
11,30,0,1,3,2
11,30,1,6,9,3
11,30,2,4,7,3
11,30,3,2,3,1
11,30,4,12,15,3
11,30,5,1,6,5
11,30,6,0,2,2
11,31,0,0,4,4
11,31,1,3,9,6
11,31,2,2,5,3
11,31,3,1,3,2
11,31,4,1,3,2
11,31,5,0,3,3
11,31,6,1,2,1
11,32,0,1,1,0
11,32,1,5,7,2
11,32,2,0,2,2
11,32,3,4,8,4
11,32,4,1,3,2
11,32,5,0,5,5
11,32,6,0,6,6
11,33,0,2,4,2
11,33,1,7,11,4
11,33,2,1,5,4
11,33,3,2,5,3
11,33,4,4,6,2
11,33,5,1,4,3
11,33,6,2,5,3
11,34,0,2,10,8
11,34,1,0,4,4
11,34,2,2,8,6
11,34,3,2,3,1
11,34,4,5,9,4
11,34,5,3,6,3
11,34,6,0,7,7
11,35,0,3,8,5
11,35,1,2,6,4
11,35,2,3,4,1
11,35,3,6,11,5
11,35,4,5,9,4
11,35,5,0,5,5
11,35,6,0,1,1
11,36,0,4,9,5
11,36,1,6,13,7
11,36,2,2,8,6
11,36,3,12,17,5
11,36,4,7,15,8
11,36,5,5,8,3
11,36,6,1,6,5
11,37,0,2,11,9
11,37,1,5,16,11
11,37,2,4,8,4
11,37,3,2,11,9
11,37,4,9,13,4
11,37,5,7,15,8
11,37,6,2,8,6
11,38,0,8,20,12
11,38,1,1,16,15
11,38,2,0,18,18
11,38,3,6,20,14
11,38,4,4,17,13
11,38,5,1,11,10
11,38,6,3,10,7
11,39,0,2,29,27
11,39,1,0,18,18
11,39,2,0,20,20
11,39,3,3,23,20
11,39,4,0,14,14
11,39,5,1,21,20
11,39,6,0,12,12
11,40,0,0,25,25
11,40,1,1,29,28
11,40,2,3,28,25
11,40,3,1,24,23
11,40,4,1,28,27
11,40,5,2,22,20
11,40,6,1,13,12
11,41,0,1,29,28
11,41,1,1,25,24
11,41,2,1,28,27
11,41,3,1,29,28
11,41,4,1,20,19
11,41,5,0,15,15
11,41,6,0,15,15
11,42,0,0,62,62
11,42,1,2,64,62
11,42,2,3,54,51
11,42,3,6,62,56
11,42,4,1,60,59
11,42,5,0,35,35
11,42,6,3,38,35
11,43,0,0,98,98
11,43,1,1,76,75
11,43,2,1,85,84
11,43,3,1,82,81
11,43,4,4,71,67
11,43,5,3,51,48
11,43,6,7,60,53
11,44,0,2,114,112
11,44,1,5,98,93
11,44,2,5,112,107
11,44,3,4,144,140
11,44,4,2,93,91
11,44,5,3,69,66
11,44,6,5,59,54
11,45,0,1,193,192
11,45,1,2,126,124
11,45,2,1,153,152
11,45,3,6,176,170
11,45,4,1,123,122
11,45,5,2,64,62
11,45,6,2,66,64
11,46,0,3,150,147
11,46,1,4,168,164
11,46,2,5,156,151
11,46,3,8,184,176
11,46,4,1,119,118
11,46,5,2,118,116
11,46,6,5,60,55
11,47,0,5,162,157
11,47,1,3,136,133
11,47,2,4,141,137
11,47,3,5,183,178
11,47,4,7,124,117
11,47,5,0,100,100
11,47,6,7,84,77
11,48,0,7,170,163
11,48,1,5,159,154
11,48,2,6,163,157
11,48,3,5,187,182
11,48,4,5,124,119
11,48,5,3,90,87
11,48,6,2,69,67
11,49,0,24,182,158
11,49,1,2,161,159
11,49,2,2,163,161
11,49,3,32,204,172
11,49,4,7,147,140
11,49,5,3,95,92
11,49,6,3,79,76
11,50,0,13,150,137
11,50,1,12,152,140
11,50,2,3,147,144
11,50,3,28,190,162
11,50,4,2,111,109
11,50,5,3,92,89
11,50,6,1,87,86
11,51,0,29,195,166
11,51,1,38,200,162
11,51,2,10,168,158
11,51,3,46,215,169
11,51,4,15,126,111
11,51,5,2,107,105
11,51,6,2,97,95
11,52,0,37,175,138
11,52,1,31,162,131
11,52,2,17,147,130
11,52,3,42,184,142
11,52,4,20,132,112
11,52,5,1,98,97
11,52,6,3,99,96
11,53,0,27,134,107
11,53,1,5,98,93
11,53,2,2,103,101
11,53,3,14,138,124
11,53,4,6,94,88
11,53,5,1,90,89
11,53,6,7,93,86
11,54,0,3,99,96
11,54,1,3,92,89
11,54,2,4,88,84
11,54,3,3,96,93
11,54,4,3,101,98
11,54,5,2,75,73
11,54,6,1,68,67
11,55,0,6,106,100
11,55,1,6,96,90
11,55,2,3,99,96
11,55,3,2,88,86
11,55,4,1,77,76
11,55,5,0,98,98
11,55,6,3,67,64
11,56,0,1,73,72
11,56,1,1,66,65
11,56,2,2,84,82
11,56,3,3,74,71
11,56,4,3,89,86
11,56,5,2,75,73
11,56,6,5,75,70
11,57,0,2,81,79
11,57,1,7,78,71
11,57,2,2,73,71
11,57,3,4,72,68
11,57,4,3,76,73
11,57,5,4,62,58
11,57,6,2,83,81
11,58,0,11,81,70
11,58,1,2,66,64
11,58,2,4,58,54
11,58,3,9,75,66
11,58,4,8,85,77
11,58,5,4,82,78
11,58,6,2,74,72
11,59,0,13,87,74
11,59,1,3,73,70
11,59,2,1,53,52
11,59,3,4,84,80
11,59,4,6,67,61
11,59,5,4,83,79
11,59,6,1,74,73
11,60,0,4,77,73
11,60,1,0,71,71
11,60,2,9,63,54
11,60,3,7,70,63
11,60,4,13,79,66
11,60,5,4,96,92
11,60,6,4,92,88
11,61,0,8,87,79
11,61,1,10,77,67
11,61,2,6,98,92
11,61,3,10,82,72
11,61,4,9,74,65
11,61,5,4,100,96
11,61,6,4,98,94
11,62,0,6,83,77
11,62,1,4,57,53
11,62,2,9,67,58
11,62,3,0,58,58
11,62,4,4,62,58
11,62,5,2,84,82
11,62,6,4,82,78
11,63,0,2,65,63
11,63,1,4,59,55
11,63,2,1,64,63
11,63,3,2,60,58
11,63,4,15,86,71
11,63,5,9,90,81
11,63,6,4,82,78
11,64,0,6,51,45
11,64,1,5,59,54
11,64,2,0,54,54
11,64,3,1,52,51
11,64,4,11,76,65
11,64,5,9,91,82
11,64,6,4,81,77
11,65,0,2,69,67
11,65,1,1,56,55
11,65,2,2,57,55
11,65,3,1,58,57
11,65,4,23,85,62
11,65,5,1,78,77
11,65,6,1,57,56
11,66,0,5,58,53
11,66,1,1,66,65
11,66,2,5,67,62
11,66,3,0,76,76
11,66,4,25,81,56
11,66,5,2,64,62
11,66,6,0,74,74
11,67,0,0,52,52
11,67,1,3,58,55
11,67,2,11,74,63
11,67,3,6,72,66
11,67,4,45,118,73
11,67,5,3,74,71
11,67,6,4,72,68
11,68,0,3,67,64
11,68,1,3,63,60
11,68,2,3,64,61
11,68,3,0,64,64
11,68,4,19,84,65
11,68,5,2,71,69
11,68,6,6,71,65
11,69,0,3,54,51
11,69,1,1,55,54
11,69,2,3,60,57
11,69,3,8,75,67
11,69,4,26,94,68
11,69,5,4,59,55
11,69,6,4,92,88
11,70,0,1,63,62
11,70,1,0,46,46
11,70,2,5,66,61
11,70,3,3,53,50
11,70,4,17,83,66
11,70,5,2,87,85
11,70,6,6,85,79
11,71,0,3,65,62
11,71,1,1,54,53
11,71,2,4,60,56
11,71,3,6,71,65
11,71,4,7,70,63
11,71,5,0,53,53
11,71,6,6,93,87
11,72,0,0,68,68
11,72,1,1,69,68
11,72,2,4,77,73
11,72,3,1,68,67
11,72,4,14,80,66
11,72,5,0,84,84
11,72,6,4,94,90
11,73,0,3,57,54
11,73,1,3,63,60
11,73,2,4,74,70
11,73,3,3,60,57
11,73,4,17,99,82
11,73,5,0,83,83
11,73,6,6,95,89
11,74,0,4,62,58
11,74,1,1,57,56
11,74,2,6,58,52
11,74,3,4,63,59
11,74,4,17,92,75
11,74,5,3,92,89
11,74,6,5,84,79
11,75,0,4,71,67
11,75,1,6,62,56
11,75,2,5,68,63
11,75,3,13,87,74
11,75,4,10,87,77
11,75,5,6,87,81
11,75,6,2,89,87
11,76,0,4,83,79
11,76,1,4,68,64
11,76,2,5,86,81
11,76,3,5,75,70
11,76,4,8,69,61
11,76,5,4,81,77
11,76,6,5,85,80
11,77,0,1,72,71
11,77,1,2,70,68
11,77,2,1,48,47
11,77,3,2,70,68
11,77,4,19,91,72
11,77,5,6,98,92
11,77,6,5,92,87
11,78,0,0,69,69
11,78,1,7,72,65
11,78,2,2,70,68
11,78,3,1,80,79
11,78,4,10,73,63
11,78,5,6,96,90
11,78,6,2,88,86
11,79,0,6,74,68
11,79,1,4,65,61
11,79,2,1,79,78
11,79,3,6,92,86
11,79,4,18,106,88
11,79,5,19,132,113
11,79,6,3,100,97
11,80,0,3,62,59
11,80,1,6,79,73
11,80,2,5,82,77
11,80,3,4,66,62
11,80,4,39,115,76
11,80,5,4,103,99
11,80,6,3,115,112
11,81,0,6,71,65
11,81,1,3,65,62
11,81,2,6,67,61
11,81,3,4,75,71
11,81,4,15,92,77
11,81,5,10,92,82
11,81,6,7,95,88
11,82,0,6,73,67
11,82,1,1,63,62
11,82,2,6,79,73
11,82,3,2,73,71
11,82,4,15,92,77
11,82,5,4,86,82
11,82,6,1,88,87
11,83,0,1,72,71
11,83,1,4,72,68
11,83,2,0,54,54
11,83,3,3,75,72
11,83,4,16,91,75
11,83,5,3,71,68
11,83,6,1,95,94
11,84,0,3,85,82
11,84,1,3,72,69
11,84,2,5,90,85
11,84,3,4,79,75
11,84,4,11,97,86
11,84,5,3,97,94
11,84,6,0,99,99
11,85,0,3,63,60
11,85,1,4,78,74
11,85,2,11,79,68
11,85,3,3,69,66
11,85,4,19,92,73
11,85,5,4,82,78
11,85,6,3,74,71
11,86,0,1,64,63
11,86,1,1,62,61
11,86,2,2,76,74
11,86,3,1,69,68
11,86,4,13,88,75
11,86,5,4,71,67
11,86,6,1,82,81
11,87,0,5,76,71
11,87,1,6,78,72
11,87,2,0,55,55
11,87,3,1,51,50
11,87,4,9,84,75
11,87,5,4,71,67
11,87,6,5,81,76
11,88,0,4,69,65
11,88,1,2,71,69
11,88,2,9,73,64
11,88,3,1,48,47
11,88,4,8,88,80
11,88,5,3,77,74
11,88,6,1,72,71
11,89,0,0,46,46
11,89,1,0,68,68
11,89,2,4,73,69
11,89,3,1,64,63
11,89,4,8,76,68
11,89,5,2,76,74
11,89,6,3,79,76
11,90,0,2,63,61
11,90,1,2,67,65
11,90,2,0,48,48
11,90,3,2,71,69
11,90,4,2,70,68
11,90,5,3,75,72
11,90,6,2,101,99
11,91,0,2,51,49
11,91,1,2,65,63
11,91,2,5,62,57
11,91,3,6,70,64
11,91,4,6,84,78
11,91,5,1,66,65
11,91,6,1,83,82
11,92,0,6,61,55
11,92,1,4,76,72
11,92,2,2,76,74
11,92,3,2,67,65
11,92,4,7,73,66
11,92,5,1,71,70
11,92,6,3,84,81
11,93,0,1,89,88
11,93,1,0,80,80
11,93,2,3,66,63
11,93,3,1,63,62
11,93,4,0,80,80
11,93,5,3,101,98
11,93,6,4,92,88
11,94,0,1,58,57
11,94,1,8,71,63
11,94,2,2,77,75
11,94,3,4,63,59
11,94,4,4,84,80
11,94,5,7,80,73
11,94,6,4,83,79
11,95,0,0,76,76
11,95,1,1,62,61
11,95,2,4,88,84
11,95,3,4,85,81
11,95,4,3,95,92
11,95,5,3,84,81
11,95,6,2,82,80
11,96,0,6,84,78
11,96,1,0,84,84
11,96,2,0,113,113
11,96,3,3,108,105
11,96,4,3,66,63
11,96,5,2,102,100
11,96,6,4,106,102
11,97,0,0,74,74
11,97,1,3,85,82
11,97,2,3,70,67
11,97,3,4,88,84
11,97,4,2,96,94
11,97,5,1,77,76
11,97,6,5,86,81
11,98,0,2,64,62
11,98,1,2,83,81
11,98,2,2,85,83
11,98,3,5,93,88
11,98,4,5,81,76
11,98,5,4,98,94
11,98,6,2,87,85
11,99,0,4,84,80
11,99,1,6,61,55
11,99,2,3,79,76
11,99,3,5,86,81
11,99,4,3,80,77
11,99,5,5,117,112
11,99,6,1,96,95
11,100,0,6,80,74
11,100,1,3,81,78
11,100,2,5,97,92
11,100,3,4,82,78
11,100,4,4,96,92
11,100,5,6,97,91
11,100,6,4,96,92
11,101,0,6,103,97
11,101,1,6,103,97
11,101,2,2,109,107
11,101,3,7,101,94
11,101,4,2,98,96
11,101,5,2,113,111
11,101,6,2,111,109
11,102,0,3,118,115
11,102,1,2,125,123
11,102,2,5,135,130
11,102,3,5,133,128
11,102,4,5,126,121
11,102,5,1,122,121
11,102,6,6,98,92
11,103,0,4,115,111
11,103,1,5,119,114
11,103,2,7,130,123
11,103,3,2,127,125
11,103,4,6,109,103
11,103,5,1,110,109
11,103,6,2,95,93
11,104,0,3,102,99
11,104,1,8,100,92
11,104,2,5,124,119
11,104,3,11,114,103
11,104,4,3,126,123
11,104,5,2,113,111
11,104,6,1,118,117
11,105,0,3,93,90
11,105,1,2,114,112
11,105,2,5,100,95
11,105,3,5,114,109
11,105,4,5,136,131
11,105,5,5,116,111
11,105,6,6,100,94
11,106,0,6,105,99
11,106,1,3,109,106
11,106,2,8,140,132
11,106,3,6,106,100
11,106,4,8,125,117
11,106,5,8,106,98
11,106,6,3,90,87
11,107,0,5,101,96
11,107,1,2,94,92
11,107,2,7,112,105
11,107,3,10,120,110
11,107,4,1,97,96
11,107,5,1,86,85
11,107,6,0,77,77
11,108,0,2,95,93
11,108,1,5,122,117
11,108,2,8,118,110
11,108,3,3,136,133
11,108,4,3,112,109
11,108,5,0,91,91
11,108,6,3,90,87
11,109,0,4,84,80
11,109,1,3,71,68
11,109,2,1,101,100
11,109,3,1,107,106
11,109,4,3,97,94
11,109,5,4,87,83
11,109,6,2,83,81
11,110,0,4,91,87
11,110,1,3,78,75
11,110,2,3,96,93
11,110,3,1,81,80
11,110,4,6,95,89
11,110,5,0,76,76
11,110,6,3,84,81
11,111,0,4,89,85
11,111,1,6,82,76
11,111,2,2,101,99
11,111,3,3,82,79
11,111,4,2,89,87
11,111,5,4,77,73
11,111,6,7,99,92
11,112,0,5,70,65
11,112,1,0,79,79
11,112,2,5,69,64
11,112,3,2,79,77
11,112,4,1,80,79
11,112,5,2,75,73
11,112,6,6,80,74
11,113,0,8,84,76
11,113,1,3,83,80
11,113,2,3,79,76
11,113,3,5,66,61
11,113,4,3,74,71
11,113,5,0,73,73
11,113,6,1,98,97
11,114,0,8,71,63
11,114,1,2,84,82
11,114,2,2,71,69
11,114,3,1,57,56
11,114,4,3,72,69
11,114,5,3,71,68
11,114,6,1,78,77
11,115,0,3,68,65
11,115,1,3,59,56
11,115,2,2,64,62
11,115,3,3,80,77
11,115,4,2,68,66
11,115,5,4,63,59
11,115,6,3,87,84
11,116,0,2,67,65
11,116,1,3,73,70
11,116,2,0,68,68
11,116,3,3,80,77
11,116,4,4,69,65
11,116,5,3,74,71
11,116,6,5,66,61
11,117,0,0,49,49
11,117,1,10,71,61
11,117,2,2,72,70
11,117,3,3,68,65
11,117,4,2,81,79
11,117,5,5,67,62
11,117,6,2,71,69
11,118,0,1,53,52
11,118,1,10,72,62
11,118,2,4,68,64
11,118,3,4,67,63
11,118,4,2,83,81
11,118,5,2,86,84
11,118,6,0,76,76
11,119,0,2,44,42
11,119,1,8,82,74
11,119,2,0,67,67
11,119,3,3,65,62
11,119,4,2,62,60
11,119,5,1,55,54
11,119,6,3,69,66
11,120,0,0,48,48
11,120,1,0,54,54
11,120,2,3,62,59
11,120,3,1,58,57
11,120,4,4,87,83
11,120,5,5,83,78
11,120,6,0,75,75
11,121,0,1,60,59
11,121,1,3,73,70
11,121,2,0,54,54
11,121,3,0,50,50
11,121,4,5,57,52
11,121,5,2,75,73
11,121,6,2,77,75
11,122,0,2,58,56
11,122,1,2,65,63
11,122,2,1,64,63
11,122,3,2,62,60
11,122,4,4,83,79
11,122,5,3,56,53
11,122,6,5,66,61
11,123,0,2,64,62
11,123,1,0,53,53
11,123,2,6,68,62
11,123,3,3,70,67
11,123,4,1,74,73
11,123,5,3,59,56
11,123,6,8,70,62
11,124,0,2,46,44
11,124,1,1,52,51
11,124,2,4,64,60
11,124,3,2,69,67
11,124,4,4,58,54
11,124,5,0,57,57
11,124,6,6,76,70
11,125,0,3,50,47
11,125,1,0,63,63
11,125,2,2,56,54
11,125,3,7,55,48
11,125,4,7,71,64
11,125,5,2,59,57
11,125,6,2,59,57
11,126,0,2,58,56
11,126,1,4,63,59
11,126,2,1,66,65
11,126,3,4,62,58
11,126,4,5,74,69
11,126,5,5,60,55
11,126,6,2,65,63
11,127,0,0,52,52
11,127,1,3,57,54
11,127,2,3,51,48
11,127,3,2,52,50
11,127,4,3,66,63
11,127,5,1,49,48
11,127,6,3,51,48
11,128,0,5,55,50
11,128,1,2,59,57
11,128,2,3,72,69
11,128,3,3,41,38
11,128,4,3,55,52
11,128,5,3,51,48
11,128,6,3,56,53
11,129,0,4,54,50
11,129,1,0,57,57
11,129,2,0,60,60
11,129,3,4,57,53
11,129,4,3,69,66
11,129,5,3,66,63
11,129,6,1,53,52
11,130,0,6,54,48
11,130,1,4,50,46
11,130,2,1,55,54
11,130,3,4,54,50
11,130,4,3,54,51
11,130,5,2,55,53
11,130,6,3,42,39
11,131,0,4,46,42
11,131,1,0,34,34
11,131,2,3,64,61
11,131,3,3,52,49
11,131,4,0,40,40
11,131,5,3,41,38
11,131,6,0,33,33
11,132,0,1,41,40
11,132,1,1,32,31
11,132,2,1,49,48
11,132,3,0,45,45
11,132,4,3,36,33
11,132,5,0,35,35
11,132,6,1,37,36
11,133,0,0,42,42
11,133,1,2,36,34
11,133,2,2,50,48
11,133,3,1,36,35
11,133,4,3,50,47
11,133,5,3,58,55
11,133,6,2,38,36
11,134,0,2,44,42
11,134,1,1,40,39
11,134,2,1,44,43
11,134,3,2,49,47
11,134,4,2,38,36
11,134,5,6,54,48
11,134,6,4,44,40
11,135,0,2,30,28
11,135,1,1,33,32
11,135,2,5,40,35
11,135,3,1,32,31
11,135,4,2,55,53
11,135,5,0,61,61
11,135,6,0,40,40
11,136,0,1,32,31
11,136,1,0,31,31
11,136,2,1,37,36
11,136,3,4,42,38
11,136,4,2,35,33
11,136,5,2,52,50
11,136,6,1,35,34
11,137,0,0,30,30
11,137,1,1,31,30
11,137,2,4,45,41
11,137,3,3,36,33
11,137,4,11,60,49
11,137,5,1,39,38
11,137,6,4,32,28
11,138,0,2,26,24
11,138,1,2,34,32
11,138,2,3,34,31
11,138,3,1,27,26
11,138,4,5,36,31
11,138,5,2,21,19
11,138,6,6,40,34
11,139,0,2,27,25
11,139,1,3,30,27
11,139,2,2,25,23
11,139,3,0,31,31
11,139,4,1,34,33
11,139,5,2,28,26
11,139,6,1,18,17
11,140,0,3,29,26
11,140,1,5,31,26
11,140,2,0,30,30
11,140,3,3,32,29
11,140,4,2,31,29
11,140,5,1,44,43
11,140,6,0,24,24
11,141,0,1,22,21
11,141,1,1,22,21
11,141,2,2,34,32
11,141,3,5,33,28
11,141,4,0,27,27
11,141,5,1,29,28
11,141,6,1,23,22
11,142,0,1,21,20
11,142,1,1,23,22
11,142,2,2,31,29
11,142,3,1,31,30
11,142,4,1,32,31
11,142,5,2,30,28
11,142,6,0,19,19
11,143,0,4,34,30
11,143,1,1,26,25
11,143,2,0,19,19
11,143,3,2,20,18
11,143,4,3,35,32
11,143,5,5,42,37
11,143,6,5,23,18
12,0,0,30,211,181
12,0,1,28,186,158
12,0,2,22,180,158
12,0,3,24,196,172
12,0,4,25,281,256
12,0,5,20,229,209
12,0,6,44,278,234
12,1,0,50,201,151
12,1,1,38,170,132
12,1,2,30,194,164
12,1,3,19,173,154
12,1,4,18,289,271
12,1,5,27,226,199
12,1,6,55,263,208
12,2,0,57,189,132
12,2,1,26,144,118
12,2,2,31,162,131
12,2,3,38,168,130
12,2,4,24,259,235
12,2,5,36,236,200
12,2,6,53,251,198
12,3,0,56,181,125
12,3,1,45,157,112
12,3,2,20,151,131
12,3,3,28,172,144
12,3,4,21,253,232
12,3,5,29,192,163
12,3,6,23,185,162
12,4,0,29,142,113
12,4,1,24,135,111
12,4,2,26,150,124
12,4,3,27,146,119
12,4,4,14,244,230
12,4,5,33,192,159
12,4,6,16,173,157
12,5,0,18,106,88
12,5,1,12,123,111
12,5,2,8,115,107
12,5,3,30,151,121
12,5,4,14,239,225
12,5,5,26,171,145
12,5,6,9,134,125
12,6,0,38,134,96
12,6,1,37,134,97
12,6,2,13,126,113
12,6,3,22,110,88
12,6,4,14,210,196
12,6,5,10,135,125
12,6,6,33,178,145
12,7,0,26,106,80
12,7,1,23,117,94
12,7,2,34,124,90
12,7,3,16,101,85
12,7,4,8,171,163
12,7,5,10,117,107
12,7,6,14,114,100
12,8,0,9,80,71
12,8,1,5,82,77
12,8,2,12,92,80
12,8,3,3,89,86
12,8,4,18,196,178
12,8,5,9,115,106
12,8,6,16,129,113
12,9,0,10,85,75
12,9,1,9,81,72
12,9,2,10,75,65
12,9,3,17,82,65
12,9,4,14,148,134
12,9,5,18,133,115
12,9,6,21,127,106
12,10,0,23,106,83
12,10,1,25,88,63
12,10,2,16,91,75
12,10,3,17,106,89
12,10,4,16,158,142
12,10,5,10,101,91
12,10,6,15,107,92
12,11,0,9,78,69
12,11,1,12,72,60
12,11,2,21,92,71
12,11,3,13,96,83
12,11,4,16,133,117
12,11,5,4,87,83
12,11,6,18,112,94
12,12,0,2,60,58
12,12,1,12,83,71
12,12,2,8,80,72
12,12,3,10,71,61
12,12,4,10,111,101
12,12,5,17,95,78
12,12,6,9,92,83
12,13,0,8,68,60
12,13,1,6,61,55
12,13,2,14,78,64
12,13,3,1,38,37
12,13,4,1,93,92
12,13,5,39,129,90
12,13,6,15,93,78
12,14,0,8,67,59
12,14,1,2,55,53
12,14,2,3,49,46
12,14,3,5,54,49
12,14,4,4,78,74
12,14,5,51,121,70
12,14,6,15,82,67
12,15,0,10,56,46
12,15,1,15,57,42
12,15,2,4,46,42
12,15,3,2,63,61
12,15,4,7,75,68
12,15,5,19,82,63
12,15,6,6,51,45
12,16,0,11,56,45
12,16,1,3,56,53
12,16,2,4,48,44
12,16,3,8,54,46
12,16,4,4,61,57
12,16,5,12,52,40
12,16,6,5,65,60
12,17,0,6,44,38
12,17,1,4,44,40
12,17,2,3,53,50
12,17,3,7,37,30
12,17,4,18,90,72
12,17,5,7,50,43
12,17,6,7,55,48
12,18,0,15,53,38
12,18,1,8,39,31
12,18,2,3,42,39
12,18,3,1,35,34
12,18,4,45,93,48
12,18,5,5,48,43
12,18,6,12,61,49
12,19,0,5,37,32
12,19,1,4,39,35
12,19,2,6,45,39
12,19,3,3,41,38
12,19,4,17,75,58
12,19,5,8,52,44
12,19,6,8,46,38
12,20,0,12,44,32
12,20,1,7,39,32
12,20,2,8,30,22
12,20,3,3,27,24
12,20,4,18,63,45
12,20,5,4,44,40
12,20,6,9,51,42
12,21,0,5,32,27
12,21,1,3,31,28
12,21,2,7,43,36
12,21,3,4,33,29
12,21,4,11,56,45
12,21,5,3,43,40
12,21,6,2,34,32
12,22,0,6,36,30
12,22,1,0,30,30
12,22,2,8,31,23
12,22,3,4,27,23
12,22,4,4,33,29
12,22,5,27,67,40
12,22,6,17,49,32
12,23,0,4,26,22
12,23,1,1,19,18
12,23,2,4,23,19
12,23,3,5,29,24
12,23,4,1,27,26
12,23,5,5,43,38
12,23,6,8,35,27
12,24,0,2,19,17
12,24,1,0,23,23
12,24,2,9,36,27
12,24,3,3,21,18
12,24,4,20,44,24
12,24,5,5,30,25
12,24,6,7,32,25
12,25,0,6,24,18
12,25,1,2,23,21
12,25,2,17,38,21
12,25,3,5,20,15
12,25,4,23,50,27
12,25,5,4,21,17
12,25,6,10,36,26
12,26,0,3,25,22
12,26,1,1,21,20
12,26,2,5,22,17
12,26,3,16,34,18
12,26,4,14,34,20
12,26,5,4,31,27
12,26,6,6,31,25
12,27,0,6,24,18
12,27,1,7,23,16
12,27,2,3,22,19
12,27,3,17,29,12
12,27,4,19,33,14
12,27,5,4,28,24
12,27,6,3,21,18
12,28,0,9,27,18
12,28,1,8,23,15
12,28,2,6,22,16
12,28,3,6,22,16
12,28,4,3,25,22
12,28,5,1,18,17
12,28,6,10,34,24
12,29,0,2,16,14
12,29,1,6,28,22
12,29,2,5,22,17
12,29,3,3,17,14
12,29,4,16,36,20
12,29,5,7,23,16
12,29,6,7,24,17
12,30,0,14,27,13
12,30,1,13,26,13
12,30,2,3,18,15
12,30,3,5,29,24
12,30,4,18,29,11
12,30,5,0,17,17
12,30,6,5,18,13
12,31,0,8,24,16
12,31,1,12,26,14
12,31,2,4,19,15
12,31,3,4,21,17
12,31,4,34,51,17
12,31,5,8,24,16
12,31,6,11,29,18
12,32,0,11,27,16
12,32,1,8,17,9
12,32,2,8,25,17
12,32,3,6,20,14
12,32,4,22,38,16
12,32,5,13,33,20
12,32,6,23,41,18
12,33,0,8,23,15
12,33,1,10,22,12
12,33,2,7,24,17
12,33,3,10,27,17
12,33,4,21,37,16
12,33,5,7,20,13
12,33,6,21,33,12
12,34,0,6,20,14
12,34,1,10,25,15
12,34,2,9,28,19
12,34,3,13,29,16
12,34,4,35,51,16
12,34,5,2,19,17
12,34,6,9,25,16
12,35,0,16,34,18
12,35,1,14,39,25
12,35,2,14,33,19
12,35,3,9,26,17
12,35,4,37,64,27
12,35,5,12,34,22
12,35,6,14,32,18
12,36,0,25,48,23
12,36,1,25,51,26
12,36,2,17,33,16
12,36,3,18,40,22
12,36,4,51,67,16
12,36,5,17,42,25
12,36,6,14,40,26
12,37,0,14,46,32
12,37,1,8,36,28
12,37,2,20,50,30
12,37,3,7,37,30
12,37,4,38,64,26
12,37,5,11,31,20
12,37,6,27,48,21
12,38,0,26,79,53
12,38,1,22,58,36
12,38,2,19,58,39
12,38,3,11,49,38
12,38,4,34,64,30
12,38,5,7,30,23
12,38,6,10,40,30
12,39,0,5,117,112
12,39,1,5,85,80
12,39,2,8,99,91
12,39,3,1,61,60
12,39,4,14,74,60
12,39,5,6,64,58
12,39,6,7,69,62
12,40,0,3,119,116
12,40,1,7,100,93
12,40,2,8,99,91
12,40,3,4,118,114
12,40,4,37,138,101
12,40,5,4,63,59
12,40,6,8,62,54
12,41,0,6,159,153
12,41,1,7,170,163
12,41,2,4,163,159
12,41,3,3,131,128
12,41,4,13,128,115
12,41,5,1,77,76
12,41,6,12,90,78
12,42,0,10,279,269
12,42,1,3,213,210
12,42,2,5,239,234
12,42,3,7,219,212
12,42,4,11,169,158
12,42,5,7,124,117
12,42,6,14,111,97
12,43,0,12,314,302
12,43,1,4,273,269
12,43,2,5,290,285
12,43,3,6,287,281
12,43,4,5,217,212
12,43,5,5,150,145
12,43,6,25,162,137
12,44,0,8,390,382
12,44,1,10,369,359
12,44,2,7,395,388
12,44,3,10,371,361
12,44,4,6,276,270
12,44,5,13,182,169
12,44,6,14,142,128
12,45,0,17,436,419
12,45,1,5,369,364
12,45,2,16,452,436
12,45,3,17,452,435
12,45,4,8,321,313
12,45,5,8,225,217
12,45,6,13,209,196
12,46,0,23,457,434
12,46,1,3,375,372
12,46,2,17,427,410
12,46,3,37,503,466
12,46,4,6,329,323
12,46,5,7,216,209
12,46,6,6,220,214
12,47,0,55,507,452
12,47,1,5,453,448
12,47,2,23,512,489
12,47,3,62,522,460
12,47,4,10,358,348
12,47,5,10,264,254
12,47,6,1,191,190
12,48,0,125,646,521
12,48,1,22,530,508
12,48,2,52,554,502
12,48,3,60,583,523
12,48,4,17,406,389
12,48,5,13,290,277
12,48,6,6,233,227
12,49,0,147,611,464
12,49,1,90,569,479
12,49,2,63,575,512
12,49,3,85,601,516
12,49,4,29,393,364
12,49,5,14,288,274
12,49,6,9,234,225
12,50,0,127,651,524
12,50,1,69,585,516
12,50,2,48,506,458
12,50,3,62,557,495
12,50,4,16,398,382
12,50,5,7,250,243
12,50,6,16,269,253
12,51,0,126,641,515
12,51,1,51,568,517
12,51,2,27,578,551
12,51,3,75,614,539
12,51,4,31,451,420
12,51,5,10,313,303
12,51,6,12,293,281
12,52,0,91,551,460
12,52,1,63,523,460
12,52,2,29,465,436
12,52,3,79,560,481
12,52,4,41,408,367
12,52,5,13,334,321
12,52,6,10,313,303
12,53,0,40,406,366
12,53,1,22,409,387
12,53,2,13,373,360
12,53,3,23,372,349
12,53,4,15,322,307
12,53,5,9,266,257
12,53,6,6,234,228
12,54,0,11,342,331
12,54,1,9,327,318
12,54,2,9,347,338
12,54,3,8,381,373
12,54,4,3,256,253
12,54,5,6,267,261
12,54,6,3,242,239
12,55,0,3,312,309
12,55,1,17,340,323
12,55,2,5,326,321
12,55,3,20,367,347
12,55,4,8,263,255
12,55,5,10,268,258
12,55,6,7,228,221
12,56,0,3,262,259
12,56,1,14,278,264
12,56,2,8,309,301
12,56,3,4,314,310
12,56,4,4,283,279
12,56,5,2,262,260
12,56,6,3,208,205
12,57,0,9,289,280
12,57,1,4,272,268
12,57,2,7,286,279
12,57,3,2,268,266
12,57,4,9,254,245
12,57,5,3,244,241
12,57,6,3,241,238
12,58,0,8,250,242
12,58,1,6,296,290
12,58,2,13,252,239
12,58,3,4,293,289
12,58,4,8,260,252
12,58,5,9,285,276
12,58,6,3,266,263
12,59,0,8,248,240
12,59,1,3,255,252
12,59,2,11,260,249
12,59,3,3,289,286
12,59,4,13,261,248
12,59,5,11,275,264
12,59,6,5,242,237
12,60,0,15,263,248
12,60,1,5,246,241
12,60,2,7,220,213
12,60,3,6,248,242
12,60,4,7,264,257
12,60,5,8,272,264
12,60,6,4,249,245
12,61,0,12,248,236
12,61,1,11,245,234
12,61,2,5,244,239
12,61,3,9,258,249
12,61,4,15,254,239
12,61,5,9,269,260
12,61,6,7,274,267
12,62,0,7,241,234
12,62,1,6,263,257
12,62,2,10,267,257
12,62,3,7,246,239
12,62,4,8,228,220
12,62,5,5,263,258
12,62,6,3,271,268
12,63,0,5,255,250
12,63,1,10,266,256
12,63,2,6,232,226
12,63,3,7,289,282
12,63,4,9,268,259
12,63,5,7,277,270
12,63,6,9,287,278
12,64,0,8,264,256
12,64,1,1,261,260
12,64,2,8,257,249
12,64,3,24,294,270
12,64,4,8,282,274
12,64,5,3,266,263
12,64,6,7,269,262
12,65,0,9,267,258
12,65,1,9,238,229
12,65,2,7,238,231
12,65,3,6,255,249
12,65,4,15,297,282
12,65,5,11,283,272
12,65,6,9,264,255
12,66,0,7,255,248
12,66,1,9,222,213
12,66,2,8,274,266
12,66,3,6,251,245
12,66,4,11,268,257
12,66,5,10,256,246
12,66,6,10,303,293
12,67,0,1,287,286
12,67,1,4,244,240
12,67,2,5,299,294
12,67,3,10,284,274
12,67,4,23,312,289
12,67,5,7,318,311
12,67,6,20,341,321
12,68,0,5,282,277
12,68,1,3,261,258
12,68,2,5,259,254
12,68,3,8,281,273
12,68,4,32,291,259
12,68,5,14,320,306
12,68,6,26,305,279
12,69,0,8,295,287
12,69,1,5,306,301
12,69,2,24,320,296
12,69,3,7,306,299
12,69,4,25,316,291
12,69,5,12,287,275
12,69,6,26,352,326
12,70,0,11,298,287
12,70,1,6,296,290
12,70,2,33,305,272
12,70,3,10,289,279
12,70,4,25,308,283
12,70,5,10,311,301
12,70,6,16,338,322
12,71,0,5,256,251
12,71,1,7,230,223
12,71,2,11,272,261
12,71,3,7,286,279
12,71,4,25,301,276
12,71,5,9,285,276
12,71,6,10,298,288
12,72,0,4,269,265
12,72,1,7,245,238
12,72,2,2,257,255
12,72,3,9,227,218
12,72,4,9,255,246
12,72,5,14,288,274
12,72,6,5,326,321
12,73,0,6,235,229
12,73,1,6,224,218
12,73,2,9,260,251
12,73,3,4,257,253
12,73,4,26,296,270
12,73,5,8,289,281
12,73,6,9,315,306
12,74,0,6,244,238
12,74,1,2,256,254
12,74,2,10,261,251
12,74,3,9,295,286
12,74,4,18,274,256
12,74,5,11,305,294
12,74,6,11,341,330
12,75,0,6,291,285
12,75,1,3,258,255
12,75,2,5,244,239
12,75,3,10,289,279
12,75,4,17,341,324
12,75,5,10,313,303
12,75,6,8,323,315
12,76,0,10,301,291
12,76,1,8,301,293
12,76,2,8,254,246
12,76,3,10,283,273
12,76,4,12,283,271
12,76,5,8,337,329
12,76,6,7,357,350
12,77,0,12,290,278
12,77,1,6,279,273
12,77,2,8,305,297
12,77,3,12,326,314
12,77,4,8,290,282
12,77,5,9,357,348
12,77,6,16,331,315
12,78,0,6,291,285
12,78,1,12,294,282
12,78,2,10,313,303
12,78,3,10,312,302
12,78,4,13,301,288
12,78,5,7,360,353
12,78,6,7,380,373
12,79,0,5,310,305
12,79,1,5,314,309
12,79,2,6,292,286
12,79,3,11,316,305
12,79,4,14,348,334
12,79,5,9,365,356
12,79,6,4,344,340
12,80,0,9,305,296
12,80,1,8,323,315
12,80,2,9,329,320
12,80,3,7,321,314
12,80,4,19,335,316
12,80,5,18,382,364
12,80,6,14,380,366
12,81,0,6,324,318
12,81,1,13,341,328
12,81,2,10,333,323
12,81,3,19,391,372
12,81,4,25,358,333
12,81,5,9,343,334
12,81,6,13,407,394
12,82,0,13,331,318
12,82,1,7,306,299
12,82,2,7,317,310
12,82,3,8,310,302
12,82,4,20,364,344
12,82,5,6,388,382
12,82,6,26,446,420
12,83,0,3,309,306
12,83,1,8,337,329
12,83,2,15,342,327
12,83,3,5,308,303
12,83,4,15,334,319
12,83,5,6,331,325
12,83,6,38,455,417
12,84,0,8,318,310
12,84,1,10,247,237
12,84,2,11,316,305
12,84,3,3,288,285
12,84,4,15,353,338
12,84,5,7,323,316
12,84,6,17,425,408
12,85,0,7,298,291
12,85,1,1,287,286
12,85,2,12,304,292
12,85,3,10,310,300
12,85,4,15,336,321
12,85,5,9,342,333
12,85,6,18,420,402
12,86,0,7,330,323
12,86,1,7,286,279
12,86,2,6,322,316
12,86,3,8,300,292
12,86,4,13,328,315
12,86,5,10,352,342
12,86,6,9,378,369
12,87,0,5,353,348
12,87,1,2,280,278
12,87,2,10,333,323
12,87,3,9,309,300
12,87,4,16,368,352
12,87,5,5,353,348
12,87,6,16,410,394
12,88,0,10,320,310
12,88,1,7,299,292
12,88,2,13,356,343
12,88,3,9,297,288
12,88,4,25,369,344
12,88,5,5,415,410
12,88,6,6,386,380
12,89,0,11,326,315
12,89,1,10,304,294
12,89,2,14,329,315
12,89,3,16,336,320
12,89,4,10,357,347
12,89,5,6,345,339
12,89,6,13,403,390
12,90,0,6,325,319
12,90,1,6,320,314
12,90,2,4,308,304
12,90,3,16,343,327
12,90,4,24,399,375
12,90,5,15,384,369
12,90,6,13,439,426
12,91,0,4,336,332
12,91,1,9,339,330
12,91,2,11,345,334
12,91,3,11,310,299
12,91,4,69,407,338
12,91,5,6,348,342
12,91,6,9,391,382
12,92,0,13,318,305
12,92,1,6,323,317
12,92,2,12,386,374
12,92,3,46,407,361
12,92,4,49,422,373
12,92,5,14,366,352
12,92,6,8,430,422
12,93,0,6,387,381
12,93,1,7,306,299
12,93,2,7,394,387
12,93,3,13,403,390
12,93,4,12,375,363
12,93,5,14,380,366
12,93,6,6,424,418
12,94,0,7,336,329
12,94,1,10,361,351
12,94,2,8,434,426
12,94,3,7,339,332
12,94,4,6,401,395
12,94,5,10,416,406
12,94,6,13,473,460
12,95,0,7,328,321
12,95,1,10,357,347
12,95,2,18,411,393
12,95,3,12,342,330
12,95,4,10,405,395
12,95,5,15,448,433
12,95,6,19,479,460
12,96,0,9,380,371
12,96,1,13,374,361
12,96,2,11,403,392
12,96,3,13,358,345
12,96,4,10,418,408
12,96,5,12,432,420
12,96,6,12,488,476
12,97,0,6,387,381
12,97,1,9,384,375
12,97,2,11,425,414
12,97,3,8,395,387
12,97,4,10,400,390
12,97,5,10,504,494
12,97,6,9,495,486
12,98,0,13,383,370
12,98,1,12,403,391
12,98,2,13,423,410
12,98,3,7,428,421
12,98,4,14,471,457
12,98,5,7,474,467
12,98,6,16,540,524
12,99,0,13,443,430
12,99,1,11,436,425
12,99,2,26,535,509
12,99,3,11,429,418
12,99,4,22,468,446
12,99,5,20,491,471
12,99,6,16,522,506
12,100,0,17,442,425
12,100,1,13,401,388
12,100,2,14,479,465
12,100,3,13,445,432
12,100,4,23,476,453
12,100,5,14,493,479
12,100,6,17,549,532
12,101,0,7,445,438
12,101,1,6,477,471
12,101,2,7,449,442
12,101,3,13,473,460
12,101,4,18,505,487
12,101,5,15,533,518
12,101,6,12,550,538
12,102,0,11,501,490
12,102,1,14,538,524
12,102,2,17,580,563
12,102,3,19,607,588
12,102,4,11,537,526
12,102,5,17,584,567
12,102,6,7,572,565
12,103,0,31,533,502
12,103,1,8,585,577
12,103,2,36,612,576
12,103,3,20,585,565
12,103,4,22,554,532
12,103,5,16,550,534
12,103,6,8,581,573
12,104,0,10,455,445
12,104,1,14,483,469
12,104,2,86,646,560
12,104,3,20,554,534
12,104,4,28,562,534
12,104,5,15,541,526
12,104,6,12,536,524
12,105,0,14,474,460
12,105,1,11,511,500
12,105,2,92,603,511
12,105,3,16,564,548
12,105,4,20,498,478
12,105,5,19,547,528
12,105,6,16,517,501
12,106,0,12,484,472
12,106,1,7,433,426
12,106,2,64,569,505
12,106,3,4,436,432
12,106,4,16,488,472
12,106,5,9,483,474
12,106,6,8,461,453
12,107,0,11,421,410
12,107,1,17,447,430
12,107,2,18,485,467
12,107,3,10,446,436
12,107,4,20,462,442
12,107,5,15,457,442
12,107,6,11,404,393
12,108,0,13,440,427
12,108,1,7,434,427
12,108,2,15,497,482
12,108,3,18,505,487
12,108,4,8,471,463
12,108,5,14,445,431
12,108,6,11,473,462
12,109,0,10,402,392
12,109,1,9,411,402
12,109,2,16,416,400
12,109,3,13,421,408
12,109,4,15,447,432
12,109,5,8,397,389
12,109,6,7,402,395
12,110,0,8,333,325
12,110,1,15,376,361
12,110,2,22,473,451
12,110,3,16,432,416
12,110,4,15,430,415
12,110,5,11,383,372
12,110,6,8,363,355
12,111,0,13,385,372
12,111,1,7,391,384
12,111,2,5,430,425
12,111,3,14,430,416
12,111,4,19,430,411
12,111,5,12,405,393
12,111,6,8,387,379
12,112,0,6,371,365
12,112,1,3,337,334
12,112,2,12,413,401
12,112,3,6,403,397
12,112,4,14,401,387
12,112,5,3,380,377
12,112,6,12,420,408
12,113,0,11,372,361
12,113,1,5,359,354
12,113,2,6,374,368
12,113,3,7,365,358
12,113,4,8,370,362
12,113,5,13,372,359
12,113,6,8,356,348
12,114,0,6,321,315
12,114,1,11,335,324
12,114,2,5,381,376
12,114,3,11,390,379
12,114,4,7,359,352
12,114,5,10,341,331
12,114,6,9,381,372
12,115,0,8,346,338
12,115,1,9,331,322
12,115,2,9,382,373
12,115,3,11,342,331
12,115,4,9,374,365
12,115,5,14,373,359
12,115,6,7,329,322
12,116,0,7,334,327
12,116,1,13,336,323
12,116,2,5,339,334
12,116,3,11,323,312
12,116,4,13,345,332
12,116,5,11,346,335
12,116,6,11,370,359
12,117,0,7,344,337
12,117,1,12,351,339
12,117,2,14,353,339
12,117,3,8,346,338
12,117,4,8,329,321
12,117,5,10,358,348
12,117,6,12,398,386
12,118,0,7,310,303
12,118,1,8,376,368
12,118,2,11,397,386
12,118,3,12,348,336
12,118,4,11,382,371
12,118,5,5,381,376
12,118,6,16,389,373
12,119,0,9,334,325
12,119,1,6,384,378
12,119,2,11,333,322
12,119,3,16,377,361
12,119,4,15,409,394
12,119,5,10,386,376
12,119,6,14,389,375
12,120,0,10,411,401
12,120,1,10,418,408
12,120,2,11,433,422
12,120,3,10,426,416
12,120,4,14,452,438
12,120,5,16,460,444
12,120,6,20,502,482
12,121,0,12,418,406
12,121,1,11,473,462
12,121,2,13,416,403
12,121,3,10,394,384
12,121,4,10,431,421
12,121,5,10,487,477
12,121,6,12,484,472
12,122,0,18,382,364
12,122,1,12,445,433
12,122,2,10,475,465
12,122,3,17,462,445
12,122,4,17,432,415
12,122,5,12,426,414
12,122,6,13,450,437
12,123,0,10,452,442
12,123,1,14,466,452
12,123,2,18,479,461
12,123,3,11,434,423
12,123,4,21,517,496
12,123,5,7,483,476
12,123,6,11,427,416
12,124,0,10,413,403
12,124,1,15,471,456
12,124,2,12,467,455
12,124,3,14,422,408
12,124,4,14,495,481
12,124,5,13,454,441
12,124,6,20,402,382
12,125,0,5,368,363
12,125,1,14,413,399
12,125,2,7,441,434
12,125,3,16,449,433
12,125,4,18,431,413
12,125,5,15,444,429
12,125,6,11,426,415
12,126,0,8,378,370
12,126,1,10,450,440
12,126,2,14,492,478
12,126,3,24,481,457
12,126,4,28,532,504
12,126,5,18,494,476
12,126,6,14,463,449
12,127,0,8,394,386
12,127,1,9,450,441
12,127,2,10,413,403
12,127,3,16,422,406
12,127,4,16,475,459
12,127,5,14,483,469
12,127,6,22,475,453
12,128,0,9,396,387
12,128,1,16,407,391
12,128,2,13,437,424
12,128,3,17,419,402
12,128,4,19,467,448
12,128,5,15,503,488
12,128,6,11,428,417
12,129,0,15,403,388
12,129,1,15,437,422
12,129,2,8,417,409
12,129,3,20,435,415
12,129,4,17,459,442
12,129,5,10,417,407
12,129,6,12,413,401
12,130,0,13,383,370
12,130,1,10,392,382
12,130,2,13,412,399
12,130,3,10,331,321
12,130,4,14,431,417
12,130,5,4,441,437
12,130,6,18,390,372
12,131,0,11,359,348
12,131,1,16,395,379
12,131,2,9,362,353
12,131,3,9,362,353
12,131,4,12,419,407
12,131,5,19,487,468
12,131,6,19,392,373
12,132,0,10,325,315
12,132,1,14,331,317
12,132,2,5,314,309
12,132,3,20,354,334
12,132,4,10,397,387
12,132,5,42,521,479
12,132,6,7,355,348
12,133,0,9,259,250
12,133,1,8,294,286
12,133,2,4,263,259
12,133,3,8,280,272
12,133,4,17,367,350
12,133,5,93,545,452
12,133,6,8,293,285
12,134,0,15,257,242
12,134,1,3,245,242
12,134,2,7,259,252
12,134,3,11,258,247
12,134,4,9,352,343
12,134,5,103,420,317
12,134,6,11,294,283
12,135,0,7,276,269
12,135,1,2,251,249
12,135,2,12,290,278
12,135,3,9,266,257
12,135,4,4,292,288
12,135,5,29,332,303
12,135,6,8,252,244
12,136,0,9,231,222
12,136,1,9,222,213
12,136,2,3,278,275
12,136,3,2,254,252
12,136,4,8,291,283
12,136,5,15,307,292
12,136,6,6,267,261
12,137,0,6,217,211
12,137,1,10,256,246
12,137,2,11,251,240
12,137,3,13,282,269
12,137,4,8,257,249
12,137,5,15,345,330
12,137,6,10,264,254
12,138,0,13,223,210
12,138,1,8,255,247
12,138,2,10,253,243
12,138,3,15,226,211
12,138,4,15,267,252
12,138,5,14,334,320
12,138,6,9,258,249
12,139,0,15,206,191
12,139,1,11,223,212
12,139,2,5,247,242
12,139,3,14,221,207
12,139,4,12,232,220
12,139,5,15,278,263
12,139,6,19,264,245
12,140,0,13,192,179
12,140,1,15,210,195
12,140,2,7,200,193
12,140,3,7,181,174
12,140,4,8,213,205
12,140,5,19,227,208
12,140,6,18,197,179
12,141,0,7,183,176
12,141,1,15,208,193
12,141,2,14,194,180
12,141,3,9,212,203
12,141,4,19,259,240
12,141,5,19,254,235
12,141,6,6,190,184
12,142,0,15,187,172
12,142,1,28,197,169
12,142,2,21,181,160
12,142,3,26,212,186
12,142,4,29,258,229
12,142,5,10,237,227
12,142,6,12,157,145
12,143,0,9,169,160
12,143,1,30,200,170
12,143,2,16,185,169
12,143,3,59,239,180
12,143,4,36,265,229
12,143,5,20,240,220
12,143,6,18,186,168
13,0,0,1,12,11
13,0,1,2,9,7
13,0,2,8,15,7
13,0,3,3,11,8
13,0,4,3,10,7
13,0,5,2,20,18
13,0,6,2,12,10
13,1,0,3,10,7
13,1,1,3,11,8
13,1,2,2,8,6
13,1,3,3,10,7
13,1,4,1,11,10
13,1,5,3,14,11
13,1,6,1,8,7
13,2,0,1,8,7
13,2,1,1,5,4
13,2,2,6,13,7
13,2,3,2,9,7
13,2,4,2,11,9
13,2,5,1,11,10
13,2,6,4,17,13
13,3,0,2,7,5
13,3,1,0,7,7
13,3,2,0,7,7
13,3,3,1,7,6
13,3,4,0,15,15
13,3,5,0,7,7
13,3,6,3,14,11
13,4,0,1,12,11
13,4,1,1,12,11
13,4,2,2,8,6
13,4,3,3,4,1
13,4,4,0,5,5
13,4,5,1,9,8
13,4,6,5,16,11
13,5,0,7,12,5
13,5,1,2,13,11
13,5,2,1,4,3
13,5,3,1,10,9
13,5,4,5,14,9
13,5,5,3,11,8
13,5,6,1,10,9
13,6,0,2,7,5
13,6,1,2,5,3
13,6,2,2,3,1
13,6,3,2,8,6
13,6,4,0,7,7
13,6,5,0,2,2
13,6,6,5,15,10
13,7,0,1,3,2
13,7,1,0,1,1
13,7,2,0,3,3
13,7,3,0,1,1
13,7,4,2,14,12
13,7,5,2,9,7
13,7,6,1,6,5
13,8,0,0,3,3
13,8,1,0,2,2
13,8,2,1,3,2
13,8,3,1,4,3
13,8,4,2,7,5
13,8,5,0,4,4
13,8,6,2,6,4
13,9,0,1,3,2
13,9,1,1,3,2
13,9,2,1,4,3
13,9,3,1,6,5
13,9,4,2,8,6
13,9,5,1,4,3
13,9,6,0,6,6
13,10,0,1,5,4
13,10,1,0,1,1
13,10,2,0,3,3
13,10,3,2,3,1
13,10,4,3,8,5
13,10,5,0,3,3
13,10,6,0,4,4
13,11,0,1,1,0
13,11,1,1,4,3
13,11,2,0,2,2
13,11,3,0,4,4
13,11,4,1,4,3
13,11,5,3,4,1
13,11,6,0,1,1
13,12,0,2,4,2
13,12,1,2,2,0
13,12,2,0,1,1
13,12,3,1,3,2
13,12,5,1,2,1
13,12,6,1,4,3
13,13,0,2,5,3
13,13,1,1,1,0
13,13,2,1,3,2
13,13,4,0,2,2
13,13,5,0,5,5
13,13,6,5,7,2
13,14,0,1,3,2
13,14,1,0,2,2
13,14,2,1,2,1
13,14,4,2,4,2
13,14,5,0,4,4
13,14,6,1,2,1
13,15,0,0,1,1
13,15,1,0,2,2
13,15,2,1,3,2
13,15,3,0,1,1
13,15,4,2,2,0
13,15,5,0,1,1
13,15,6,1,4,3
13,16,0,1,3,2
13,16,1,4,5,1
13,16,2,0,2,2
13,16,3,0,2,2
13,16,5,0,1,1
13,16,6,1,2,1
13,17,0,0,1,1
13,17,1,1,3,2
13,17,2,0,3,3
13,17,3,1,2,1
13,17,4,0,3,3
13,17,5,2,3,1
13,17,6,0,1,1
13,18,0,2,5,3
13,18,1,0,2,2
13,18,2,0,3,3
13,18,3,2,3,1
13,18,4,1,2,1
13,18,6,1,1,0
13,19,0,1,1,0
13,19,2,0,1,1
13,19,4,1,1,0
13,19,6,1,2,1
13,20,0,3,4,1
13,20,2,3,5,2
13,20,4,0,1,1
13,20,5,1,2,1
13,21,0,1,1,0
13,21,1,2,2,0
13,21,2,1,3,2
13,21,3,1,2,1
13,21,4,2,7,5
13,21,6,0,1,1
13,22,0,4,5,1
13,22,3,1,1,0
13,22,4,0,1,1
13,22,6,2,3,1
13,23,0,0,1,1
13,23,1,1,1,0
13,23,4,1,1,0
13,23,6,1,2,1
13,24,2,0,1,1
13,24,3,1,1,0
13,24,5,0,1,1
13,24,6,0,2,2
13,25,0,0,2,2
13,25,2,2,3,1
13,25,4,1,1,0
13,25,5,1,2,1
13,26,0,0,2,2
13,26,1,0,1,1
13,26,2,1,2,1
13,27,1,3,4,1
13,27,2,0,1,1
13,27,3,0,1,1
13,27,4,1,2,1
13,28,0,1,1,0
13,28,1,3,7,4
13,28,4,2,3,1
13,29,1,1,2,1
13,29,2,1,2,1
13,29,4,1,1,0
13,29,5,0,1,1
13,30,2,1,1,0
13,30,4,1,3,2
13,30,5,0,1,1
13,30,6,1,1,0
13,31,0,8,9,1
13,31,1,1,4,3
13,31,2,1,1,0
13,31,4,1,2,1
13,31,6,0,1,1
13,32,0,1,2,1
13,32,1,4,4,0
13,32,2,3,5,2
13,32,3,2,3,1
13,32,4,0,1,1
13,32,5,1,2,1
13,32,6,1,2,1
13,33,0,2,4,2
13,33,1,0,2,2
13,33,2,0,1,1
13,33,4,2,3,1
13,33,5,4,4,0
13,33,6,2,2,0
13,34,0,1,2,1
13,34,1,2,4,2
13,34,2,0,1,1
13,34,3,1,4,3
13,34,4,2,2,0
13,34,5,1,1,0
13,34,6,1,1,0
13,35,0,1,2,1
13,35,1,3,5,2
13,35,2,3,4,1
13,35,3,0,1,1
13,35,4,2,3,1
13,35,5,4,8,4
13,36,0,2,5,3
13,36,1,1,2,1
13,36,2,2,4,2
13,36,3,5,6,1
13,36,4,2,3,1
13,36,5,1,1,0
13,36,6,5,5,0
13,37,0,3,9,6
13,37,1,1,4,3
13,37,2,5,10,5
13,37,3,3,5,2
13,37,4,0,1,1
13,37,5,2,3,1
13,37,6,4,5,1
13,38,0,2,4,2
13,38,1,0,2,2
13,38,2,4,6,2
13,38,3,3,8,5
13,38,4,10,13,3
13,38,5,1,2,1
13,38,6,2,3,1
13,39,0,1,21,20
13,39,1,1,12,11
13,39,2,9,20,11
13,39,3,1,14,13
13,39,4,2,11,9
13,39,5,1,8,7
13,39,6,2,6,4
13,40,0,0,18,18
13,40,1,0,19,19
13,40,2,0,18,18
13,40,3,2,20,18
13,40,4,2,17,15
13,40,5,2,10,8
13,40,6,0,7,7
13,41,0,3,26,23
13,41,1,1,18,17
13,41,2,0,17,17
13,41,3,2,19,17
13,41,4,0,23,23
13,41,5,2,11,9
13,41,6,4,10,6
13,42,0,3,49,46
13,42,1,1,45,44
13,42,2,1,44,43
13,42,3,2,48,46
13,42,4,0,27,27
13,42,5,2,18,16
13,42,6,4,18,14
13,43,0,0,45,45
13,43,1,0,57,57
13,43,2,1,51,50
13,43,3,2,51,49
13,43,4,2,47,45
13,43,5,0,23,23
13,43,6,6,24,18
13,44,0,0,39,39
13,44,1,1,39,38
13,44,2,4,58,54
13,44,3,1,55,54
13,44,4,1,29,28
13,44,5,0,17,17
13,44,6,5,23,18
13,45,0,2,47,45
13,45,1,1,41,40
13,45,2,1,39,38
13,45,3,8,59,51
13,45,4,1,38,37
13,45,5,2,28,26
13,45,6,0,28,28
13,46,0,4,48,44
13,46,1,0,30,30
13,46,2,0,45,45
13,46,3,7,59,52
13,46,4,1,32,31
13,46,5,1,31,30
13,46,6,3,24,21
13,47,0,1,47,46
13,47,1,3,40,37
13,47,2,0,50,50
13,47,3,2,47,45
13,47,4,5,43,38
13,47,5,1,36,35
13,47,6,3,34,31
13,48,0,2,57,55
13,48,1,0,52,52
13,48,2,3,58,55
13,48,3,14,76,62
13,48,4,2,44,42
13,48,5,0,42,42
13,48,6,1,39,38
13,49,0,3,65,62
13,49,1,1,59,58
13,49,2,0,53,53
13,49,3,4,68,64
13,49,4,1,55,54
13,49,5,0,41,41
13,49,6,1,44,43
13,50,0,1,58,57
13,50,1,0,58,58
13,50,2,6,61,55
13,50,3,3,71,68
13,50,4,5,55,50
13,50,5,3,44,41
13,50,6,3,52,49
13,51,0,1,53,52
13,51,1,3,56,53
13,51,2,2,68,66
13,51,3,5,64,59
13,51,4,1,55,54
13,51,5,2,41,39
13,51,6,2,58,56
13,52,0,12,79,67
13,52,1,2,51,49
13,52,2,3,75,72
13,52,3,13,73,60
13,52,4,1,62,61
13,52,5,1,46,45
13,52,6,3,56,53
13,53,0,9,63,54
13,53,1,5,54,49
13,53,2,2,52,50
13,53,3,12,70,58
13,53,4,0,37,37
13,53,5,1,40,39
13,53,6,1,35,34
13,54,0,1,42,41
13,54,1,2,46,44
13,54,2,1,47,46
13,54,3,1,55,54
13,54,4,3,44,41
13,54,5,5,36,31
13,54,6,0,35,35
13,55,0,1,32,31
13,55,1,4,39,35
13,55,2,0,35,35
13,55,3,9,51,42
13,55,4,1,36,35
13,55,5,0,39,39
13,55,6,4,40,36
13,56,0,6,37,31
13,56,1,0,37,37
13,56,2,2,40,38
13,56,3,6,42,36
13,56,4,1,45,44
13,56,5,4,46,42
13,56,6,0,29,29
13,57,0,7,37,30
13,57,1,2,31,29
13,57,2,6,64,58
13,57,3,5,42,37
13,57,4,1,42,41
13,57,5,6,43,37
13,57,6,0,41,41
13,58,0,1,35,34
13,58,1,8,28,20
13,58,2,14,43,29
13,58,3,1,35,34
13,58,4,2,29,27
13,58,5,7,47,40
13,58,6,2,45,43
13,59,0,3,32,29
13,59,1,2,28,26
13,59,2,10,41,31
13,59,3,6,39,33
13,59,4,2,32,30
13,59,5,6,34,28
13,59,6,2,38,36
13,60,0,0,23,23
13,60,1,4,43,39
13,60,2,1,24,23
13,60,3,2,38,36
13,60,4,1,35,34
13,60,5,4,52,48
13,60,6,0,39,39
13,61,0,4,34,30
13,61,1,5,32,27
13,61,2,4,37,33
13,61,3,10,43,33
13,61,4,6,40,34
13,61,5,3,36,33
13,61,6,1,39,38
13,62,0,3,30,27
13,62,1,1,33,32
13,62,2,3,34,31
13,62,3,2,28,26
13,62,4,8,39,31
13,62,5,3,26,23
13,62,6,11,52,41
13,63,0,2,29,27
13,63,1,5,37,32
13,63,2,1,28,27
13,63,3,7,38,31
13,63,4,4,43,39
13,63,5,6,43,37
13,63,6,3,48,45
13,64,0,15,41,26
13,64,1,3,30,27
13,64,2,1,21,20
13,64,3,5,36,31
13,64,4,11,45,34
13,64,5,5,28,23
13,64,6,14,64,50
13,65,0,8,49,41
13,65,1,2,34,32
13,65,2,2,27,25
13,65,3,3,45,42
13,65,4,9,30,21
13,65,5,5,37,32
13,65,6,7,50,43
13,66,0,3,46,43
13,66,1,4,41,37
13,66,2,4,31,27
13,66,3,5,45,40
13,66,4,2,29,27
13,66,5,7,45,38
13,66,6,22,52,30
13,67,0,3,38,35
13,67,1,3,22,19
13,67,2,3,25,22
13,67,3,2,33,31
13,67,4,6,34,28
13,67,5,3,38,35
13,67,6,21,70,49
13,68,0,5,36,31
13,68,1,6,40,34
13,68,2,4,38,34
13,68,3,5,33,28
13,68,4,5,31,26
13,68,5,5,45,40
13,68,6,14,48,34
13,69,0,4,37,33
13,69,1,5,29,24
13,69,2,6,31,25
13,69,3,7,40,33
13,69,4,9,49,40
13,69,5,0,37,37
13,69,6,8,41,33
13,70,0,6,36,30
13,70,1,10,38,28
13,70,2,5,34,29
13,70,3,7,49,42
13,70,4,7,35,28
13,70,5,6,37,31
13,70,6,4,31,27
13,71,0,14,45,31
13,71,1,6,32,26
13,71,2,1,31,30
13,71,3,1,26,25
13,71,4,23,51,28
13,71,5,5,37,32
13,71,6,3,49,46
13,72,0,4,36,32
13,72,1,2,38,36
13,72,2,2,35,33
13,72,3,2,31,29
13,72,4,11,45,34
13,72,5,4,37,33
13,72,6,2,51,49
13,73,0,1,29,28
13,73,1,1,23,22
13,73,2,2,40,38
13,73,3,3,37,34
13,73,4,6,42,36
13,73,5,8,47,39
13,73,6,0,42,42
13,74,0,0,31,31
13,74,1,2,36,34
13,74,2,4,38,34
13,74,3,0,27,27
13,74,4,10,45,35
13,74,5,1,41,40
13,74,6,4,45,41
13,75,0,5,44,39
13,75,1,6,41,35
13,75,2,5,36,31
13,75,3,2,25,23
13,75,4,4,39,35
13,75,5,2,56,54
13,75,6,4,51,47
13,76,0,1,40,39
13,76,1,1,24,23
13,76,2,3,38,35
13,76,3,2,42,40
13,76,4,3,44,41
13,76,5,1,50,49
13,76,6,1,44,43
13,77,0,0,26,26
13,77,1,1,27,26
13,77,2,1,34,33
13,77,3,0,37,37
13,77,4,4,39,35
13,77,5,6,52,46
13,77,6,1,38,37
13,78,0,0,33,33
13,78,1,3,32,29
13,78,2,0,34,34
13,78,3,0,29,29
13,78,4,7,48,41
13,78,5,6,43,37
13,78,6,1,39,38
13,79,0,1,38,37
13,79,1,3,46,43
13,79,2,9,56,47
13,79,3,3,32,29
13,79,4,10,54,44
13,79,5,3,39,36
13,79,6,2,45,43
13,80,0,2,40,38
13,80,1,8,46,38
13,80,2,2,38,36
13,80,3,3,48,45
13,80,4,13,42,29
13,80,5,4,47,43
13,80,6,3,41,38
13,81,0,2,41,39
13,81,1,2,41,39
13,81,2,2,27,25
13,81,3,2,35,33
13,81,4,5,37,32
13,81,5,1,43,42
13,81,6,3,42,39
13,82,0,0,33,33
13,82,1,1,34,33
13,82,2,7,49,42
13,82,3,1,36,35
13,82,4,6,39,33
13,82,5,1,33,32
13,82,6,1,41,40
13,83,0,4,35,31
13,83,1,7,41,34
13,83,2,6,38,32
13,83,3,2,32,30
13,83,4,4,38,34
13,83,5,0,39,39
13,83,6,2,38,36
13,84,0,4,38,34
13,84,1,5,36,31
13,84,2,4,21,17
13,84,3,1,35,34
13,84,4,0,35,35
13,84,5,1,39,38
13,84,6,1,41,40
13,85,0,1,38,37
13,85,1,4,37,33
13,85,2,4,46,42
13,85,3,3,43,40
13,85,4,4,34,30
13,85,5,0,39,39
13,85,6,2,39,37
13,86,0,1,23,22
13,86,1,1,27,26
13,86,2,1,31,30
13,86,3,5,44,39
13,86,4,9,47,38
13,86,5,5,37,32
13,86,6,4,46,42
13,87,0,1,36,35
13,87,1,1,19,18
13,87,2,3,35,32
13,87,3,0,24,24
13,87,4,3,31,28
13,87,5,0,36,36
13,87,6,1,34,33
13,88,0,0,31,31
13,88,1,2,27,25
13,88,2,1,35,34
13,88,3,4,40,36
13,88,4,1,27,26
13,88,5,2,34,32
13,88,6,5,43,38
13,89,0,2,40,38
13,89,1,1,21,20
13,89,2,4,39,35
13,89,3,3,37,34
13,89,4,5,31,26
13,89,5,3,34,31
13,89,6,2,53,51
13,90,0,5,32,27
13,90,1,0,28,28
13,90,2,3,41,38
13,90,3,4,41,37
13,90,4,1,37,36
13,90,5,1,34,33
13,90,6,2,38,36
13,91,0,2,30,28
13,91,1,0,30,30
13,91,2,2,41,39
13,91,3,3,36,33
13,91,4,8,48,40
13,91,5,3,43,40
13,91,6,0,36,36
13,92,0,2,26,24
13,92,1,5,26,21
13,92,2,7,41,34
13,92,3,1,33,32
13,92,4,0,28,28
13,92,5,1,33,32
13,92,6,1,37,36
13,93,0,0,31,31
13,93,1,3,35,32
13,93,2,1,39,38
13,93,3,5,41,36
13,93,4,1,31,30
13,93,5,1,36,35
13,93,6,1,49,48
13,94,0,0,32,32
13,94,1,1,30,29
13,94,2,1,27,26
13,94,3,1,27,26
13,94,4,1,28,27
13,94,5,1,30,29
13,94,6,1,43,42
13,95,0,3,33,30
13,95,1,0,22,22
13,95,2,1,42,41
13,95,3,6,38,32
13,95,4,1,44,43
13,95,5,3,40,37
13,95,6,3,34,31
13,96,0,1,34,33
13,96,1,2,28,26
13,96,2,2,47,45
13,96,3,2,37,35
13,96,4,0,52,52
13,96,5,2,44,42
13,96,6,5,58,53
13,97,0,1,40,39
13,97,1,0,38,38
13,97,2,3,43,40
13,97,3,2,34,32
13,97,4,2,43,41
13,97,5,2,40,38
13,97,6,1,47,46
13,98,0,1,39,38
13,98,1,1,28,27
13,98,2,1,35,34
13,98,3,3,41,38
13,98,4,1,36,35
13,98,5,1,47,46
13,98,6,5,49,44
13,99,0,1,37,36
13,99,1,2,40,38
13,99,2,0,30,30
13,99,3,2,44,42
13,99,4,4,42,38
13,99,5,3,53,50
13,99,6,4,55,51
13,100,0,1,38,37
13,100,1,2,45,43
13,100,2,3,40,37
13,100,3,1,54,53
13,100,4,5,56,51
13,100,5,0,49,49
13,100,6,2,48,46
13,101,0,4,46,42
13,101,1,2,53,51
13,101,2,1,48,47
13,101,3,5,59,54
13,101,4,1,43,42
13,101,5,1,50,49
13,101,6,0,46,46
13,102,0,1,68,67
13,102,1,1,42,41
13,102,2,3,56,53
13,102,3,5,79,74
13,102,4,0,52,52
13,102,5,2,56,54
13,102,6,0,60,60
13,103,0,2,50,48
13,103,1,2,59,57
13,103,2,5,62,57
13,103,3,1,64,63
13,103,4,5,67,62
13,103,5,1,48,47
13,103,6,2,51,49
13,104,0,1,46,45
13,104,1,2,42,40
13,104,2,2,54,52
13,104,3,3,53,50
13,104,4,2,59,57
13,104,5,4,72,68
13,104,6,2,52,50
13,105,0,1,52,51
13,105,1,2,67,65
13,105,2,8,67,59
13,105,3,1,65,64
13,105,4,0,60,60
13,105,5,5,48,43
13,105,6,0,57,57
13,106,0,1,58,57
13,106,1,2,48,46
13,106,2,3,53,50
13,106,3,4,40,36
13,106,4,0,38,38
13,106,5,1,43,42
13,106,6,2,41,39
13,107,0,0,33,33
13,107,1,2,50,48
13,107,2,3,61,58
13,107,3,2,50,48
13,107,4,2,50,48
13,107,5,4,55,51
13,107,6,0,29,29
13,108,0,2,48,46
13,108,1,0,42,42
13,108,2,1,44,43
13,108,3,1,47,46
13,108,4,1,44,43
13,108,5,3,47,44
13,108,6,0,34,34
13,109,0,4,42,38
13,109,1,2,37,35
13,109,2,1,40,39
13,109,3,4,56,52
13,109,4,1,31,30
13,109,5,1,36,35
13,109,6,2,36,34
13,110,0,5,36,31
13,110,1,3,51,48
13,110,2,3,42,39
13,110,3,2,51,49
13,110,4,3,50,47
13,110,5,3,46,43
13,110,6,2,46,44
13,111,0,6,39,33
13,111,1,2,51,49
13,111,2,3,48,45
13,111,3,0,34,34
13,111,4,2,44,42
13,111,5,0,37,37
13,111,6,2,33,31
13,112,0,0,32,32
13,112,1,3,43,40
13,112,2,3,51,48
13,112,3,1,31,30
13,112,4,2,40,38
13,112,5,0,29,29
13,112,6,2,37,35
13,113,0,0,38,38
13,113,1,0,51,51
13,113,2,1,47,46
13,113,3,1,43,42
13,113,4,3,35,32
13,113,5,2,35,33
13,113,6,9,49,40
13,114,0,1,38,37
13,114,1,3,45,42
13,114,2,2,45,43
13,114,3,2,39,37
13,114,4,0,43,43
13,114,5,4,34,30
13,114,6,0,36,36
13,115,0,3,28,25
13,115,1,1,28,27
13,115,2,2,33,31
13,115,3,2,46,44
13,115,4,1,38,37
13,115,5,1,44,43
13,115,6,4,44,40
13,116,0,1,36,35
13,116,1,1,34,33
13,116,2,0,42,42
13,116,3,4,42,38
13,116,4,1,38,37
13,116,5,0,30,30
13,116,6,1,57,56
13,117,0,2,46,44
13,117,1,2,26,24
13,117,2,1,44,43
13,117,3,1,34,33
13,117,4,1,46,45
13,117,5,3,30,27
13,117,6,2,33,31
13,118,0,3,28,25
13,118,1,1,26,25
13,118,2,3,33,30
13,118,3,3,36,33
13,118,4,2,36,34
13,118,5,2,33,31
13,118,6,1,50,49
13,119,0,4,39,35
13,119,1,2,40,38
13,119,2,1,35,34
13,119,3,3,51,48
13,119,4,4,43,39
13,119,5,0,39,39
13,119,6,4,36,32
13,120,0,0,27,27
13,120,1,1,38,37
13,120,2,1,34,33
13,120,3,2,40,38
13,120,4,1,51,50
13,120,5,3,32,29
13,120,6,1,44,43
13,121,0,0,33,33
13,121,1,0,41,41
13,121,2,0,38,38
13,121,3,2,36,34
13,121,4,1,44,43
13,121,5,8,48,40
13,121,6,1,41,40
13,122,0,2,31,29
13,122,1,2,38,36
13,122,2,1,46,45
13,122,3,1,36,35
13,122,4,2,41,39
13,122,5,3,48,45
13,122,6,5,38,33
13,123,0,2,37,35
13,123,1,1,32,31
13,123,2,1,40,39
13,123,3,1,30,29
13,123,4,0,40,40
13,123,5,1,41,40
13,123,6,3,43,40
13,124,0,1,25,24
13,124,1,1,30,29
13,124,2,3,40,37
13,124,3,1,35,34
13,124,4,1,45,44
13,124,5,0,22,22
13,124,6,1,36,35
13,125,0,1,35,34
13,125,1,5,42,37
13,125,2,2,42,40
13,125,3,2,37,35
13,125,4,5,51,46
13,125,5,3,30,27
13,125,6,1,32,31
13,126,0,0,37,37
13,126,1,3,36,33
13,126,2,2,61,59
13,126,3,1,39,38
13,126,4,2,45,43
13,126,5,3,30,27
13,126,6,3,39,36
13,127,0,1,30,29
13,127,1,1,27,26
13,127,2,1,44,43
13,127,3,0,34,34
13,127,4,1,34,33
13,127,5,2,28,26
13,127,6,2,42,40
13,128,0,0,27,27
13,128,1,2,40,38
13,128,2,2,40,38
13,128,3,1,39,38
13,128,4,3,45,42
13,128,5,1,37,36
13,128,6,1,24,23
13,129,0,1,30,29
13,129,1,2,45,43
13,129,2,4,45,41
13,129,3,1,35,34
13,129,4,1,38,37
13,129,5,1,31,30
13,129,6,2,28,26
13,130,0,2,28,26
13,130,1,0,33,33
13,130,2,2,32,30
13,130,3,1,23,22
13,130,4,0,23,23
13,130,5,0,35,35
13,130,6,2,34,32
13,131,0,0,29,29
13,131,1,2,23,21
13,131,2,0,27,27
13,131,3,7,31,24
13,131,4,0,18,18
13,131,5,5,43,38
13,131,6,4,32,28
13,132,0,0,24,24
13,132,1,2,28,26
13,132,2,1,34,33
13,132,3,1,21,20
13,132,4,5,37,32
13,132,5,3,38,35
13,132,6,1,29,28
13,133,0,2,21,19
13,133,1,4,23,19
13,133,2,3,36,33
13,133,3,0,16,16
13,133,4,1,35,34
13,133,5,1,31,30
13,133,6,0,24,24
13,134,0,4,22,18
13,134,1,0,15,15
13,134,2,3,30,27
13,134,3,2,34,32
13,134,4,6,32,26
13,134,5,0,38,38
13,134,6,0,22,22
13,135,0,3,14,11
13,135,1,0,17,17
13,135,2,1,24,23
13,135,3,0,17,17
13,135,4,1,23,22
13,135,5,2,31,29
13,135,6,0,25,25
13,136,0,0,14,14
13,136,1,3,21,18
13,136,2,0,17,17
13,136,3,3,24,21
13,136,4,1,25,24
13,136,5,0,26,26
13,136,6,1,26,25
13,137,0,0,18,18
13,137,1,1,20,19
13,137,2,0,20,20
13,137,3,2,17,15
13,137,4,1,21,20
13,137,5,3,24,21
13,137,6,1,21,20
13,138,0,0,8,8
13,138,1,1,15,14
13,138,2,1,18,17
13,138,3,1,19,18
13,138,4,3,26,23
13,138,5,2,13,11
13,138,6,2,17,15
13,139,0,0,19,19
13,139,1,0,11,11
13,139,2,1,19,18
13,139,3,2,15,13
13,139,4,0,12,12
13,139,5,0,11,11
13,139,6,0,18,18
13,140,0,2,12,10
13,140,1,1,13,12
13,140,2,1,12,11
13,140,3,2,12,10
13,140,4,0,11,11
13,140,5,1,15,14
13,140,6,4,18,14
13,141,0,3,18,15
13,141,1,0,3,3
13,141,2,3,12,9
13,141,3,0,10,10
13,141,4,2,29,27
13,141,5,1,20,19
13,141,6,3,30,27
13,142,0,2,12,10
13,142,1,2,18,16
13,142,2,3,13,10
13,142,3,3,22,19
13,142,4,7,28,21
13,142,5,4,20,16
13,142,6,0,3,3
13,143,0,1,9,8
13,143,1,3,10,7
13,143,2,1,16,15
13,143,3,1,12,11
13,143,4,7,24,17
13,143,5,5,17,12
13,143,6,2,8,6
14,0,0,4,61,57
14,0,1,11,66,55
14,0,2,8,46,38
14,0,3,9,56,47
14,0,4,12,122,110
14,0,5,6,69,63
14,0,6,9,87,78
14,1,0,21,68,47
14,1,1,12,52,40
14,1,2,20,72,52
14,1,3,17,64,47
14,1,4,17,106,89
14,1,5,6,72,66
14,1,6,9,77,68
14,2,0,10,58,48
14,2,1,6,46,40
14,2,2,12,53,41
14,2,3,11,52,41
14,2,4,67,170,103
14,2,5,6,52,46
14,2,6,4,53,49
14,3,0,12,55,43
14,3,1,8,39,31
14,3,2,18,60,42
14,3,3,7,51,44
14,3,4,78,168,90
14,3,5,3,46,43
14,3,6,6,55,49
14,4,0,13,39,26
14,4,1,14,52,38
14,4,2,7,52,45
14,4,3,5,47,42
14,4,4,81,171,90
14,4,5,5,51,46
14,4,6,3,53,50
14,5,0,4,38,34
14,5,1,6,27,21
14,5,2,20,60,40
14,5,3,2,30,28
14,5,4,93,168,75
14,5,5,4,57,53
14,5,6,1,48,47
14,6,0,4,33,29
14,6,1,7,36,29
14,6,2,3,37,34
14,6,3,4,41,37
14,6,4,70,161,91
14,6,5,1,30,29
14,6,6,4,35,31
14,7,0,11,45,34
14,7,1,6,26,20
14,7,2,4,24,20
14,7,3,6,33,27
14,7,4,35,94,59
14,7,5,4,44,40
14,7,6,2,38,36
14,8,0,1,27,26
14,8,1,3,19,16
14,8,2,6,39,33
14,8,3,6,26,20
14,8,4,12,96,84
14,8,5,5,46,41
14,8,6,3,31,28
14,9,0,9,33,24
14,9,1,6,26,20
14,9,2,0,35,35
14,9,3,4,32,28
14,9,4,3,86,83
14,9,5,6,34,28
14,9,6,6,37,31
14,10,0,4,22,18
14,10,1,2,23,21
14,10,2,0,22,22
14,10,3,2,22,20
14,10,4,17,71,54
14,10,5,5,33,28
14,10,6,9,36,27
14,11,0,2,12,10
14,11,1,10,34,24
14,11,2,3,25,22
14,11,3,2,25,23
14,11,4,3,50,47
14,11,5,3,29,26
14,11,6,4,33,29
14,12,0,0,18,18
14,12,1,12,26,14
14,12,2,7,40,33
14,12,3,3,27,24
14,12,4,8,51,43
14,12,5,6,26,20
14,12,6,6,29,23
14,13,0,4,17,13
14,13,1,2,25,23
14,13,2,1,11,10
14,13,3,5,20,15
14,13,4,7,40,33
14,13,5,6,32,26
14,13,6,12,43,31
14,14,0,6,23,17
14,14,1,5,21,16
14,14,2,3,16,13
14,14,3,2,21,19
14,14,4,4,53,49
14,14,5,9,34,25
14,14,6,2,25,23
14,15,0,7,17,10
14,15,1,1,23,22
14,15,2,4,13,9
14,15,3,4,15,11
14,15,4,24,53,29
14,15,5,8,21,13
14,15,6,0,19,19
14,16,0,10,19,9
14,16,1,3,25,22
14,16,2,1,15,14
14,16,3,5,18,13
14,16,4,15,45,30
14,16,5,3,23,20
14,16,6,1,20,19
14,17,0,6,18,12
14,17,1,2,5,3
14,17,2,2,5,3
14,17,3,3,10,7
14,17,4,4,22,18
14,17,5,4,24,20
14,17,6,2,17,15
14,18,0,6,15,9
14,18,1,1,7,6
14,18,2,5,20,15
14,18,3,7,24,17
14,18,4,2,18,16
14,18,5,3,23,20
14,18,6,2,17,15
14,19,0,0,4,4
14,19,1,1,10,9
14,19,2,4,9,5
14,19,3,5,14,9
14,19,4,5,17,12
14,19,5,2,20,18
14,19,6,4,18,14
14,20,0,1,7,6
14,20,1,4,14,10
14,20,2,2,11,9
14,20,3,1,7,6
14,20,4,5,19,14
14,20,5,1,14,13
14,20,6,12,23,11
14,21,0,3,8,5
14,21,1,1,11,10
14,21,2,2,7,5
14,21,3,2,13,11
14,21,4,4,17,13
14,21,5,11,30,19
14,21,6,2,20,18
14,22,0,2,7,5
14,22,1,1,10,9
14,22,2,1,10,9
14,22,3,3,13,10
14,22,4,3,21,18
14,22,5,2,9,7
14,22,6,0,10,10
14,23,0,2,5,3
14,23,1,1,5,4
14,23,2,0,4,4
14,23,3,1,7,6
14,23,4,5,15,10
14,23,5,3,12,9
14,23,6,3,10,7
14,24,0,3,12,9
14,24,1,5,9,4
14,24,2,2,12,10
14,24,3,3,12,9
14,24,4,5,14,9
14,24,5,1,17,16
14,24,6,1,10,9
14,25,0,2,7,5
14,25,1,3,15,12
14,25,2,4,12,8
14,25,3,0,1,1
14,25,4,4,9,5
14,25,5,4,16,12
14,25,6,3,13,10
14,26,0,3,7,4
14,26,1,11,15,4
14,26,2,1,18,17
14,26,3,6,15,9
14,26,4,9,25,16
14,26,5,2,12,10
14,26,6,6,19,13
14,27,0,2,10,8
14,27,1,0,7,7
14,27,2,1,7,6
14,27,3,9,20,11
14,27,4,9,18,9
14,27,5,3,10,7
14,27,6,5,22,17
14,28,0,10,22,12
14,28,1,12,25,13
14,28,2,2,8,6
14,28,3,3,8,5
14,28,4,23,34,11
14,28,5,5,12,7
14,28,6,4,17,13
14,29,0,2,13,11
14,29,1,4,15,11
14,29,2,1,6,5
14,29,3,1,12,11
14,29,4,18,23,5
14,29,5,5,10,5
14,29,6,5,17,12
14,30,0,6,13,7
14,30,1,5,14,9
14,30,2,6,15,9
14,30,3,3,6,3
14,30,4,15,27,12
14,30,5,0,6,6
14,30,6,1,7,6
14,31,0,6,18,12
14,31,1,2,9,7
14,31,2,6,18,12
14,31,3,4,13,9
14,31,4,10,18,8
14,31,5,1,13,12
14,31,6,5,15,10
14,32,0,8,14,6
14,32,1,11,17,6
14,32,2,9,19,10
14,32,3,9,18,9
14,32,4,11,28,17
14,32,5,4,14,10
14,32,6,5,16,11
14,33,0,12,23,11
14,33,1,6,13,7
14,33,2,1,7,6
14,33,3,1,15,14
14,33,4,15,28,13
14,33,5,4,19,15
14,33,6,1,9,8
14,34,0,8,21,13
14,34,1,9,20,11
14,34,2,7,15,8
14,34,3,5,14,9
14,34,4,20,31,11
14,34,5,7,21,14
14,34,6,4,16,12
14,35,0,11,21,10
14,35,1,20,33,13
14,35,2,11,26,15
14,35,3,6,16,10
14,35,4,44,54,10
14,35,5,6,17,11
14,35,6,12,27,15
14,36,0,27,42,15
14,36,1,21,37,16
14,36,2,8,24,16
14,36,3,14,26,12
14,36,4,47,61,14
14,36,5,9,22,13
14,36,6,7,19,12
14,37,0,29,50,21
14,37,1,19,28,9
14,37,2,23,34,11
14,37,3,12,21,9
14,37,4,56,71,15
14,37,5,12,26,14
14,37,6,19,33,14
14,38,0,34,57,23
14,38,1,21,40,19
14,38,2,26,49,23
14,38,3,17,38,21
14,38,4,59,75,16
14,38,5,17,32,15
14,38,6,16,29,13
14,39,0,4,93,89
14,39,1,2,84,82
14,39,2,4,77,73
14,39,3,9,88,79
14,39,4,20,84,64
14,39,5,9,43,34
14,39,6,15,49,34
14,40,0,7,121,114
14,40,1,2,109,107
14,40,2,13,124,111
14,40,3,4,98,94
14,40,4,51,125,74
14,40,5,9,55,46
14,40,6,10,42,32
14,41,0,34,194,160
14,41,1,1,150,149
14,41,2,5,132,127
14,41,3,4,134,130
14,41,4,44,146,102
14,41,5,23,88,65
14,41,6,17,57,40
14,42,0,81,339,258
14,42,1,11,209,198
14,42,2,11,249,238
14,42,3,10,231,221
14,42,4,71,244,173
14,42,5,21,115,94
14,42,6,34,104,70
14,43,0,198,462,264
14,43,1,28,329,301
14,43,2,43,349,306
14,43,3,34,324,290
14,43,4,75,292,217
14,43,5,21,127,106
14,43,6,17,85,68
14,44,0,368,674,306
14,44,1,52,410,358
14,44,2,117,516,399
14,44,3,63,402,339
14,44,4,98,366,268
14,44,5,32,179,147
14,44,6,26,132,106
14,45,0,375,651,276
14,45,1,143,491,348
14,45,2,193,547,354
14,45,3,146,501,355
14,45,4,112,386,274
14,45,5,20,207,187
14,45,6,47,167,120
14,46,0,485,786,301
14,46,1,258,624,366
14,46,2,350,742,392
14,46,3,132,498,366
14,46,4,140,442,302
14,46,5,33,206,173
14,46,6,41,166,125
14,47,0,590,899,309
14,47,1,373,770,397
14,47,2,531,914,383
14,47,3,238,636,398
14,47,4,242,571,329
14,47,5,32,242,210
14,47,6,33,197,164
14,48,0,718,1020,302
14,48,1,812,1160,348
14,48,2,694,1070,376
14,48,3,391,825,434
14,48,4,403,753,350
14,48,5,51,266,215
14,48,6,35,244,209
14,49,0,653,981,328
14,49,1,822,1228,406
14,49,2,540,965,425
14,49,3,309,734,425
14,49,4,386,712,326
14,49,5,58,295,237
14,49,6,35,241,206
14,50,0,652,1071,419
14,50,1,610,1142,532
14,50,2,398,903,505
14,50,3,233,830,597
14,50,4,269,685,416
14,50,5,39,288,249
14,50,6,38,250,212
14,51,0,706,1144,438
14,51,1,564,1041,477
14,51,2,487,993,506
14,51,3,194,761,567
14,51,4,236,684,448
14,51,5,40,321,281
14,51,6,26,291,265
14,52,0,518,1008,490
14,52,1,491,988,497
14,52,2,392,942,550
14,52,3,149,693,544
14,52,4,230,651,421
14,52,5,51,341,290
14,52,6,35,261,226
14,53,0,303,833,530
14,53,1,184,810,626
14,53,2,170,723,553
14,53,3,45,569,524
14,53,4,73,520,447
14,53,5,42,311,269
14,53,6,12,246,234
14,54,0,63,667,604
14,54,1,43,588,545
14,54,2,35,574,539
14,54,3,24,575,551
14,54,4,40,501,461
14,54,5,21,269,248
14,54,6,12,258,246
14,55,0,35,499,464
14,55,1,19,472,453
14,55,2,24,498,474
14,55,3,21,486,465
14,55,4,33,435,402
14,55,5,14,305,291
14,55,6,14,226,212
14,56,0,22,408,386
14,56,1,10,407,397
14,56,2,18,422,404
14,56,3,19,410,391
14,56,4,19,375,356
14,56,5,26,330,304
14,56,6,7,232,225
14,57,0,8,297,289
14,57,1,13,379,366
14,57,2,13,365,352
14,57,3,14,389,375
14,57,4,43,357,314
14,57,5,33,354,321
14,57,6,13,264,251
14,58,0,9,298,289
14,58,1,13,326,313
14,58,2,6,334,328
14,58,3,9,347,338
14,58,4,41,300,259
14,58,5,24,332,308
14,58,6,12,255,243
14,59,0,13,280,267
14,59,1,8,267,259
14,59,2,16,336,320
14,59,3,12,286,274
14,59,4,53,306,253
14,59,5,41,349,308
14,59,6,19,271,252
14,60,0,9,252,243
14,60,1,15,276,261
14,60,2,11,255,244
14,60,3,3,276,273
14,60,4,59,296,237
14,60,5,23,323,300
14,60,6,15,272,257
14,61,0,2,241,239
14,61,1,6,238,232
14,61,2,10,223,213
14,61,3,12,266,254
14,61,4,76,290,214
14,61,5,16,307,291
14,61,6,11,252,241
14,62,0,5,241,236
14,62,1,7,223,216
14,62,2,10,251,241
14,62,3,7,239,232
14,62,4,63,309,246
14,62,5,18,301,283
14,62,6,16,269,253
14,63,0,5,221,216
14,63,1,1,197,196
14,63,2,12,233,221
14,63,3,7,244,237
14,63,4,50,280,230
14,63,5,12,276,264
14,63,6,12,252,240
14,64,0,6,209,203
14,64,1,3,213,210
14,64,2,8,212,204
14,64,3,10,228,218
14,64,4,63,267,204
14,64,5,31,305,274
14,64,6,24,299,275
14,65,0,3,210,207
14,65,1,5,206,201
14,65,2,7,209,202
14,65,3,5,228,223
14,65,4,62,292,230
14,65,5,21,287,266
14,65,6,20,274,254
14,66,0,3,201,198
14,66,1,6,207,201
14,66,2,9,235,226
14,66,3,2,224,222
14,66,4,64,264,200
14,66,5,33,287,254
14,66,6,14,276,262
14,67,0,2,200,198
14,67,1,5,216,211
14,67,2,11,227,216
14,67,3,7,230,223
14,67,4,82,326,244
14,67,5,22,267,245
14,67,6,32,281,249
14,68,0,6,230,224
14,68,1,8,221,213
14,68,2,21,247,226
14,68,3,13,233,220
14,68,4,102,315,213
14,68,5,22,283,261
14,68,6,38,314,276
14,69,0,10,212,202
14,69,1,10,226,216
14,69,2,26,206,180
14,69,3,12,249,237
14,69,4,67,284,217
14,69,5,39,360,321
14,69,6,51,300,249
14,70,0,6,212,206
14,70,1,9,214,205
14,70,2,34,229,195
14,70,3,10,234,224
14,70,4,86,315,229
14,70,5,35,303,268
14,70,6,54,303,249
14,71,0,4,184,180
14,71,1,12,208,196
14,71,2,35,271,236
14,71,3,7,220,213
14,71,4,61,315,254
14,71,5,38,316,278
14,71,6,53,294,241
14,72,0,2,201,199
14,72,1,6,230,224
14,72,2,19,246,227
14,72,3,15,225,210
14,72,4,83,309,226
14,72,5,42,305,263
14,72,6,27,294,267
14,73,0,10,224,214
14,73,1,6,187,181
14,73,2,8,207,199
14,73,3,5,219,214
14,73,4,110,308,198
14,73,5,43,295,252
14,73,6,39,319,280
14,74,0,7,190,183
14,74,1,18,227,209
14,74,2,16,226,210
14,74,3,5,211,206
14,74,4,98,324,226
14,74,5,38,321,283
14,74,6,33,302,269
14,75,0,17,241,224
14,75,1,22,228,206
14,75,2,9,217,208
14,75,3,9,231,222
14,75,4,95,316,221
14,75,5,31,336,305
14,75,6,28,278,250
14,76,0,18,227,209
14,76,1,13,212,199
14,76,2,24,236,212
14,76,3,6,233,227
14,76,4,66,291,225
14,76,5,37,299,262
14,76,6,29,317,288
14,77,0,25,259,234
14,77,1,10,197,187
14,77,2,14,262,248
14,77,3,8,208,200
14,77,4,53,248,195
14,77,5,33,353,320
14,77,6,24,293,269
14,78,0,25,243,218
14,78,1,19,255,236
14,78,2,16,234,218
14,78,3,17,283,266
14,78,4,66,323,257
14,78,5,51,353,302
14,78,6,26,316,290
14,79,0,19,223,204
14,79,1,22,247,225
14,79,2,21,275,254
14,79,3,20,245,225
14,79,4,105,308,203
14,79,5,69,389,320
14,79,6,32,329,297
14,80,0,39,269,230
14,80,1,27,246,219
14,80,2,20,234,214
14,80,3,11,228,217
14,80,4,111,331,220
14,80,5,86,432,346
14,80,6,25,351,326
14,81,0,20,235,215
14,81,1,20,240,220
14,81,2,19,252,233
14,81,3,16,242,226
14,81,4,95,322,227
14,81,5,73,400,327
14,81,6,48,356,308
14,82,0,34,261,227
14,82,1,36,236,200
14,82,2,32,253,221
14,82,3,26,263,237
14,82,4,101,332,231
14,82,5,84,414,330
14,82,6,32,362,330
14,83,0,50,267,217
14,83,1,42,265,223
14,83,2,28,239,211
14,83,3,43,263,220
14,83,4,55,281,226
14,83,5,90,405,315
14,83,6,46,342,296
14,84,0,32,251,219
14,84,1,24,224,200
14,84,2,26,225,199
14,84,3,27,254,227
14,84,4,67,277,210
14,84,5,71,399,328
14,84,6,29,332,303
14,85,0,36,249,213
14,85,1,33,214,181
14,85,2,43,281,238
14,85,3,22,236,214
14,85,4,66,299,233
14,85,5,76,355,279
14,85,6,34,307,273
14,86,0,42,221,179
14,86,1,42,256,214
14,86,2,19,228,209
14,86,3,15,218,203
14,86,4,91,324,233
14,86,5,49,337,288
14,86,6,31,292,261
14,87,0,48,270,222
14,87,1,26,247,221
14,87,2,16,229,213
14,87,3,14,222,208
14,87,4,109,325,216
14,87,5,38,299,261
14,87,6,34,328,294
14,88,0,34,217,183
14,88,1,37,239,202
14,88,2,35,281,246
14,88,3,25,219,194
14,88,4,104,332,228
14,88,5,39,281,242
14,88,6,35,260,225
14,89,0,44,237,193
14,89,1,45,226,181
14,89,2,43,246,203
14,89,3,32,250,218
14,89,4,103,298,195
14,89,5,36,283,247
14,89,6,70,302,232
14,90,0,63,258,195
14,90,1,27,228,201
14,90,2,23,244,221
14,90,3,34,223,189
14,90,4,140,399,259
14,90,5,62,329,267
14,90,6,82,378,296
14,91,0,80,268,188
14,91,1,125,365,240
14,91,2,108,324,216
14,91,3,53,296,243
14,91,4,123,339,216
14,91,5,90,369,279
14,91,6,79,315,236
14,92,0,113,350,237
14,92,1,108,294,186
14,92,2,118,318,200
14,92,3,52,251,199
14,92,4,156,395,239
14,92,5,80,349,269
14,92,6,97,334,237
14,93,0,17,249,232
14,93,1,34,275,241
14,93,2,28,276,248
14,93,3,24,266,242
14,93,4,22,293,271
14,93,5,60,346,286
14,93,6,70,378,308
14,94,0,32,274,242
14,94,1,37,257,220
14,94,2,15,243,228
14,94,3,18,252,234
14,94,4,54,310,256
14,94,5,59,326,267
14,94,6,83,350,267
14,95,0,37,245,208
14,95,1,37,236,199
14,95,2,31,249,218
14,95,3,20,226,206
14,95,4,89,343,254
14,95,5,88,355,267
14,95,6,97,355,258
14,96,0,15,268,253
14,96,1,9,293,284
14,96,2,26,264,238
14,96,3,8,251,243
14,96,4,120,372,252
14,96,5,33,393,360
14,96,6,14,314,300
14,97,0,26,265,239
14,97,1,18,245,227
14,97,2,33,288,255
14,97,3,9,243,234
14,97,4,107,356,249
14,97,5,78,365,287
14,97,6,20,304,284
14,98,0,40,315,275
14,98,1,29,318,289
14,98,2,34,327,293
14,98,3,11,276,265
14,98,4,117,399,282
14,98,5,60,352,292
14,98,6,45,346,301
14,99,0,36,306,270
14,99,1,29,308,279
14,99,2,61,353,292
14,99,3,12,345,333
14,99,4,151,445,294
14,99,5,87,405,318
14,99,6,61,357,296
14,100,0,26,308,282
14,100,1,28,329,301
14,100,2,68,365,297
14,100,3,12,308,296
14,100,4,171,468,297
14,100,5,104,434,330
14,100,6,50,370,320
14,101,0,35,372,337
14,101,1,31,378,347
14,101,2,67,383,316
14,101,3,16,380,364
14,101,4,237,588,351
14,101,5,119,480,361
14,101,6,60,397,337
14,102,0,79,440,361
14,102,1,136,583,447
14,102,2,128,548,420
14,102,3,84,518,434
14,102,4,280,681,401
14,102,5,188,580,392
14,102,6,42,374,332
14,103,0,144,497,353
14,103,1,170,556,386
14,103,2,175,525,350
14,103,3,71,433,362
14,103,4,284,605,321
14,103,5,188,557,369
14,103,6,60,411,351
14,104,0,175,524,349
14,104,1,164,539,375
14,104,2,193,509,316
14,104,3,89,486,397
14,104,4,320,675,355
14,104,5,152,481,329
14,104,6,35,408,373
14,105,0,189,569,380
14,105,1,249,627,378
14,105,2,281,645,364
14,105,3,118,522,404
14,105,4,295,676,381
14,105,5,122,537,415
14,105,6,23,399,376
14,106,0,123,470,347
14,106,1,208,578,370
14,106,2,251,543,292
14,106,3,79,428,349
14,106,4,322,662,340
14,106,5,81,491,410
14,106,6,17,321,304
14,107,0,112,437,325
14,107,1,130,462,332
14,107,2,164,443,279
14,107,3,73,405,332
14,107,4,293,581,288
14,107,5,44,396,352
14,107,6,15,288,273
14,108,0,87,424,337
14,108,1,139,492,353
14,108,2,168,459,291
14,108,3,55,373,318
14,108,4,334,621,287
14,108,5,17,327,310
14,108,6,7,248,241
14,109,0,81,404,323
14,109,1,135,462,327
14,109,2,156,474,318
14,109,3,36,342,306
14,109,4,260,574,314
14,109,5,6,283,277
14,109,6,6,258,252
14,110,0,28,290,262
14,110,1,83,382,299
14,110,2,105,395,290
14,110,3,38,301,263
14,110,4,115,400,285
14,110,5,10,253,243
14,110,6,3,281,278
14,111,0,10,303,293
14,111,1,22,283,261
14,111,2,72,346,274
14,111,3,13,283,270
14,111,4,30,392,362
14,111,5,13,300,287
14,111,6,4,238,234
14,112,0,8,248,240
14,112,1,6,241,235
14,112,2,35,292,257
14,112,3,15,249,234
14,112,4,36,302,266
14,112,5,7,266,259
14,112,6,7,254,247
14,113,0,8,254,246
14,113,1,8,257,249
14,113,2,23,256,233
14,113,3,11,235,224
14,113,4,12,290,278
14,113,5,9,289,280
14,113,6,6,243,237
14,114,0,10,230,220
14,114,1,6,235,229
14,114,2,27,271,244
14,114,3,7,246,239
14,114,4,20,275,255
14,114,5,8,215,207
14,114,6,6,199,193
14,115,0,11,269,258
14,115,1,12,241,229
14,115,2,25,269,244
14,115,3,9,263,254
14,115,4,22,252,230
14,115,5,9,210,201
14,115,6,16,257,241
14,116,0,9,256,247
14,116,1,19,244,225
14,116,2,25,268,243
14,116,3,8,214,206
14,116,4,29,284,255
14,116,5,8,230,222
14,116,6,17,248,231
14,117,0,5,206,201
14,117,1,14,226,212
14,117,2,14,230,216
14,117,3,10,209,199
14,117,4,21,233,212
14,117,5,25,239,214
14,117,6,10,234,224
14,118,0,7,199,192
14,118,1,19,225,206
14,118,2,4,196,192
14,118,3,10,215,205
14,118,4,24,231,207
14,118,5,26,253,227
14,118,6,23,208,185
14,119,0,22,250,228
14,119,1,25,264,239
14,119,2,11,239,228
14,119,3,8,212,204
14,119,4,14,218,204
14,119,5,24,209,185
14,119,6,35,218,183
14,120,0,14,241,227
14,120,1,15,248,233
14,120,2,6,216,210
14,120,3,5,215,210
14,120,4,13,266,253
14,120,5,6,239,233
14,120,6,22,220,198
14,121,0,18,225,207
14,121,1,23,253,230
14,121,2,10,284,274
14,121,3,10,231,221
14,121,4,11,248,237
14,121,5,17,248,231
14,121,6,35,240,205
14,122,0,7,193,186
14,122,1,25,252,227
14,122,2,15,241,226
14,122,3,8,196,188
14,122,4,15,233,218
14,122,5,24,214,190
14,122,6,21,217,196
14,123,0,58,282,224
14,123,1,28,242,214
14,123,2,20,273,253
14,123,3,15,213,198
14,123,4,20,249,229
14,123,5,43,246,203
14,123,6,16,244,228
14,124,0,83,283,200
14,124,1,23,241,218
14,124,2,16,261,245
14,124,3,16,241,225
14,124,4,10,207,197
14,124,5,32,240,208
14,124,6,19,231,212
14,125,0,64,265,201
14,125,1,15,206,191
14,125,2,22,229,207
14,125,3,7,186,179
14,125,4,17,246,229
14,125,5,24,219,195
14,125,6,26,223,197
14,126,0,85,343,258
14,126,1,29,277,248
14,126,2,17,261,244
14,126,3,9,239,230
14,126,4,44,269,225
14,126,5,18,201,183
14,126,6,28,238,210
14,127,0,58,274,216
14,127,1,24,242,218
14,127,2,26,255,229
14,127,3,12,206,194
14,127,4,26,250,224
14,127,5,20,227,207
14,127,6,5,167,162
14,128,0,28,211,183
14,128,1,30,242,212
14,128,2,22,247,225
14,128,3,16,217,201
14,128,4,20,211,191
14,128,5,25,195,170
14,128,6,7,152,145
14,129,0,27,204,177
14,129,1,10,187,177
14,129,2,10,218,208
14,129,3,11,182,171
14,129,4,13,195,182
14,129,5,19,207,188
14,129,6,8,138,130
14,130,0,15,177,162
14,130,1,13,206,193
14,130,2,8,176,168
14,130,3,13,186,173
14,130,4,20,216,196
14,130,5,10,179,169
14,130,6,3,134,131
14,131,0,11,163,152
14,131,1,23,176,153
14,131,2,4,156,152
14,131,3,6,139,133
14,131,4,17,184,167
14,131,5,14,153,139
14,131,6,9,151,142
14,132,0,8,140,132
14,132,1,16,177,161
14,132,2,7,161,154
14,132,3,9,143,134
14,132,4,24,177,153
14,132,5,25,176,151
14,132,6,8,147,139
14,133,0,5,123,118
14,133,1,17,176,159
14,133,2,7,141,134
14,133,3,3,130,127
14,133,4,11,166,155
14,133,5,14,142,128
14,133,6,3,111,108
14,134,0,6,134,128
14,134,1,8,121,113
14,134,2,4,135,131
14,134,3,3,130,127
14,134,4,3,141,138
14,134,5,14,128,114
14,134,6,3,97,94
14,135,0,3,102,99
14,135,1,7,128,121
14,135,2,2,97,95
14,135,3,3,101,98
14,135,4,13,132,119
14,135,5,9,120,111
14,135,6,2,99,97
14,136,0,5,90,85
14,136,1,7,113,106
14,136,2,3,83,80
14,136,3,1,91,90
14,136,4,6,126,120
14,136,5,1,92,91
14,136,6,3,91,88
14,137,0,6,98,92
14,137,1,5,94,89
14,137,2,5,116,111
14,137,3,7,115,108
14,137,4,8,118,110
14,137,5,9,111,102
14,137,6,3,102,99
14,138,0,6,76,70
14,138,1,8,93,85
14,138,2,4,91,87
14,138,3,6,79,73
14,138,4,4,95,91
14,138,5,6,104,98
14,138,6,9,83,74
14,139,0,6,80,74
14,139,1,5,80,75
14,139,2,3,78,75
14,139,3,4,83,79
14,139,4,7,86,79
14,139,5,13,89,76
14,139,6,4,70,66
14,140,0,2,70,68
14,140,1,6,74,68
14,140,2,3,67,64
14,140,3,6,77,71
14,140,4,9,79,70
14,140,5,13,98,85
14,140,6,1,65,64
14,141,0,5,69,64
14,141,1,11,67,56
14,141,2,9,79,70
14,141,3,15,93,78
14,141,4,8,99,91
14,141,5,5,84,79
14,141,6,5,83,78
14,142,0,7,71,64
14,142,1,13,68,55
14,142,2,7,81,74
14,142,3,8,77,69
14,142,4,5,71,66
14,142,5,6,86,80
14,142,6,14,83,69
14,143,0,6,51,45
14,143,1,10,78,68
14,143,2,5,55,50
14,143,3,5,54,49
14,143,4,5,67,62
14,143,5,2,73,71
14,143,6,5,50,45
15,1,6,0,1,1
15,2,1,0,1,1
15,2,2,0,1,1
15,3,3,1,1,0
15,4,4,0,1,1
15,5,3,1,1,0
15,5,5,0,1,1
15,8,1,2,2,0
15,9,1,2,3,1
15,10,1,1,1,0
15,10,4,4,4,0
15,11,4,2,2,0
15,12,1,0,1,1
15,15,4,1,1,0
15,39,5,0,1,1
15,40,6,1,2,1
15,43,0,1,2,1
15,43,5,1,1,0
15,44,4,1,1,0
15,45,0,0,1,1
15,45,1,0,2,2
15,45,2,0,1,1
15,45,3,0,2,2
15,45,6,0,1,1
15,46,1,0,1,1
15,47,2,1,2,1
15,47,3,0,1,1
15,47,5,0,3,3
15,47,6,0,1,1
15,48,1,1,2,1
15,48,2,0,3,3
15,48,3,2,2,0
15,48,4,0,1,1
15,48,5,4,4,0
15,48,6,4,5,1
15,49,0,1,1,0
15,49,1,4,5,1
15,49,3,1,5,4
15,49,4,0,2,2
15,49,5,0,1,1
15,49,6,3,3,0
15,50,0,0,2,2
15,50,1,1,3,2
15,50,2,1,3,2
15,50,4,0,3,3
15,51,1,0,2,2
15,51,2,0,2,2
15,51,3,2,2,0
15,51,4,0,2,2
15,51,5,0,1,1
15,52,1,0,1,1
15,52,2,3,7,4
15,52,3,0,2,2
15,52,4,0,1,1
15,52,6,3,4,1
15,53,0,0,2,2
15,53,1,0,2,2
15,53,2,1,2,1
15,53,5,0,2,2
15,54,0,1,3,2
15,54,1,0,1,1
15,54,2,2,4,2
15,54,5,1,2,1
15,55,3,1,3,2
15,55,4,1,1,0
15,55,6,0,2,2
15,56,0,0,1,1
15,56,1,3,3,0
15,56,3,1,3,2
15,56,4,0,3,3
15,56,5,0,1,1
15,57,0,0,1,1
15,57,3,0,1,1
15,57,6,1,2,1
15,58,0,0,2,2
15,58,1,0,1,1
15,58,2,1,2,1
15,58,6,3,3,0
15,59,0,1,1,0
15,59,2,0,1,1
15,59,3,2,2,0
15,59,4,1,3,2
15,59,6,4,7,3
15,60,2,5,5,0
15,60,4,0,2,2
15,60,6,4,6,2
15,61,0,1,2,1
15,61,1,1,1,0
15,61,2,1,1,0
15,61,3,1,1,0
15,62,4,0,1,1
15,62,5,8,8,0
15,62,6,0,1,1
15,63,0,1,1,0
15,63,4,1,1,0
15,63,5,2,5,3
15,64,2,0,1,1
15,64,5,1,4,3
15,64,6,2,2,0
15,65,0,0,1,1
15,65,2,0,2,2
15,65,4,0,1,1
15,65,5,1,4,3
15,66,1,0,1,1
15,66,2,0,1,1
15,66,4,0,2,2
15,66,5,0,2,2
15,66,6,1,4,3
15,67,0,0,1,1
15,67,1,1,1,0
15,67,2,3,3,0
15,67,3,1,1,0
15,67,6,1,2,1
15,68,0,2,3,1
15,68,1,1,3,2
15,68,2,0,3,3
15,68,3,0,1,1
15,68,4,0,3,3
15,68,6,1,2,1
15,69,0,1,2,1
15,69,3,1,1,0
15,69,5,1,2,1
15,69,6,1,1,0
15,70,1,1,1,0
15,70,2,2,2,0
15,70,3,2,3,1
15,70,4,1,2,1
15,70,5,1,1,0
15,70,6,1,1,0
15,71,0,2,3,1
15,71,2,1,2,1
15,71,4,1,2,1
15,71,6,0,1,1
15,72,1,0,1,1
15,72,2,0,2,2
15,72,4,1,3,2
15,72,5,3,4,1
15,72,6,1,1,0
15,73,5,0,1,1
15,73,6,1,3,2
15,74,1,2,5,3
15,74,2,3,5,2
15,74,3,7,8,1
15,74,4,0,1,1
15,74,6,1,1,0
15,75,2,4,5,1
15,75,3,2,4,2
15,75,4,0,2,2
15,75,5,0,1,1
15,75,6,2,2,0
15,76,0,0,1,1
15,76,2,0,3,3
15,76,3,1,2,1
15,76,6,5,6,1
15,77,1,1,2,1
15,77,2,0,1,1
15,77,3,0,1,1
15,77,4,1,1,0
15,77,5,0,1,1
15,77,6,0,1,1
15,78,1,4,5,1
15,78,4,0,3,3
15,78,5,0,1,1
15,78,6,3,5,2
15,79,2,3,5,2
15,79,3,0,1,1
15,79,4,0,4,4
15,79,5,0,1,1
15,79,6,0,2,2
15,80,0,0,1,1
15,80,1,1,1,0
15,80,2,2,2,0
15,80,3,0,1,1
15,80,4,0,3,3
15,80,5,0,1,1
15,80,6,0,1,1
15,81,1,1,1,0
15,81,3,1,2,1
15,81,4,0,1,1
15,81,5,3,6,3
15,81,6,0,1,1
15,82,1,0,1,1
15,82,2,0,1,1
15,82,3,4,4,0
15,82,4,0,2,2
15,82,5,1,4,3
15,83,0,0,1,1
15,83,1,1,2,1
15,83,2,1,2,1
15,83,3,2,4,2
15,83,4,1,4,3
15,83,5,3,6,3
15,83,6,2,3,1
15,84,0,0,1,1
15,84,1,0,1,1
15,84,2,1,1,0
15,84,4,0,3,3
15,84,5,2,3,1
15,84,6,0,10,10
15,85,0,1,2,1
15,85,1,1,2,1
15,85,2,0,1,1
15,85,3,2,2,0
15,85,5,2,6,4
15,85,6,1,2,1
15,86,2,1,1,0
15,86,3,0,1,1
15,86,4,2,3,1
15,86,5,0,3,3
15,86,6,1,3,2
15,87,0,0,1,1
15,87,1,0,1,1
15,87,2,0,1,1
15,87,3,0,1,1
15,87,4,1,4,3
15,87,5,6,9,3
15,87,6,0,3,3
15,88,0,2,3,1
15,88,1,1,4,3
15,88,3,0,1,1
15,88,4,2,5,3
15,88,5,4,5,1
15,88,6,1,2,1
15,89,4,1,1,0
15,89,5,0,1,1
15,89,6,3,5,2
15,90,4,1,3,2
15,90,5,5,5,0
15,90,6,3,6,3
15,91,0,1,3,2
15,91,1,0,3,3
15,91,4,6,8,2
15,91,5,4,6,2
15,91,6,7,10,3
15,92,0,0,1,1
15,92,1,0,1,1
15,92,4,4,4,0
15,92,5,10,12,2
15,92,6,2,4,2
15,93,0,0,1,1
15,93,1,1,6,5
15,93,3,2,3,1
15,93,4,0,5,5
15,93,5,6,10,4
15,93,6,2,5,3
15,94,0,0,1,1
15,94,1,0,3,3
15,94,2,0,1,1
15,94,3,1,2,1
15,94,4,11,12,1
15,94,5,6,11,5
15,94,6,3,8,5
15,95,1,0,1,1
15,95,2,2,2,0
15,95,4,3,8,5
15,95,5,16,18,2
15,95,6,4,5,1
15,96,0,0,2,2
15,96,1,0,3,3
15,96,2,1,1,0
15,96,4,2,5,3
15,96,5,10,15,5
15,96,6,6,7,1
15,97,0,3,7,4
15,97,1,1,4,3
15,97,2,2,6,4
15,97,4,6,10,4
15,97,5,5,8,3
15,97,6,3,7,4
15,98,0,0,4,4
15,98,1,2,8,6
15,98,2,0,1,1
15,98,3,0,4,4
15,98,4,5,9,4
15,98,5,7,11,4
15,98,6,11,14,3
15,99,0,1,2,1
15,99,1,1,4,3
15,99,2,1,1,0
15,99,3,0,4,4
15,99,4,6,11,5
15,99,5,6,9,3
15,99,6,7,8,1
15,100,0,2,4,2
15,100,1,0,2,2
15,100,2,0,1,1
15,100,3,0,2,2
15,100,4,6,17,11
15,100,5,4,8,4
15,100,6,4,7,3
15,101,0,0,3,3
15,101,1,0,2,2
15,101,3,0,1,1
15,101,4,4,6,2
15,101,5,4,6,2
15,101,6,6,8,2
15,102,0,0,1,1
15,102,1,1,3,2
15,102,2,1,3,2
15,102,3,0,1,1
15,102,4,0,8,8
15,102,5,5,6,1
15,102,6,7,7,0
15,103,1,0,1,1
15,103,2,0,1,1
15,103,3,1,3,2
15,103,4,2,5,3
15,103,5,4,5,1
15,103,6,1,4,3
15,104,0,0,2,2
15,104,1,0,1,1
15,104,2,1,1,0
15,104,3,0,1,1
15,104,4,2,3,1
15,104,5,6,6,0
15,104,6,1,2,1
15,105,0,0,1,1
15,105,2,0,1,1
15,105,3,0,1,1
15,105,4,0,1,1
15,105,5,2,3,1
15,105,6,2,3,1
15,106,0,0,1,1
15,106,1,0,1,1
15,106,2,7,13,6
15,106,4,1,2,1
15,106,5,1,4,3
15,106,6,3,5,2
15,107,2,2,3,1
15,107,4,1,4,3
15,107,5,5,6,1
15,107,6,1,3,2
15,108,0,3,4,1
15,108,2,2,3,1
15,108,3,0,2,2
15,108,4,1,1,0
15,108,5,4,5,1
15,108,6,1,2,1
15,109,1,0,1,1
15,109,2,2,3,1
15,109,3,11,11,0
15,109,4,2,3,1
15,110,0,0,2,2
15,110,1,1,3,2
15,110,2,0,2,2
15,110,3,0,6,6
15,110,4,0,2,2
15,110,5,0,1,1
15,110,6,2,4,2
15,111,0,0,4,4
15,111,1,0,2,2
15,111,3,1,2,1
15,111,4,0,1,1
15,112,0,0,2,2
15,112,1,0,3,3
15,112,2,0,1,1
15,112,3,0,1,1
15,112,4,1,3,2
15,112,6,4,7,3
15,113,0,0,1,1
15,113,1,0,2,2
15,113,2,1,5,4
15,113,4,0,4,4
15,113,5,1,3,2
15,113,6,1,1,0
15,114,1,1,1,0
15,114,2,2,4,2
15,114,3,1,3,2
15,114,4,6,8,2
15,114,5,0,1,1
15,114,6,2,2,0
15,115,6,1,2,1
15,116,0,1,2,1
15,116,2,0,1,1
15,116,3,0,1,1
15,117,0,1,2,1
15,117,1,0,1,1
15,117,2,2,4,2
15,117,5,0,1,1
15,118,0,0,1,1
15,118,2,3,5,2
15,118,4,3,5,2
15,118,6,0,1,1
15,119,1,1,1,0
15,119,4,2,2,0
15,119,5,3,3,0
15,120,0,0,1,1
15,120,1,0,1,1
15,120,5,0,1,1
15,120,6,2,2,0
15,121,0,0,1,1
15,121,1,0,1,1
15,121,2,1,2,1
15,121,3,1,1,0
15,121,4,1,1,0
15,121,6,0,1,1
15,122,0,0,1,1
15,122,2,0,1,1
15,122,4,2,2,0
15,122,5,1,2,1
15,123,2,2,4,2
15,123,3,0,2,2
15,123,4,0,1,1
15,123,5,0,1,1
15,123,6,0,1,1
15,124,0,0,2,2
15,124,2,1,1,0
15,124,4,0,1,1
15,125,0,1,1,0
15,125,1,2,3,1
15,125,2,2,3,1
15,125,3,0,1,1
15,125,6,1,1,0
15,126,1,1,3,2
15,126,5,0,1,1
15,127,1,3,4,1
15,127,5,0,2,2
15,128,1,1,4,3
15,128,4,0,2,2
15,129,1,0,1,1
15,129,5,1,1,0
15,130,0,0,1,1
15,130,2,0,1,1
15,130,5,3,4,1
15,131,2,0,1,1
15,131,4,0,1,1
15,132,0,1,1,0
15,132,2,0,1,1
15,132,4,0,1,1
15,133,0,1,1,0
15,133,4,0,1,1
15,134,0,1,2,1
15,134,2,0,1,1
15,134,4,1,1,0
15,134,5,1,1,0
15,135,1,1,2,1
15,135,2,1,2,1
15,135,4,1,2,1
15,135,5,2,2,0
15,136,2,0,1,1
15,136,4,1,2,1
15,137,2,2,2,0
15,138,0,2,2,0
15,138,2,0,1,1
15,139,0,4,5,1
15,139,2,0,2,2
15,141,1,1,2,1
15,141,4,0,1,1
15,142,0,1,1,0
15,142,2,1,1,0
15,142,5,0,1,1
16,0,0,4,9,5
16,0,1,1,9,8
16,0,2,0,4,4
16,0,3,0,7,7
16,0,4,0,12,12
16,0,5,1,11,10
16,0,6,0,9,9
16,1,0,1,5,4
16,1,1,0,10,10
16,1,2,2,8,6
16,1,3,2,7,5
16,1,4,1,19,18
16,1,5,3,5,2
16,1,6,0,10,10
16,2,0,3,10,7
16,2,1,0,3,3
16,2,2,1,8,7
16,2,3,0,4,4
16,2,4,1,11,10
16,2,5,2,10,8
16,2,6,0,8,8
16,3,0,2,8,6
16,3,1,0,2,2
16,3,2,0,2,2
16,3,3,0,4,4
16,3,4,0,7,7
16,3,5,0,2,2
16,3,6,0,3,3
16,4,0,0,2,2
16,4,1,2,4,2
16,4,2,1,3,2
16,4,3,3,6,3
16,4,4,2,8,6
16,4,5,1,5,4
16,4,6,5,9,4
16,5,0,0,4,4
16,5,1,0,2,2
16,5,2,1,6,5
16,5,3,0,6,6
16,5,4,2,9,7
16,5,5,0,2,2
16,5,6,6,9,3
16,6,1,0,2,2
16,6,2,0,5,5
16,6,3,0,2,2
16,6,4,1,7,6
16,6,5,0,3,3
16,6,6,8,10,2
16,7,0,0,2,2
16,7,1,0,1,1
16,7,2,4,8,4
16,7,3,1,1,0
16,7,4,0,6,6
16,7,5,3,10,7
16,7,6,0,4,4
16,8,0,3,8,5
16,8,1,2,4,2
16,8,2,0,2,2
16,8,3,0,1,1
16,8,4,1,4,3
16,8,5,0,6,6
16,8,6,0,6,6
16,9,0,1,3,2
16,9,1,2,3,1
16,9,2,0,1,1
16,9,3,5,7,2
16,9,4,0,6,6
16,9,5,1,4,3
16,9,6,0,5,5
16,10,0,0,1,1
16,10,1,3,3,0
16,10,2,0,2,2
16,10,3,0,2,2
16,10,4,3,7,4
16,10,5,0,1,1
16,10,6,2,5,3
16,11,1,2,4,2
16,11,2,0,1,1
16,11,3,3,6,3
16,11,4,2,3,1
16,11,5,1,5,4
16,11,6,5,9,4
16,12,3,0,2,2
16,12,4,1,2,1
16,12,5,3,6,3
16,12,6,0,4,4
16,13,0,0,3,3
16,13,1,0,1,1
16,13,2,0,1,1
16,13,3,0,1,1
16,13,4,1,2,1
16,13,5,0,4,4
16,13,6,3,4,1
16,14,0,0,1,1
16,14,2,0,1,1
16,14,3,0,2,2
16,14,4,4,7,3
16,14,5,1,5,4
16,14,6,1,2,1
16,15,3,2,4,2
16,15,4,4,4,0
16,15,6,3,7,4
16,16,0,1,2,1
16,16,2,0,1,1
16,16,3,2,4,2
16,16,4,2,4,2
16,16,6,0,1,1
16,17,0,2,3,1
16,17,2,0,1,1
16,17,6,1,2,1
16,18,1,1,1,0
16,18,4,0,2,2
16,19,1,2,2,0
16,19,2,1,1,0
16,19,4,2,2,0
16,19,5,1,1,0
16,20,0,2,2,0
16,20,1,0,1,1
16,20,4,2,2,0
16,20,6,0,1,1
16,21,0,1,1,0
16,21,1,2,2,0
16,21,3,1,1,0
16,21,4,1,3,2
16,21,5,0,1,1
16,22,0,2,2,0
16,22,1,1,2,1
16,22,6,1,1,0
16,23,2,1,1,0
16,23,3,1,1,0
16,23,6,0,1,1
16,24,1,2,3,1
16,24,3,1,1,0
16,24,4,1,1,0
16,24,6,2,2,0
16,25,2,1,1,0
16,25,4,0,1,1
16,25,5,0,1,1
16,26,2,0,1,1
16,26,3,1,1,0
16,26,4,3,5,2
16,26,5,0,2,2
16,27,1,0,1,1
16,27,3,1,2,1
16,27,4,3,4,1
16,28,2,1,1,0
16,28,3,0,1,1
16,29,3,0,1,1
16,29,4,0,2,2
16,29,6,1,1,0
16,30,1,1,1,0
16,30,2,1,1,0
16,30,6,2,2,0
16,31,3,2,2,0
16,31,4,1,2,1
16,31,5,1,2,1
16,31,6,0,1,1
16,32,2,1,1,0
16,32,3,2,2,0
16,32,4,2,3,1
16,33,0,1,1,0
16,33,3,1,2,1
16,33,6,1,2,1
16,34,2,1,1,0
16,34,3,1,2,1
16,34,4,0,1,1
16,34,6,0,2,2
16,35,0,1,1,0
16,35,1,1,3,2
16,35,5,1,2,1
16,36,0,2,3,1
16,36,1,0,2,2
16,36,2,1,3,2
16,36,4,2,2,0
16,36,6,0,3,3
16,37,0,1,3,2
16,37,1,0,2,2
16,37,2,1,4,3
16,37,3,2,2,0
16,37,4,2,4,2
16,37,6,1,3,2
16,38,0,3,7,4
16,38,1,0,2,2
16,38,3,3,5,2
16,38,4,3,8,5
16,38,6,1,1,0
16,39,0,2,5,3
16,39,1,1,8,7
16,39,2,0,7,7
16,39,3,2,7,5
16,39,4,1,2,1
16,39,5,0,1,1
16,39,6,0,3,3
16,40,0,1,10,9
16,40,1,2,6,4
16,40,2,1,8,7
16,40,3,0,6,6
16,40,4,4,7,3
16,40,5,1,3,2
16,40,6,0,3,3
16,41,0,3,26,23
16,41,1,0,5,5
16,41,2,0,16,16
16,41,3,2,13,11
16,41,4,7,16,9
16,41,5,1,5,4
16,41,6,0,2,2
16,42,0,2,18,16
16,42,1,4,26,22
16,42,2,2,19,17
16,42,3,0,23,23
16,42,4,7,22,15
16,42,5,1,9,8
16,42,6,0,3,3
16,43,0,0,23,23
16,43,1,1,19,18
16,43,2,0,19,19
16,43,3,1,25,24
16,43,4,0,20,20
16,43,5,0,11,11
16,43,6,0,6,6
16,44,0,1,32,31
16,44,1,2,28,26
16,44,2,1,30,29
16,44,3,1,31,30
16,44,4,2,27,25
16,44,5,1,16,15
16,44,6,2,11,9
16,45,0,5,39,34
16,45,1,2,33,31
16,45,2,4,38,34
16,45,3,2,29,27
16,45,4,7,25,18
16,45,5,0,13,13
16,45,6,5,22,17
16,46,0,7,45,38
16,46,1,4,44,40
16,46,2,1,44,43
16,46,3,1,50,49
16,46,4,6,38,32
16,46,5,2,19,17
16,46,6,1,17,16
16,47,0,5,61,56
16,47,1,0,51,51
16,47,2,6,47,41
16,47,3,5,46,41
16,47,4,1,46,45
16,47,5,1,33,32
16,47,6,1,15,14
16,48,0,23,82,59
16,48,1,3,56,53
16,48,2,8,66,58
16,48,3,7,63,56
16,48,4,6,38,32
16,48,5,3,30,27
16,48,6,0,22,22
16,49,0,14,54,40
16,49,1,17,77,60
16,49,2,11,56,45
16,49,3,15,69,54
16,49,4,7,50,43
16,49,5,7,37,30
16,49,6,6,31,25
16,50,0,27,75,48
16,50,1,26,77,51
16,50,2,10,58,48
16,50,3,14,67,53
16,50,4,15,48,33
16,50,5,2,29,27
16,50,6,3,21,18
16,51,0,47,78,31
16,51,1,34,76,42
16,51,2,42,77,35
16,51,3,35,86,51
16,51,4,29,71,42
16,51,5,5,31,26
16,51,6,2,21,19
16,52,0,55,88,33
16,52,1,21,50,29
16,52,2,23,58,35
16,52,3,27,63,36
16,52,4,21,53,32
16,52,5,5,29,24
16,52,6,1,17,16
16,53,0,34,64,30
16,53,1,44,82,38
16,53,2,28,65,37
16,53,3,28,65,37
16,53,4,22,42,20
16,53,5,1,25,24
16,53,6,1,32,31
16,54,0,25,44,19
16,54,1,35,65,30
16,54,2,27,60,33
16,54,3,20,53,33
16,54,4,30,55,25
16,54,5,6,36,30
16,54,6,2,15,13
16,55,0,33,65,32
16,55,1,37,58,21
16,55,2,37,67,30
16,55,3,29,53,24
16,55,4,18,45,27
16,55,5,2,29,27
16,55,6,1,32,31
16,56,0,56,71,15
16,56,1,45,73,28
16,56,2,33,44,11
16,56,3,48,75,27
16,56,4,23,50,27
16,56,5,4,28,24
16,56,6,5,31,26
16,57,0,60,79,19
16,57,1,26,44,18
16,57,2,27,34,7
16,57,3,65,79,14
16,57,4,23,38,15
16,57,5,8,32,24
16,57,6,1,28,27
16,58,0,57,80,23
16,58,1,28,44,16
16,58,2,27,42,15
16,58,3,31,42,11
16,58,4,27,44,17
16,58,5,2,13,11
16,58,6,1,20,19
16,59,0,49,67,18
16,59,1,27,50,23
16,59,2,17,32,15
16,59,3,10,23,13
16,59,4,23,41,18
16,59,5,5,29,24
16,59,6,3,29,26
16,60,0,24,44,20
16,60,1,22,46,24
16,60,2,14,35,21
16,60,3,16,31,15
16,60,4,14,42,28
16,60,5,3,25,22
16,60,6,5,20,15
16,61,0,10,42,32
16,61,1,10,27,17
16,61,2,10,27,17
16,61,3,5,23,18
16,61,4,7,23,16
16,61,5,9,39,30
16,61,6,3,33,30
16,62,0,16,40,24
16,62,1,6,33,27
16,62,2,8,25,17
16,62,3,6,27,21
16,62,4,21,52,31
16,62,5,10,46,36
16,62,6,10,30,20
16,63,0,13,33,20
16,63,1,5,31,26
16,63,2,6,25,19
16,63,3,7,20,13
16,63,4,19,39,20
16,63,5,6,38,32
16,63,6,3,31,28
16,64,0,12,39,27
16,64,1,6,26,20
16,64,2,3,27,24
16,64,3,0,17,17
16,64,4,23,45,22
16,64,5,7,42,35
16,64,6,4,17,13
16,65,0,2,22,20
16,65,1,4,25,21
16,65,2,7,29,22
16,65,3,10,28,18
16,65,4,14,36,22
16,65,5,7,28,21
16,65,6,6,25,19
16,66,0,3,18,15
16,66,1,4,26,22
16,66,2,9,33,24
16,66,3,6,27,21
16,66,4,12,32,20
16,66,5,6,33,27
16,66,6,4,20,16
16,67,0,4,16,12
16,67,1,12,34,22
16,67,2,5,25,20
16,67,3,11,34,23
16,67,4,19,32,13
16,67,5,0,32,32
16,67,6,5,30,25
16,68,0,7,30,23
16,68,1,5,22,17
16,68,2,1,17,16
16,68,3,3,30,27
16,68,4,17,40,23
16,68,5,4,26,22
16,68,6,4,34,30
16,69,0,8,27,19
16,69,1,5,27,22
16,69,2,6,25,19
16,69,3,5,18,13
16,69,4,8,31,23
16,69,5,2,28,26
16,69,6,0,25,25
16,70,0,4,26,22
16,70,1,4,18,14
16,70,2,4,24,20
16,70,3,7,19,12
16,70,4,16,41,25
16,70,5,4,25,21
16,70,6,2,25,23
16,71,0,3,21,18
16,71,1,6,28,22
16,71,2,2,23,21
16,71,3,11,32,21
16,71,4,7,28,21
16,71,5,2,27,25
16,71,6,1,26,25
16,72,0,7,25,18
16,72,1,4,16,12
16,72,2,4,25,21
16,72,3,10,31,21
16,72,4,5,23,18
16,72,5,4,31,27
16,72,6,4,34,30
16,73,0,2,14,12
16,73,1,4,26,22
16,73,2,4,21,17
16,73,3,11,27,16
16,73,4,8,26,18
16,73,5,10,43,33
16,73,6,7,42,35
16,74,0,3,17,14
16,74,1,5,27,22
16,74,2,4,21,17
16,74,3,6,30,24
16,74,4,17,37,20
16,74,5,6,42,36
16,74,6,8,34,26
16,75,0,3,31,28
16,75,1,4,26,22
16,75,2,5,19,14
16,75,3,6,34,28
16,75,4,30,51,21
16,75,5,11,41,30
16,75,6,2,31,29
16,76,0,2,21,19
16,76,1,5,23,18
16,76,2,5,21,16
16,76,3,4,24,20
16,76,4,3,32,29
16,76,5,11,30,19
16,76,6,2,30,28
16,77,0,2,30,28
16,77,1,12,33,21
16,77,2,8,37,29
16,77,3,13,35,22
16,77,4,11,28,17
16,77,5,8,37,29
16,77,6,7,36,29
16,78,0,1,19,18
16,78,1,6,23,17
16,78,2,2,22,20
16,78,3,2,16,14
16,78,4,9,35,26
16,78,5,9,32,23
16,78,6,1,38,37
16,79,0,1,18,17
16,79,1,8,27,19
16,79,2,2,21,19
16,79,3,2,18,16
16,79,4,4,27,23
16,79,5,11,39,28
16,79,6,2,20,18
16,80,0,2,22,20
16,80,1,0,20,20
16,80,2,5,28,23
16,80,3,6,30,24
16,80,4,4,29,25
16,80,5,6,36,30
16,80,6,5,34,29
16,81,0,0,15,15
16,81,1,5,24,19
16,81,2,1,23,22
16,81,3,4,26,22
16,81,4,7,28,21
16,81,5,0,24,24
16,81,6,1,31,30
16,82,0,2,22,20
16,82,1,6,18,12
16,82,2,5,26,21
16,82,3,2,27,25
16,82,4,14,42,28
16,82,5,6,29,23
16,82,6,3,27,24
16,83,0,2,14,12
16,83,1,4,22,18
16,83,2,6,22,16
16,83,3,4,27,23
16,83,4,33,55,22
16,83,5,6,26,20
16,83,6,9,44,35
16,84,0,0,14,14
16,84,1,3,15,12
16,84,2,9,26,17
16,84,3,3,19,16
16,84,4,17,41,24
16,84,5,2,24,22
16,84,6,6,31,25
16,85,0,0,17,17
16,85,1,0,15,15
16,85,2,8,27,19
16,85,3,2,15,13
16,85,4,11,28,17
16,85,5,2,23,21
16,85,6,5,29,24
16,86,0,6,25,19
16,86,1,3,28,25
16,86,2,1,20,19
16,86,3,1,18,17
16,86,4,8,35,27
16,86,5,7,27,20
16,86,6,4,26,22
16,87,0,5,22,17
16,87,1,1,16,15
16,87,2,1,16,15
16,87,3,3,24,21
16,87,4,9,32,23
16,87,5,3,23,20
16,87,6,0,23,23
16,88,0,0,14,14
16,88,1,4,32,28
16,88,2,4,25,21
16,88,3,9,26,17
16,88,4,9,24,15
16,88,5,8,31,23
16,88,6,0,23,23
16,89,0,3,17,14
16,89,1,2,17,15
16,89,2,10,30,20
16,89,3,5,23,18
16,89,4,5,20,15
16,89,5,5,32,27
16,89,6,3,23,20
16,90,0,1,20,19
16,90,1,1,16,15
16,90,2,6,18,12
16,90,3,2,19,17
16,90,4,5,26,21
16,90,5,4,22,18
16,90,6,3,33,30
16,91,0,4,19,15
16,91,1,2,21,19
16,91,2,9,28,19
16,91,3,5,23,18
16,91,4,5,30,25
16,91,5,2,23,21
16,91,6,1,20,19
16,92,0,4,29,25
16,92,1,5,25,20
16,92,2,3,23,20
16,92,3,4,24,20
16,92,4,2,29,27
16,92,5,3,39,36
16,92,6,4,30,26
16,93,0,0,23,23
16,93,1,2,14,12
16,93,2,2,24,22
16,93,3,3,26,23
16,93,4,0,40,40
16,93,5,4,27,23
16,93,6,1,26,25
16,94,0,1,26,25
16,94,1,1,19,18
16,94,2,4,27,23
16,94,3,1,18,17
16,94,4,1,34,33
16,94,5,0,30,30
16,94,6,2,31,29
16,95,0,0,22,22
16,95,1,0,14,14
16,95,2,1,30,29
16,95,3,3,27,24
16,95,4,1,31,30
16,95,5,2,29,27
16,95,6,3,33,30
16,96,0,0,25,25
16,96,1,0,25,25
16,96,2,0,26,26
16,96,3,1,21,20
16,96,4,1,32,31
16,96,5,0,30,30
16,96,6,1,42,41
16,97,0,0,24,24
16,97,1,3,35,32
16,97,2,1,31,30
16,97,3,0,19,19
16,97,4,0,26,26
16,97,5,0,23,23
16,97,6,0,34,34
16,98,0,2,31,29
16,98,1,5,42,37
16,98,2,3,33,30
16,98,3,2,20,18
16,98,4,0,29,29
16,98,5,5,45,40
16,98,6,0,25,25
16,99,0,4,38,34
16,99,1,1,34,33
16,99,2,2,32,30
16,99,3,3,38,35
16,99,4,0,38,38
16,99,5,1,27,26
16,99,6,0,29,29
16,100,0,3,41,38
16,100,1,2,37,35
16,100,2,6,34,28
16,100,3,1,25,24
16,100,4,14,46,32
16,100,5,2,28,26
16,100,6,1,33,32
16,101,0,1,38,37
16,101,1,0,28,28
16,101,2,7,46,39
16,101,3,1,36,35
16,101,4,3,32,29
16,101,5,1,38,37
16,101,6,3,32,29
16,102,0,3,32,29
16,102,1,0,40,40
16,102,2,3,60,57
16,102,3,1,40,39
16,102,4,2,32,30
16,102,5,3,41,38
16,102,6,4,38,34
16,103,0,0,24,24
16,103,1,2,35,33
16,103,2,7,34,27
16,103,3,2,23,21
16,103,4,2,34,32
16,103,5,2,41,39
16,103,6,0,27,27
16,104,0,0,28,28
16,104,1,1,37,36
16,104,2,0,24,24
16,104,3,0,33,33
16,104,4,3,33,30
16,104,5,1,36,35
16,104,6,0,39,39
16,105,0,1,30,29
16,105,1,6,44,38
16,105,2,0,32,32
16,105,3,0,24,24
16,105,4,2,34,32
16,105,5,1,40,39
16,105,6,0,38,38
16,106,0,1,24,23
16,106,1,1,30,29
16,106,2,0,31,31
16,106,3,0,28,28
16,106,4,3,42,39
16,106,5,3,30,27
16,106,6,2,40,38
16,107,0,2,25,23
16,107,1,1,17,16
16,107,2,2,23,21
16,107,3,0,29,29
16,107,4,5,34,29
16,107,5,3,44,41
16,107,6,0,19,19
16,108,0,2,29,27
16,108,1,0,20,20
16,108,2,1,28,27
16,108,3,0,32,32
16,108,4,3,26,23
16,108,5,2,26,24
16,108,6,4,34,30
16,109,0,1,26,25
16,109,1,0,21,21
16,109,2,3,39,36
16,109,3,0,28,28
16,109,4,6,35,29
16,109,5,2,32,30
16,109,6,0,39,39
16,110,0,2,22,20
16,110,1,4,32,28
16,110,2,0,26,26
16,110,3,0,22,22
16,110,4,1,25,24
16,110,5,2,19,17
16,110,6,1,27,26
16,111,0,3,18,15
16,111,1,1,30,29
16,111,2,6,29,23
16,111,3,1,19,18
16,111,4,3,36,33
16,111,5,0,31,31
16,111,6,2,27,25
16,112,0,0,29,29
16,112,1,0,21,21
16,112,2,3,35,32
16,112,3,4,32,28
16,112,4,2,23,21
16,112,5,0,31,31
16,112,6,2,26,24
16,113,0,1,10,9
16,113,1,0,28,28
16,113,2,3,43,40
16,113,3,0,21,21
16,113,4,2,28,26
16,113,5,0,23,23
16,113,6,1,28,27
16,114,0,2,23,21
16,114,1,0,23,23
16,114,2,2,18,16
16,114,3,1,22,21
16,114,4,0,19,19
16,114,5,0,23,23
16,114,6,3,22,19
16,115,0,1,24,23
16,115,1,1,15,14
16,115,2,2,33,31
16,115,3,1,22,21
16,115,4,1,23,22
16,115,5,0,33,33
16,115,6,1,25,24
16,116,0,1,17,16
16,116,1,0,20,20
16,116,2,1,14,13
16,116,3,2,24,22
16,116,4,1,27,26
16,116,5,0,18,18
16,116,6,3,21,18
16,117,0,0,27,27
16,117,1,2,27,25
16,117,2,0,37,37
16,117,3,1,30,29
16,117,4,0,26,26
16,117,5,0,26,26
16,117,6,0,21,21
16,118,0,1,17,16
16,118,1,4,35,31
16,118,2,0,27,27
16,118,3,2,26,24
16,118,4,1,24,23
16,118,5,1,23,22
16,118,6,2,28,26
16,119,0,3,35,32
16,119,1,2,31,29
16,119,2,0,33,33
16,119,3,2,20,18
16,119,4,0,25,25
16,119,5,2,28,26
16,119,6,0,22,22
16,120,0,1,21,20
16,120,1,1,25,24
16,120,2,2,20,18
16,120,3,2,18,16
16,120,4,2,34,32
16,120,5,5,34,29
16,120,6,2,43,41
16,121,0,4,36,32
16,121,1,2,31,29
16,121,2,2,22,20
16,121,3,1,20,19
16,121,4,1,25,24
16,121,5,4,28,24
16,121,6,0,19,19
16,122,0,1,22,21
16,122,1,0,17,17
16,122,2,1,21,20
16,122,3,3,29,26
16,122,4,0,19,19
16,122,5,4,32,28
16,122,6,0,27,27
16,123,0,1,22,21
16,123,1,2,26,24
16,123,2,1,26,25
16,123,3,0,21,21
16,123,4,0,20,20
16,123,5,2,20,18
16,123,6,4,31,27
16,124,0,0,22,22
16,124,1,0,22,22
16,124,2,0,28,28
16,124,3,0,16,16
16,124,4,1,31,30
16,124,5,2,23,21
16,124,6,1,30,29
16,125,0,0,24,24
16,125,1,1,29,28
16,125,2,0,25,25
16,125,3,1,28,27
16,125,4,1,28,27
16,125,5,1,23,22
16,125,6,4,24,20
16,126,0,0,26,26
16,126,1,0,27,27
16,126,2,1,29,28
16,126,3,4,24,20
16,126,4,1,22,21
16,126,5,0,23,23
16,126,6,5,31,26
16,127,0,2,25,23
16,127,1,1,16,15
16,127,2,1,14,13
16,127,3,1,23,22
16,127,4,1,20,19
16,127,5,1,31,30
16,127,6,2,30,28
16,128,0,1,13,12
16,128,1,0,16,16
16,128,2,0,19,19
16,128,3,0,15,15
16,128,4,3,21,18
16,128,5,0,25,25
16,128,6,0,17,17
16,129,0,0,16,16
16,129,1,1,16,15
16,129,2,0,12,12
16,129,3,0,22,22
16,129,4,2,27,25
16,129,5,0,19,19
16,129,6,0,25,25
16,130,0,2,17,15
16,130,1,0,17,17
16,130,2,0,24,24
16,130,3,2,26,24
16,130,4,5,31,26
16,130,5,2,33,31
16,130,6,1,22,21
16,131,0,2,16,14
16,131,1,2,27,25
16,131,2,2,12,10
16,131,3,0,13,13
16,131,4,1,25,24
16,131,5,4,25,21
16,131,6,3,29,26
16,132,0,0,14,14
16,132,1,0,14,14
16,132,2,1,19,18
16,132,3,2,14,12
16,132,4,2,22,20
16,132,5,6,30,24
16,132,6,0,7,7
16,133,0,2,13,11
16,133,1,0,10,10
16,133,2,4,24,20
16,133,3,1,15,14
16,133,4,1,26,25
16,133,5,6,32,26
16,133,6,2,19,17
16,134,0,1,13,12
16,134,1,0,15,15
16,134,2,1,20,19
16,134,3,1,14,13
16,134,4,2,22,20
16,134,5,2,18,16
16,134,6,0,23,23
16,135,0,0,8,8
16,135,1,0,13,13
16,135,2,1,16,15
16,135,3,0,12,12
16,135,4,0,18,18
16,135,5,2,19,17
16,135,6,1,14,13
16,136,0,0,17,17
16,136,1,2,18,16
16,136,2,0,15,15
16,136,3,0,17,17
16,136,4,0,19,19
16,136,5,0,17,17
16,136,6,0,13,13
16,137,0,1,19,18
16,137,1,1,14,13
16,137,2,1,15,14
16,137,3,0,20,20
16,137,4,0,9,9
16,137,5,1,14,13
16,137,6,1,17,16
16,138,0,0,13,13
16,138,1,0,8,8
16,138,2,3,12,9
16,138,3,1,18,17
16,138,4,1,9,8
16,138,5,1,14,13
16,138,6,0,20,20
16,139,0,4,13,9
16,139,1,0,8,8
16,139,2,3,13,10
16,139,3,1,15,14
16,139,4,0,21,21
16,139,5,0,12,12
16,139,6,1,16,15
16,140,0,1,9,8
16,140,1,1,10,9
16,140,2,0,7,7
16,140,3,0,8,8
16,140,4,0,21,21
16,140,5,0,15,15
16,140,6,13,27,14
16,141,0,1,11,10
16,141,1,0,16,16
16,141,2,3,6,3
16,141,3,1,8,7
16,141,4,0,14,14
16,141,5,0,15,15
16,141,6,1,8,7
16,142,0,0,6,6
16,142,1,0,14,14
16,142,2,3,7,4
16,142,3,15,27,12
16,142,4,0,6,6
16,142,5,3,12,9
16,142,6,2,16,14
16,143,0,0,8,8
16,143,1,0,5,5
16,143,2,6,19,13
16,143,3,3,11,8
16,143,4,2,11,9
16,143,5,0,13,13
16,143,6,4,12,8
17,0,0,2,5,3
17,0,1,3,7,4
17,0,3,0,3,3
17,0,4,1,5,4
17,0,5,0,2,2
17,0,6,0,6,6
17,1,0,1,4,3
17,1,1,0,2,2
17,1,2,1,3,2
17,1,3,1,2,1
17,1,4,0,5,5
17,1,5,0,2,2
17,1,6,0,6,6
17,2,0,5,10,5
17,2,1,3,10,7
17,2,2,0,2,2
17,2,3,0,2,2
17,2,4,0,2,2
17,2,5,0,4,4
17,2,6,1,3,2
17,3,0,0,4,4
17,3,1,4,6,2
17,3,2,3,4,1
17,3,3,1,4,3
17,3,4,0,7,7
17,3,5,2,4,2
17,3,6,1,2,1
17,4,0,1,5,4
17,4,1,1,3,2
17,4,2,0,1,1
17,4,3,0,2,2
17,4,4,1,4,3
17,4,5,0,2,2
17,4,6,4,5,1
17,5,0,8,13,5
17,5,1,2,2,0
17,5,3,0,2,2
17,5,4,2,3,1
17,5,5,1,2,1
17,5,6,0,3,3
17,6,0,2,5,3
17,6,2,0,2,2
17,6,3,0,2,2
17,6,4,1,2,1
17,6,5,0,2,2
17,7,0,3,3,0
17,7,1,3,5,2
17,7,2,1,3,2
17,7,3,1,1,0
17,7,4,1,1,0
17,7,5,1,5,4
17,7,6,0,1,1
17,8,0,0,3,3
17,8,1,1,2,1
17,8,2,0,5,5
17,8,3,0,2,2
17,8,5,1,6,5
17,8,6,0,1,1
17,9,1,0,1,1
17,9,2,1,5,4
17,9,4,1,4,3
17,9,5,0,3,3
17,9,6,1,5,4
17,10,1,0,3,3
17,10,4,0,6,6
17,10,5,1,1,0
17,10,6,0,4,4
17,11,0,0,1,1
17,11,1,0,3,3
17,11,2,0,1,1
17,11,3,0,1,1
17,11,4,0,3,3
17,11,6,0,1,1
17,12,2,0,1,1
17,12,3,0,1,1
17,12,4,1,4,3
17,12,5,3,5,2
17,12,6,0,1,1
17,13,1,0,1,1
17,13,2,1,1,0
17,13,4,0,1,1
17,13,5,0,1,1
17,14,1,1,2,1
17,14,3,0,2,2
17,14,5,0,2,2
17,14,6,0,1,1
17,15,2,1,3,2
17,15,3,3,3,0
17,15,4,1,2,1
17,15,5,0,1,1
17,16,1,0,1,1
17,16,2,1,1,0
17,16,3,0,1,1
17,16,4,0,1,1
17,16,5,1,2,1
17,17,0,0,2,2
17,17,3,2,3,1
17,17,4,0,1,1
17,17,5,0,1,1
17,17,6,0,1,1
17,18,0,0,1,1
17,18,1,0,1,1
17,18,5,0,1,1
17,18,6,1,3,2
17,19,0,1,1,0
17,19,5,0,3,3
17,19,6,0,1,1
17,20,3,0,1,1
17,21,3,1,1,0
17,21,6,1,2,1
17,22,0,1,3,2
17,22,3,1,1,0
17,22,4,4,4,0
17,22,5,1,2,1
17,23,0,0,3,3
17,23,4,0,1,1
17,23,5,0,2,2
17,24,0,1,2,1
17,24,6,0,1,1
17,25,5,0,1,1
17,26,2,3,4,1
17,26,4,0,1,1
17,26,6,0,1,1
17,27,2,1,1,0
17,27,4,0,1,1
17,27,6,2,2,0
17,29,6,0,1,1
17,30,3,0,1,1
17,31,0,0,1,1
17,31,2,0,2,2
17,31,3,0,1,1
17,31,5,1,1,0
17,32,0,1,1,0
17,32,5,3,3,0
17,32,6,1,1,0
17,33,1,1,1,0
17,33,2,4,4,0
17,33,5,5,6,1
17,33,6,1,1,0
17,34,0,3,3,0
17,34,2,1,1,0
17,34,5,1,3,2
17,35,0,2,3,1
17,35,3,2,3,1
17,35,4,0,1,1
17,35,5,1,2,1
17,35,6,0,1,1
17,36,0,0,2,2
17,36,2,2,2,0
17,36,3,3,5,2
17,36,4,0,1,1
17,36,5,3,5,2
17,36,6,1,2,1
17,37,0,2,3,1
17,37,1,2,2,0
17,37,2,0,1,1
17,37,3,3,4,1
17,37,4,2,2,0
17,37,5,2,3,1
17,38,0,3,4,1
17,38,1,1,2,1
17,38,2,2,2,0
17,38,3,0,1,1
17,38,5,1,1,0
17,38,6,0,1,1
17,39,0,0,5,5
17,39,1,0,3,3
17,39,2,0,8,8
17,39,3,0,1,1
17,39,4,0,5,5
17,39,5,0,2,2
17,39,6,0,1,1
17,40,0,0,4,4
17,40,1,0,13,13
17,40,2,0,10,10
17,40,3,0,9,9
17,40,4,0,6,6
17,40,5,1,3,2
17,40,6,2,7,5
17,41,0,0,17,17
17,41,1,0,12,12
17,41,2,2,9,7
17,41,3,0,13,13
17,41,4,1,11,10
17,41,5,0,2,2
17,41,6,2,3,1
17,42,0,1,21,20
17,42,1,0,19,19
17,42,2,0,17,17
17,42,3,1,19,18
17,42,4,0,7,7
17,42,5,1,10,9
17,42,6,2,5,3
17,43,0,0,27,27
17,43,1,0,19,19
17,43,2,0,20,20
17,43,3,0,22,22
17,43,4,0,13,13
17,43,5,1,9,8
17,43,6,1,12,11
17,44,0,0,22,22
17,44,1,1,26,25
17,44,2,0,21,21
17,44,3,1,20,19
17,44,4,0,15,15
17,44,5,0,15,15
17,44,6,4,19,15
17,45,0,0,22,22
17,45,1,0,27,27
17,45,2,4,26,22
17,45,3,1,31,30
17,45,4,0,18,18
17,45,5,2,15,13
17,45,6,0,8,8
17,46,0,1,36,35
17,46,1,0,18,18
17,46,2,0,23,23
17,46,3,0,31,31
17,46,4,0,22,22
17,46,5,0,6,6
17,46,6,0,11,11
17,47,0,0,21,21
17,47,1,0,25,25
17,47,2,1,21,20
17,47,3,0,21,21
17,47,4,2,20,18
17,47,5,1,11,10
17,47,6,0,11,11
17,48,0,0,34,34
17,48,1,0,24,24
17,48,2,2,38,36
17,48,3,3,39,36
17,48,4,0,10,10
17,48,5,0,8,8
17,48,6,1,13,12
17,49,0,0,27,27
17,49,1,0,25,25
17,49,2,0,28,28
17,49,3,1,25,24
17,49,4,3,26,23
17,49,5,1,18,17
17,49,6,0,16,16
17,50,0,3,20,17
17,50,1,1,24,23
17,50,2,0,29,29
17,50,3,1,31,30
17,50,4,0,18,18
17,50,5,6,22,16
17,50,6,0,11,11
17,51,0,2,22,20
17,51,1,1,28,27
17,51,2,0,19,19
17,51,3,0,15,15
17,51,4,1,20,19
17,51,5,0,19,19
17,51,6,2,19,17
17,52,0,1,32,31
17,52,1,1,26,25
17,52,2,0,28,28
17,52,3,6,39,33
17,52,4,4,29,25
17,52,5,0,17,17
17,52,6,1,20,19
17,53,0,0,15,15
17,53,1,0,23,23
17,53,2,2,34,32
17,53,3,0,23,23
17,53,4,5,26,21
17,53,5,0,9,9
17,53,6,2,25,23
17,54,0,0,23,23
17,54,1,3,30,27
17,54,2,0,20,20
17,54,3,3,33,30
17,54,4,3,24,21
17,54,5,2,20,18
17,54,6,1,22,21
17,55,0,0,25,25
17,55,1,3,29,26
17,55,2,0,27,27
17,55,3,1,26,25
17,55,4,2,14,12
17,55,5,2,24,22
17,55,6,2,27,25
17,56,0,0,25,25
17,56,1,1,17,16
17,56,2,1,24,23
17,56,3,0,28,28
17,56,4,2,24,22
17,56,5,0,24,24
17,56,6,1,20,19
17,57,0,4,28,24
17,57,1,2,29,27
17,57,2,4,27,23
17,57,3,1,22,21
17,57,4,0,5,5
17,57,5,1,21,20
17,57,6,1,11,10
17,58,0,6,31,25
17,58,1,11,33,22
17,58,2,5,31,26
17,58,3,9,34,25
17,58,4,1,21,20
17,58,5,0,16,16
17,58,6,2,19,17
17,59,0,3,29,26
17,59,1,3,23,20
17,59,2,2,25,23
17,59,3,6,32,26
17,59,4,4,21,17
17,59,5,1,22,21
17,59,6,7,21,14
17,60,0,2,20,18
17,60,1,0,20,20
17,60,2,1,16,15
17,60,3,3,23,20
17,60,4,1,20,19
17,60,5,2,16,14
17,60,6,0,25,25
17,61,0,0,19,19
17,61,1,0,17,17
17,61,2,1,21,20
17,61,3,1,21,20
17,61,4,2,20,18
17,61,5,3,34,31
17,61,6,1,28,27
17,62,0,1,26,25
17,62,1,0,20,20
17,62,2,4,28,24
17,62,3,2,16,14
17,62,4,9,29,20
17,62,5,4,35,31
17,62,6,1,29,28
17,63,0,2,17,15
17,63,1,2,25,23
17,63,2,5,30,25
17,63,3,1,19,18
17,63,4,4,21,17
17,63,5,0,21,21
17,63,6,0,28,28
17,64,0,7,32,25
17,64,1,2,26,24
17,64,2,4,25,21
17,64,3,3,37,34
17,64,4,9,34,25
17,64,5,6,29,23
17,64,6,4,31,27
17,65,0,6,35,29
17,65,1,1,22,21
17,65,2,6,26,20
17,65,3,2,32,30
17,65,4,4,27,23
17,65,5,4,30,26
17,65,6,9,35,26
17,66,0,2,20,18
17,66,1,2,23,21
17,66,2,5,23,18
17,66,3,3,22,19
17,66,4,1,21,20
17,66,5,2,18,16
17,66,6,14,33,19
17,67,0,2,29,27
17,67,1,4,18,14
17,67,2,5,30,25
17,67,3,0,11,11
17,67,4,3,24,21
17,67,5,1,21,20
17,67,6,1,14,13
17,68,0,3,24,21
17,68,1,0,12,12
17,68,2,3,24,21
17,68,3,4,26,22
17,68,4,4,22,18
17,68,5,1,14,13
17,68,6,5,26,21
17,69,0,2,25,23
17,69,1,5,15,10
17,69,2,1,15,14
17,69,3,5,20,15
17,69,4,6,22,16
17,69,5,1,16,15
17,69,6,6,31,25
17,70,0,1,20,19
17,70,1,0,15,15
17,70,2,0,15,15
17,70,3,2,14,12
17,70,4,6,17,11
17,70,5,0,16,16
17,70,6,1,12,11
17,71,0,5,32,27
17,71,1,3,21,18
17,71,2,2,23,21
17,71,3,0,14,14
17,71,4,4,21,17
17,71,5,0,17,17
17,71,6,4,23,19
17,72,0,2,29,27
17,72,1,2,15,13
17,72,2,0,24,24
17,72,3,2,18,16
17,72,4,0,14,14
17,72,5,0,21,21
17,72,6,1,19,18
17,73,0,2,20,18
17,73,1,1,15,14
17,73,2,0,17,17
17,73,3,0,15,15
17,73,4,7,35,28
17,73,5,0,17,17
17,73,6,1,24,23
17,74,0,1,28,27
17,74,1,0,9,9
17,74,2,0,23,23
17,74,3,0,13,13
17,74,4,3,24,21
17,74,5,2,18,16
17,74,6,2,22,20
17,75,0,1,16,15
17,75,1,1,14,13
17,75,2,1,23,22
17,75,3,4,23,19
17,75,4,7,31,24
17,75,5,1,20,19
17,75,6,2,22,20
17,76,0,1,14,13
17,76,1,2,16,14
17,76,2,2,24,22
17,76,3,0,18,18
17,76,4,8,29,21
17,76,5,1,23,22
17,76,6,0,20,20
17,77,0,0,20,20
17,77,1,1,20,19
17,77,2,0,22,22
17,77,3,1,20,19
17,77,4,9,28,19
17,77,5,4,21,17
17,77,6,4,29,25
17,78,0,2,19,17
17,78,1,0,20,20
17,78,2,1,19,18
17,78,3,1,23,22
17,78,4,0,20,20
17,78,5,1,27,26
17,78,6,2,30,28
17,79,0,9,40,31
17,79,1,0,21,21
17,79,2,2,17,15
17,79,3,0,21,21
17,79,4,3,17,14
17,79,5,3,21,18
17,79,6,1,25,24
17,80,0,2,25,23
17,80,1,0,14,14
17,80,2,4,29,25
17,80,3,1,15,14
17,80,4,1,14,13
17,80,5,2,24,22
17,80,6,0,19,19
17,81,0,1,21,20
17,81,1,1,18,17
17,81,2,7,37,30
17,81,3,2,22,20
17,81,4,1,19,18
17,81,5,0,18,18
17,81,6,0,25,25
17,82,0,0,14,14
17,82,1,0,18,18
17,82,2,0,15,15
17,82,3,2,17,15
17,82,4,7,27,20
17,82,5,2,27,25
17,82,6,4,28,24
17,83,0,1,19,18
17,83,1,1,22,21
17,83,2,0,15,15
17,83,3,5,23,18
17,83,4,0,22,22
17,83,5,6,26,20
17,83,6,1,16,15
17,84,0,2,23,21
17,84,1,7,33,26
17,84,2,0,17,17
17,84,3,0,17,17
17,84,4,0,22,22
17,84,5,2,17,15
17,84,6,3,20,17
17,85,0,2,25,23
17,85,1,0,18,18
17,85,2,1,18,17
17,85,3,1,12,11
17,85,4,9,34,25
17,85,5,0,17,17
17,85,6,1,23,22
17,86,0,3,27,24
17,86,1,4,18,14
17,86,2,0,19,19
17,86,3,1,21,20
17,86,4,1,19,18
17,86,5,1,14,13
17,86,6,0,29,29
17,87,0,4,24,20
17,87,1,3,24,21
17,87,2,0,5,5
17,87,3,0,14,14
17,87,4,3,29,26
17,87,5,3,28,25
17,87,6,5,26,21
17,88,0,2,25,23
17,88,1,0,14,14
17,88,2,1,15,14
17,88,3,1,22,21
17,88,4,3,25,22
17,88,5,3,23,20
17,88,6,0,15,15
17,89,0,2,20,18
17,89,1,0,16,16
17,89,2,0,17,17
17,89,3,1,18,17
17,89,4,4,21,17
17,89,5,0,15,15
17,89,6,3,24,21
17,90,0,3,23,20
17,90,1,0,22,22
17,90,2,1,21,20
17,90,3,0,23,23
17,90,4,2,12,10
17,90,5,0,8,8
17,90,6,4,33,29
17,91,0,0,18,18
17,91,1,0,12,12
17,91,2,3,21,18
17,91,3,4,28,24
17,91,4,0,13,13
17,91,5,0,11,11
17,91,6,1,18,17
17,92,0,2,29,27
17,92,1,0,19,19
17,92,2,1,16,15
17,92,3,2,22,20
17,92,4,2,23,21
17,92,5,1,16,15
17,92,6,1,21,20
17,93,0,0,23,23
17,93,1,0,34,34
17,93,2,1,20,19
17,93,3,0,41,41
17,93,4,3,28,25
17,93,5,0,23,23
17,93,6,0,34,34
17,94,0,1,22,21
17,94,1,1,24,23
17,94,2,4,22,18
17,94,3,4,34,30
17,94,4,2,29,27
17,94,5,1,29,28
17,94,6,1,46,45
17,95,0,0,18,18
17,95,1,1,27,26
17,95,2,0,22,22
17,95,3,1,26,25
17,95,4,1,35,34
17,95,5,1,30,29
17,95,6,2,34,32
17,96,0,0,17,17
17,96,1,1,18,17
17,96,2,3,13,10
17,96,3,1,31,30
17,96,4,3,17,14
17,96,5,1,19,18
17,96,6,0,31,31
17,97,0,0,15,15
17,97,1,0,25,25
17,97,2,0,29,29
17,97,3,2,26,24
17,97,4,1,17,16
17,97,5,1,30,29
17,97,6,2,30,28
17,98,0,0,27,27
17,98,1,0,36,36
17,98,2,2,32,30
17,98,3,2,33,31
17,98,4,1,24,23
17,98,5,0,27,27
17,98,6,0,16,16
17,99,0,0,21,21
17,99,1,0,29,29
17,99,2,1,29,28
17,99,3,1,30,29
17,99,4,3,29,26
17,99,5,3,32,29
17,99,6,0,22,22
17,100,0,0,23,23
17,100,1,1,26,25
17,100,2,1,20,19
17,100,3,2,22,20
17,100,4,4,31,27
17,100,5,0,28,28
17,100,6,0,19,19
17,101,0,0,18,18
17,101,1,1,25,24
17,101,2,1,21,20
17,101,3,2,33,31
17,101,4,1,24,23
17,101,5,0,15,15
17,101,6,0,21,21
17,102,0,0,27,27
17,102,1,0,32,32
17,102,2,1,24,23
17,102,3,0,27,27
17,102,4,0,15,15
17,102,5,0,33,33
17,102,6,7,48,41
17,103,0,2,24,22
17,103,1,2,27,25
17,103,2,2,21,19
17,103,3,3,36,33
17,103,4,0,23,23
17,103,5,0,27,27
17,103,6,0,29,29
17,104,0,2,22,20
17,104,1,2,24,22
17,104,2,0,32,32
17,104,3,0,25,25
17,104,4,2,21,19
17,104,5,0,33,33
17,104,6,0,28,28
17,105,0,1,15,14
17,105,1,0,18,18
17,105,2,1,26,25
17,105,3,3,24,21
17,105,4,1,22,21
17,105,5,0,30,30
17,105,6,0,29,29
17,106,0,0,18,18
17,106,1,1,21,20
17,106,2,1,18,17
17,106,3,3,31,28
17,106,4,0,15,15
17,106,5,1,31,30
17,106,6,1,20,19
17,107,0,4,20,16
17,107,1,1,22,21
17,107,2,1,23,22
17,107,3,5,24,19
17,107,4,0,18,18
17,107,5,1,21,20
17,107,6,0,20,20
17,108,0,9,34,25
17,108,1,0,19,19
17,108,2,1,21,20
17,108,3,0,18,18
17,108,4,2,17,15
17,108,5,0,18,18
17,108,6,1,19,18
17,109,0,6,24,18
17,109,1,0,18,18
17,109,2,1,18,17
17,109,3,4,33,29
17,109,4,0,14,14
17,109,5,1,15,14
17,109,6,2,16,14
17,110,0,2,17,15
17,110,1,2,18,16
17,110,2,0,11,11
17,110,3,0,21,21
17,110,4,0,15,15
17,110,5,0,15,15
17,110,6,0,9,9
17,111,0,0,21,21
17,111,1,0,16,16
17,111,2,0,13,13
17,111,3,1,15,14
17,111,4,0,10,10
17,111,5,0,13,13
17,111,6,0,14,14
17,112,0,1,21,20
17,112,1,0,20,20
17,112,2,0,13,13
17,112,3,1,21,20
17,112,4,2,21,19
17,112,5,1,10,9
17,112,6,0,15,15
17,113,0,0,15,15
17,113,1,0,17,17
17,113,2,2,27,25
17,113,3,3,25,22
17,113,4,0,22,22
17,113,5,1,19,18
17,113,6,2,15,13
17,114,0,1,21,20
17,114,1,2,18,16
17,114,2,1,10,9
17,114,3,0,19,19
17,114,4,0,15,15
17,114,5,2,17,15
17,114,6,4,27,23
17,115,0,0,16,16
17,115,1,1,24,23
17,115,2,0,10,10
17,115,3,1,11,10
17,115,4,0,15,15
17,115,5,0,21,21
17,115,6,0,21,21
17,116,0,1,21,20
17,116,1,1,22,21
17,116,2,0,16,16
17,116,3,0,18,18
17,116,4,1,19,18
17,116,5,1,20,19
17,116,6,6,23,17
17,117,0,0,16,16
17,117,1,0,15,15
17,117,2,1,18,17
17,117,3,0,12,12
17,117,4,2,20,18
17,117,5,2,18,16
17,117,6,2,20,18
17,118,0,2,16,14
17,118,1,0,15,15
17,118,2,1,19,18
17,118,3,0,13,13
17,118,4,2,26,24
17,118,5,0,18,18
17,118,6,3,29,26
17,119,0,0,11,11
17,119,1,0,16,16
17,119,2,2,26,24
17,119,3,0,18,18
17,119,4,1,26,25
17,119,5,0,15,15
17,119,6,0,9,9
17,120,0,1,13,12
17,120,1,1,22,21
17,120,2,0,13,13
17,120,3,1,15,14
17,120,4,0,20,20
17,120,5,1,17,16
17,120,6,6,13,7
17,121,0,0,12,12
17,121,1,3,26,23
17,121,2,0,15,15
17,121,3,1,11,10
17,121,4,1,21,20
17,121,5,1,15,14
17,121,6,2,28,26
17,122,0,1,19,18
17,122,1,5,30,25
17,122,2,1,23,22
17,122,3,1,15,14
17,122,4,0,22,22
17,122,5,0,17,17
17,122,6,0,16,16
17,123,0,1,18,17
17,123,1,1,19,18
17,123,2,0,12,12
17,123,3,3,19,16
17,123,4,1,24,23
17,123,5,2,26,24
17,123,6,0,17,17
17,124,0,1,19,18
17,124,1,1,20,19
17,124,2,0,27,27
17,124,3,0,22,22
17,124,4,1,16,15
17,124,5,0,10,10
17,124,6,0,13,13
17,125,0,0,13,13
17,125,1,2,18,16
17,125,2,0,15,15
17,125,3,1,14,13
17,125,4,0,14,14
17,125,5,1,22,21
17,125,6,0,9,9
17,126,0,0,13,13
17,126,1,0,16,16
17,126,2,0,20,20
17,126,3,0,7,7
17,126,4,0,19,19
17,126,5,1,12,11
17,126,6,0,17,17
17,127,0,0,10,10
17,127,1,0,13,13
17,127,2,1,23,22
17,127,3,1,18,17
17,127,4,0,12,12
17,127,5,1,18,17
17,127,6,0,17,17
17,128,0,0,14,14
17,128,1,0,13,13
17,128,2,0,8,8
17,128,3,0,13,13
17,128,4,1,12,11
17,128,5,0,19,19
17,128,6,0,12,12
17,129,0,0,8,8
17,129,1,1,7,6
17,129,2,1,15,14
17,129,3,0,21,21
17,129,4,4,13,9
17,129,5,0,5,5
17,129,6,0,13,13
17,130,0,2,7,5
17,130,1,0,8,8
17,130,2,0,10,10
17,130,3,4,14,10
17,130,4,0,12,12
17,130,5,0,14,14
17,130,6,1,20,19
17,131,0,1,21,20
17,131,1,0,11,11
17,131,2,0,8,8
17,131,3,1,10,9
17,131,4,0,8,8
17,131,5,2,17,15
17,131,6,0,9,9
17,132,0,1,8,7
17,132,1,0,9,9
17,132,2,0,7,7
17,132,3,0,5,5
17,132,4,1,15,14
17,132,5,1,11,10
17,132,6,0,5,5
17,133,0,0,11,11
17,133,1,1,5,4
17,133,2,0,5,5
17,133,3,1,11,10
17,133,4,1,16,15
17,133,5,2,11,9
17,133,6,0,11,11
17,134,0,2,13,11
17,134,1,0,8,8
17,134,2,1,9,8
17,134,3,1,7,6
17,134,4,0,7,7
17,134,5,0,10,10
17,134,6,1,8,7
17,135,0,0,5,5
17,135,1,0,13,13
17,135,2,0,7,7
17,135,3,1,7,6
17,135,4,0,10,10
17,135,5,1,13,12
17,135,6,1,11,10
17,136,0,1,5,4
17,136,1,0,3,3
17,136,2,1,8,7
17,136,3,0,4,4
17,136,4,0,11,11
17,136,5,0,2,2
17,136,6,2,11,9
17,137,0,0,10,10
17,137,1,1,11,10
17,137,2,2,8,6
17,137,3,1,11,10
17,137,4,2,12,10
17,137,5,2,5,3
17,137,6,1,3,2
17,138,0,0,4,4
17,138,1,3,10,7
17,138,2,0,7,7
17,138,3,0,3,3
17,138,4,1,4,3
17,138,5,1,17,16
17,138,6,2,10,8
17,139,0,5,6,1
17,139,1,2,5,3
17,139,2,0,3,3
17,139,3,0,6,6
17,139,4,0,7,7
17,139,5,2,14,12
17,139,6,2,6,4
17,140,0,0,8,8
17,140,1,1,5,4
17,140,2,1,9,8
17,140,3,0,7,7
17,140,4,1,5,4
17,140,5,1,6,5
17,140,6,2,10,8
17,141,0,0,5,5
17,141,1,1,6,5
17,141,2,0,7,7
17,141,3,0,7,7
17,141,4,0,4,4
17,141,5,0,2,2
17,141,6,1,6,5
17,142,0,0,4,4
17,142,1,3,5,2
17,142,2,0,2,2
17,142,3,0,3,3
17,142,4,2,5,3
17,142,5,0,5,5
17,142,6,3,6,3
17,143,0,0,7,7
17,143,1,3,12,9
17,143,2,0,3,3
17,143,3,2,8,6
17,143,4,0,4,4
17,143,5,0,2,2
17,143,6,9,15,6
18,0,0,0,3,3
18,0,1,0,6,6
18,0,2,8,11,3
18,0,3,3,8,5
18,0,4,1,7,6
18,0,5,1,11,10
18,0,6,2,8,6
18,1,0,9,13,4
18,1,1,8,11,3
18,1,2,1,4,3
18,1,3,6,8,2
18,1,4,0,2,2
18,1,5,1,8,7
18,1,6,0,5,5
18,2,0,4,6,2
18,2,1,7,14,7
18,2,2,4,6,2
18,2,3,3,7,4
18,2,4,1,11,10
18,2,5,3,13,10
18,2,6,4,9,5
18,3,0,7,12,5
18,3,1,0,5,5
18,3,2,1,1,0
18,3,3,3,7,4
18,3,4,0,4,4
18,3,5,0,1,1
18,3,6,5,13,8
18,4,0,0,3,3
18,4,1,1,4,3
18,4,2,2,4,2
18,4,3,4,6,2
18,4,4,1,8,7
18,4,5,2,9,7
18,4,6,3,5,2
18,5,1,4,6,2
18,5,2,0,3,3
18,5,3,12,15,3
18,5,4,1,4,3
18,5,5,2,5,3
18,5,6,1,6,5
18,6,0,5,6,1
18,6,1,5,7,2
18,6,2,3,5,2
18,6,3,1,5,4
18,6,4,0,4,4
18,6,5,1,5,4
18,6,6,1,5,4
18,7,0,11,14,3
18,7,1,1,4,3
18,7,2,1,5,4
18,7,3,5,6,1
18,7,4,3,10,7
18,7,5,1,6,5
18,7,6,2,6,4
18,8,0,3,5,2
18,8,1,1,2,1
18,8,2,0,2,2
18,8,3,2,4,2
18,8,4,0,4,4
18,8,5,0,2,2
18,8,6,2,4,2
18,9,0,4,7,3
18,9,1,2,4,2
18,9,2,2,2,0
18,9,3,1,3,2
18,9,4,4,7,3
18,9,5,1,1,0
18,9,6,4,6,2
18,10,2,4,6,2
18,10,4,2,5,3
18,10,5,2,5,3
18,10,6,5,8,3
18,11,0,2,7,5
18,11,1,1,2,1
18,11,2,6,6,0
18,11,3,3,3,0
18,11,4,1,3,2
18,11,5,3,4,1
18,11,6,4,9,5
18,12,0,0,5,5
18,12,1,2,2,0
18,12,2,3,5,2
18,12,3,1,6,5
18,12,4,0,2,2
18,12,5,0,2,2
18,12,6,2,3,1
18,13,0,0,2,2
18,13,1,0,1,1
18,13,2,0,2,2
18,13,3,5,6,1
18,13,4,2,2,0
18,13,5,1,2,1
18,13,6,3,6,3
18,14,0,1,2,1
18,14,1,2,3,1
18,14,3,2,3,1
18,14,4,0,2,2
18,14,5,0,2,2
18,14,6,4,5,1
18,15,3,1,2,1
18,15,4,1,1,0
18,15,5,2,4,2
18,15,6,1,2,1
18,16,1,0,1,1
18,16,2,1,1,0
18,16,3,5,7,2
18,16,4,0,1,1
18,16,5,3,4,1
18,16,6,1,2,1
18,17,0,0,1,1
18,17,1,1,1,0
18,17,2,2,4,2
18,17,3,2,4,2
18,17,4,1,3,2
18,18,1,0,1,1
18,18,2,1,1,0
18,18,3,1,4,3
18,18,4,1,1,0
18,18,5,1,1,0
18,18,6,5,5,0
18,19,1,1,1,0
18,19,2,0,1,1
18,19,4,4,5,1
18,19,5,0,1,1
18,20,0,1,1,0
18,20,2,1,2,1
18,20,3,0,1,1
18,20,4,0,1,1
18,21,0,0,1,1
18,21,2,1,1,0
18,21,3,1,1,0
18,21,4,1,1,0
18,21,5,1,1,0
18,21,6,2,2,0
18,22,1,1,1,0
18,22,4,2,2,0
18,22,6,0,1,1
18,23,1,2,2,0
18,23,4,2,3,1
18,23,6,0,1,1
18,24,0,3,3,0
18,24,1,2,2,0
18,24,2,1,1,0
18,24,3,0,2,2
18,24,6,1,1,0
18,25,0,1,2,1
18,25,2,0,2,2
18,25,4,0,1,1
18,25,5,1,1,0
18,25,6,3,3,0
18,26,4,1,1,0
18,26,5,1,2,1
18,26,6,2,2,0
18,27,2,2,4,2
18,27,3,0,1,1
18,27,4,1,3,2
18,27,5,0,1,1
18,27,6,1,1,0
18,28,2,1,1,0
18,28,3,0,1,1
18,28,4,0,1,1
18,28,5,0,1,1
18,28,6,3,3,0
18,29,1,1,1,0
18,29,3,1,1,0
18,29,4,5,5,0
18,29,6,1,2,1
18,30,0,1,1,0
18,30,3,1,1,0
18,31,3,2,2,0
18,31,4,2,4,2
18,31,5,0,1,1
18,31,6,1,2,1
18,32,0,1,3,2
18,32,1,1,1,0
18,32,2,1,2,1
18,32,3,0,1,1
18,32,4,0,2,2
18,32,6,1,2,1
18,33,0,1,1,0
18,33,1,2,3,1
18,33,3,0,1,1
18,33,4,4,7,3
18,33,6,2,2,0
18,34,0,0,1,1
18,34,1,0,1,1
18,34,3,1,3,2
18,34,4,5,5,0
18,34,5,0,1,1
18,35,0,0,1,1
18,35,1,1,2,1
18,35,2,1,2,1
18,35,3,3,3,0
18,35,4,4,6,2
18,35,5,0,2,2
18,35,6,0,3,3
18,36,0,3,8,5
18,36,1,1,2,1
18,36,2,2,4,2
18,36,3,5,7,2
18,36,4,1,2,1
18,36,5,0,1,1
18,36,6,1,3,2
18,37,0,1,3,2
18,37,1,2,5,3
18,37,2,0,3,3
18,37,3,3,4,1
18,37,4,1,2,1
18,37,5,0,3,3
18,37,6,4,12,8
18,38,0,2,6,4
18,38,1,1,8,7
18,38,2,6,10,4
18,38,3,11,15,4
18,38,4,6,9,3
18,38,5,1,2,1
18,38,6,5,9,4
18,39,0,0,15,15
18,39,1,0,12,12
18,39,2,2,17,15
18,39,3,5,15,10
18,39,4,5,15,10
18,39,5,2,11,9
18,39,6,2,4,2
18,40,0,6,26,20
18,40,1,0,13,13
18,40,2,9,28,19
18,40,3,3,16,13
18,40,4,0,11,11
18,40,5,0,4,4
18,40,6,1,8,7
18,41,0,2,25,23
18,41,1,3,20,17
18,41,2,0,27,27
18,41,3,1,16,15
18,41,4,1,16,15
18,41,5,1,8,7
18,41,6,1,10,9
18,42,0,3,23,20
18,42,1,0,21,21
18,42,2,0,22,22
18,42,3,3,29,26
18,42,4,3,21,18
18,42,5,2,22,20
18,42,6,2,6,4
18,43,0,6,47,41
18,43,1,1,29,28
18,43,2,0,25,25
18,43,3,1,36,35
18,43,4,0,28,28
18,43,5,1,17,16
18,43,6,4,16,12
18,44,0,1,45,44
18,44,1,0,34,34
18,44,2,0,39,39
18,44,3,3,42,39
18,44,4,1,30,29
18,44,5,1,18,17
18,44,6,3,18,15
18,45,0,4,50,46
18,45,1,6,59,53
18,45,2,0,48,48
18,45,3,2,50,48
18,45,4,6,47,41
18,45,5,5,39,34
18,45,6,3,28,25
18,46,0,2,59,57
18,46,1,1,44,43
18,46,2,6,61,55
18,46,3,2,66,64
18,46,4,3,35,32
18,46,5,0,26,26
18,46,6,4,43,39
18,47,0,7,57,50
18,47,1,6,67,61
18,47,2,2,47,45
18,47,3,2,56,54
18,47,4,3,49,46
18,47,5,2,27,25
18,47,6,0,23,23
18,48,0,11,64,53
18,48,1,2,45,43
18,48,2,7,64,57
18,48,3,11,69,58
18,48,4,8,32,24
18,48,5,1,29,28
18,48,6,2,24,22
18,49,0,16,54,38
18,49,1,11,63,52
18,49,2,6,50,44
18,49,3,9,50,41
18,49,4,1,39,38
18,49,5,2,28,26
18,49,6,2,25,23
18,50,0,3,42,39
18,50,1,9,56,47
18,50,2,4,52,48
18,50,3,6,65,59
18,50,4,1,44,43
18,50,5,8,41,33
18,50,6,1,19,18
18,51,0,16,59,43
18,51,1,16,56,40
18,51,2,2,38,36
18,51,3,4,46,42
18,51,4,2,30,28
18,51,5,2,34,32
18,51,6,0,21,21
18,52,0,4,32,28
18,52,1,2,36,34
18,52,2,8,54,46
18,52,3,3,25,22
18,52,4,4,37,33
18,52,5,6,30,24
18,52,6,2,20,18
18,53,0,10,46,36
18,53,1,1,32,31
18,53,2,7,45,38
18,53,3,17,52,35
18,53,4,2,34,32
18,53,5,4,31,27
18,53,6,0,24,24
18,54,0,0,25,25
18,54,1,0,33,33
18,54,2,1,29,28
18,54,3,8,56,48
18,54,4,1,31,30
18,54,5,6,32,26
18,54,6,2,25,23
18,55,0,0,30,30
18,55,1,1,32,31
18,55,2,2,31,29
18,55,3,12,45,33
18,55,4,4,31,27
18,55,5,8,38,30
18,55,6,6,29,23
18,56,0,1,22,21
18,56,1,5,49,44
18,56,2,1,30,29
18,56,3,2,28,26
18,56,4,2,32,30
18,56,5,10,39,29
18,56,6,4,36,32
18,57,0,3,22,19
18,57,1,2,37,35
18,57,2,4,31,27
18,57,3,4,36,32
18,57,4,3,31,28
18,57,5,3,29,26
18,57,6,2,25,23
18,58,0,1,35,34
18,58,1,5,29,24
18,58,2,4,20,16
18,58,3,4,30,26
18,58,4,4,27,23
18,58,5,6,31,25
18,58,6,3,37,34
18,59,0,6,26,20
18,59,1,6,30,24
18,59,2,5,31,26
18,59,3,3,24,21
18,59,4,10,38,28
18,59,5,3,34,31
18,59,6,7,40,33
18,60,0,7,19,12
18,60,1,5,33,28
18,60,2,12,27,15
18,60,3,0,22,22
18,60,4,13,32,19
18,60,5,3,35,32
18,60,6,1,29,28
18,61,0,3,19,16
18,61,1,5,22,17
18,61,2,12,39,27
18,61,3,1,30,29
18,61,4,22,36,14
18,61,5,4,33,29
18,61,6,4,30,26
18,62,0,6,22,16
18,62,1,4,22,18
18,62,2,6,27,21
18,62,3,4,34,30
18,62,4,18,39,21
18,62,5,2,22,20
18,62,6,13,39,26
18,63,0,8,35,27
18,63,1,4,36,32
18,63,2,6,24,18
18,63,3,2,21,19
18,63,4,15,41,26
18,63,5,2,24,22
18,63,6,6,37,31
18,64,0,4,29,25
18,64,1,3,22,19
18,64,2,4,26,22
18,64,3,7,27,20
18,64,4,14,37,23
18,64,5,6,30,24
18,64,6,2,22,20
18,65,0,9,27,18
18,65,1,4,19,15
18,65,2,8,17,9
18,65,3,2,21,19
18,65,4,18,36,18
18,65,5,7,33,26
18,65,6,4,20,16
18,66,0,2,18,16
18,66,1,6,26,20
18,66,2,12,38,26
18,66,3,9,24,15
18,66,4,20,35,15
18,66,5,2,29,27
18,66,6,6,24,18
18,67,0,10,18,8
18,67,1,9,23,14
18,67,2,4,12,8
18,67,3,0,20,20
18,67,4,16,33,17
18,67,5,3,26,23
18,67,6,3,28,25
18,68,0,15,38,23
18,68,1,5,25,20
18,68,2,5,28,23
18,68,3,4,22,18
18,68,4,19,37,18
18,68,5,2,20,18
18,68,6,2,24,22
18,69,0,5,21,16
18,69,1,6,26,20
18,69,2,2,23,21
18,69,3,8,25,17
18,69,4,14,35,21
18,69,5,2,27,25
18,69,6,5,27,22
18,70,0,3,16,13
18,70,1,2,17,15
18,70,2,4,18,14
18,70,3,11,36,25
18,70,4,9,34,25
18,70,5,4,25,21
18,70,6,0,27,27
18,71,0,4,19,15
18,71,1,1,21,20
18,71,2,5,26,21
18,71,3,9,42,33
18,71,4,2,25,23
18,71,5,1,23,22
18,71,6,2,29,27
18,72,0,4,23,19
18,72,1,3,28,25
18,72,2,4,25,21
18,72,3,11,34,23
18,72,4,13,29,16
18,72,5,2,36,34
18,72,6,4,40,36
18,73,0,3,24,21
18,73,1,5,22,17
18,73,2,4,21,17
18,73,3,7,35,28
18,73,4,1,23,22
18,73,5,11,52,41
18,73,6,4,37,33
18,74,0,8,28,20
18,74,1,5,28,23
18,74,2,5,19,14
18,74,3,2,20,18
18,74,4,11,37,26
18,74,5,4,31,27
18,74,6,5,32,27
18,75,0,9,31,22
18,75,1,4,20,16
18,75,2,6,30,24
18,75,3,4,23,19
18,75,4,12,35,23
18,75,5,5,27,22
18,75,6,4,35,31
18,76,0,4,23,19
18,76,1,5,20,15
18,76,2,4,22,18
18,76,3,1,36,35
18,76,4,13,38,25
18,76,5,5,33,28
18,76,6,2,33,31
18,77,0,5,21,16
18,77,1,4,30,26
18,77,2,4,20,16
18,77,3,8,35,27
18,77,4,9,30,21
18,77,5,6,30,24
18,77,6,5,37,32
18,78,0,10,25,15
18,78,1,8,33,25
18,78,2,9,33,24
18,78,3,8,34,26
18,78,4,6,26,20
18,78,5,9,43,34
18,78,6,9,33,24
18,79,0,3,22,19
18,79,1,3,30,27
18,79,2,12,28,16
18,79,3,7,25,18
18,79,4,13,24,11
18,79,5,10,35,25
18,79,6,6,35,29
18,80,0,13,29,16
18,80,1,2,29,27
18,80,2,11,29,18
18,80,3,10,31,21
18,80,4,7,27,20
18,80,5,4,23,19
18,80,6,6,35,29
18,81,0,6,24,18
18,81,1,4,19,15
18,81,2,11,25,14
18,81,3,2,28,26
18,81,4,6,24,18
18,81,5,4,24,20
18,81,6,8,40,32
18,82,0,8,27,19
18,82,1,1,15,14
18,82,2,17,38,21
18,82,3,5,21,16
18,82,4,1,21,20
18,82,5,7,34,27
18,82,6,2,31,29
18,83,0,4,24,20
18,83,1,2,24,22
18,83,2,17,34,17
18,83,3,5,20,15
18,83,4,3,22,19
18,83,5,5,22,17
18,83,6,8,26,18
18,84,0,5,21,16
18,84,1,8,25,17
18,84,2,3,15,12
18,84,3,4,26,22
18,84,4,6,21,15
18,84,5,6,32,26
18,84,6,3,22,19
18,85,0,9,26,17
18,85,1,1,17,16
18,85,2,6,28,22
18,85,3,0,17,17
18,85,4,5,17,12
18,85,5,4,18,14
18,85,6,2,22,20
18,86,0,2,17,15
18,86,1,4,20,16
18,86,2,4,15,11
18,86,3,1,13,12
18,86,4,5,15,10
18,86,5,2,15,13
18,86,6,2,25,23
18,87,0,8,31,23
18,87,1,2,18,16
18,87,2,3,20,17
18,87,3,4,23,19
18,87,4,3,29,26
18,87,5,4,18,14
18,87,6,1,19,18
18,88,0,2,18,16
18,88,1,0,8,8
18,88,2,0,24,24
18,88,3,0,9,9
18,88,4,8,32,24
18,88,5,2,14,12
18,88,6,0,20,20
18,89,0,1,18,17
18,89,1,1,18,17
18,89,2,1,28,27
18,89,3,1,19,18
18,89,4,3,22,19
18,89,5,4,28,24
18,89,6,2,19,17
18,90,0,4,18,14
18,90,1,0,18,18
18,90,2,5,34,29
18,90,3,2,23,21
18,90,4,2,17,15
18,90,5,8,29,21
18,90,6,7,28,21
18,91,0,5,27,22
18,91,1,2,28,26
18,91,2,9,29,20
18,91,3,4,21,17
18,91,4,8,24,16
18,91,5,4,23,19
18,91,6,1,21,20
18,92,0,8,25,17
18,92,1,6,25,19
18,92,2,3,22,19
18,92,3,6,32,26
18,92,4,1,28,27
18,92,5,1,14,13
18,92,6,2,33,31
18,93,0,3,32,29
18,93,1,5,40,35
18,93,2,1,27,26
18,93,3,4,27,23
18,93,4,1,26,25
18,93,5,1,28,27
18,93,6,2,29,27
18,94,0,4,21,17
18,94,1,0,15,15
18,94,2,1,19,18
18,94,3,2,17,15
18,94,4,2,29,27
18,94,5,1,12,11
18,94,6,3,20,17
18,95,0,1,16,15
18,95,1,0,10,10
18,95,2,0,19,19
18,95,3,2,18,16
18,95,4,2,30,28
18,95,5,0,14,14
18,95,6,0,20,20
18,96,0,2,24,22
18,96,1,2,27,25
18,96,2,1,28,27
18,96,3,3,30,27
18,96,4,1,32,31
18,96,5,0,26,26
18,96,6,0,21,21
18,97,0,0,26,26
18,97,1,2,32,30
18,97,2,1,24,23
18,97,3,1,23,22
18,97,4,3,25,22
18,97,5,0,18,18
18,97,6,4,24,20
18,98,0,4,29,25
18,98,1,1,19,18
18,98,2,5,27,22
18,98,3,11,35,24
18,98,4,0,24,24
18,98,5,5,39,34
18,98,6,3,36,33
18,99,0,0,20,20
18,99,1,4,36,32
18,99,2,5,45,40
18,99,3,2,29,27
18,99,4,1,38,37
18,99,5,4,34,30
18,99,6,1,32,31
18,100,0,1,31,30
18,100,1,6,38,32
18,100,2,9,41,32
18,100,3,6,38,32
18,100,4,1,28,27
18,100,5,3,27,24
18,100,6,3,33,30
18,101,0,6,34,28
18,101,1,5,34,29
18,101,2,3,30,27
18,101,3,2,31,29
18,101,4,9,52,43
18,101,5,3,26,23
18,101,6,2,25,23
18,102,0,2,28,26
18,102,1,1,35,34
18,102,2,3,38,35
18,102,3,4,32,28
18,102,4,8,38,30
18,102,5,1,47,46
18,102,6,2,27,25
18,103,0,5,34,29
18,103,1,6,43,37
18,103,2,4,31,27
18,103,3,4,28,24
18,103,4,2,25,23
18,103,5,2,36,34
18,103,6,2,26,24
18,104,0,7,39,32
18,104,1,0,37,37
18,104,2,12,48,36
18,104,3,3,38,35
18,104,4,0,26,26
18,104,5,1,32,31
18,104,6,4,36,32
18,105,0,3,34,31
18,105,1,9,42,33
18,105,2,10,42,32
18,105,3,0,32,32
18,105,4,5,29,24
18,105,5,5,37,32
18,105,6,1,31,30
18,106,0,2,28,26
18,106,1,4,37,33
18,106,2,2,40,38
18,106,3,2,41,39
18,106,4,1,32,31
18,106,5,4,28,24
18,106,6,1,21,20
18,107,0,1,40,39
18,107,1,4,36,32
18,107,2,1,30,29
18,107,3,3,40,37
18,107,4,1,30,29
18,107,5,1,27,26
18,107,6,1,25,24
18,108,0,7,39,32
18,108,1,5,29,24
18,108,2,3,39,36
18,108,3,1,32,31
18,108,4,2,27,25
18,108,5,1,34,33
18,108,6,0,23,23
18,109,0,2,18,16
18,109,1,4,31,27
18,109,2,2,30,28
18,109,3,0,26,26
18,109,4,0,28,28
18,109,5,2,21,19
18,109,6,1,22,21
18,110,0,1,28,27
18,110,1,2,28,26
18,110,2,1,25,24
18,110,3,0,27,27
18,110,4,2,30,28
18,110,5,2,24,22
18,110,6,1,26,25
18,111,0,1,22,21
18,111,1,0,21,21
18,111,2,2,29,27
18,111,3,1,30,29
18,111,4,5,46,41
18,111,5,0,17,17
18,111,6,5,28,23
18,112,0,7,28,21
18,112,1,1,24,23
18,112,2,6,25,19
18,112,3,2,31,29
18,112,4,3,37,34
18,112,5,0,24,24
18,112,6,2,28,26
18,113,0,4,38,34
18,113,1,4,32,28
18,113,2,2,31,29
18,113,3,2,28,26
18,113,4,1,25,24
18,113,5,4,24,20
18,113,6,2,27,25
18,114,0,2,21,19
18,114,1,0,18,18
18,114,2,1,15,14
18,114,3,2,19,17
18,114,4,4,41,37
18,114,5,3,27,24
18,114,6,9,36,27
18,115,0,4,20,16
18,115,1,1,22,21
18,115,2,3,28,25
18,115,3,2,34,32
18,115,4,3,27,24
18,115,5,2,25,23
18,115,6,2,22,20
18,116,0,0,12,12
18,116,1,0,16,16
18,116,2,3,20,17
18,116,3,2,21,19
18,116,4,6,27,21
18,116,5,2,17,15
18,116,6,4,19,15
18,117,0,0,20,20
18,117,1,3,27,24
18,117,2,1,25,24
18,117,3,2,37,35
18,117,4,1,24,23
18,117,5,0,24,24
18,117,6,1,24,23
18,118,0,1,17,16
18,118,1,2,19,17
18,118,2,5,26,21
18,118,3,1,20,19
18,118,4,7,32,25
18,118,5,3,25,22
18,118,6,6,30,24
18,119,0,4,32,28
18,119,1,7,34,27
18,119,2,3,24,21
18,119,3,1,17,16
18,119,4,0,26,26
18,119,5,1,23,22
18,119,6,5,18,13
18,120,0,1,16,15
18,120,1,4,26,22
18,120,2,1,22,21
18,120,3,2,15,13
18,120,4,4,27,23
18,120,5,2,18,16
18,120,6,1,22,21
18,121,0,1,16,15
18,121,1,6,22,16
18,121,2,2,19,17
18,121,3,1,19,18
18,121,4,0,18,18
18,121,5,0,15,15
18,121,6,1,14,13
18,122,0,1,19,18
18,122,1,4,30,26
18,122,2,2,18,16
18,122,3,0,19,19
18,122,4,5,20,15
18,122,5,1,16,15
18,122,6,1,21,20
18,123,0,0,23,23
18,123,1,1,24,23
18,123,2,3,20,17
18,123,3,0,16,16
18,123,4,3,30,27
18,123,5,0,14,14
18,123,6,1,23,22
18,124,0,3,20,17
18,124,1,5,22,17
18,124,2,0,24,24
18,124,3,3,16,13
18,124,4,0,25,25
18,124,5,2,16,14
18,124,6,2,16,14
18,125,0,4,17,13
18,125,1,3,19,16
18,125,2,2,18,16
18,125,3,4,23,19
18,125,4,3,18,15
18,125,5,2,14,12
18,125,6,4,14,10
18,126,0,9,20,11
18,126,1,3,14,11
18,126,2,1,20,19
18,126,3,9,26,17
18,126,4,6,24,18
18,126,5,0,21,21
18,126,6,0,12,12
18,127,0,10,30,20
18,127,1,1,11,10
18,127,2,1,23,22
18,127,3,0,15,15
18,127,4,4,21,17
18,127,5,1,20,19
18,127,6,1,24,23
18,128,0,8,19,11
18,128,1,1,16,15
18,128,2,1,22,21
18,128,3,2,24,22
18,128,4,0,20,20
18,128,5,6,21,15
18,128,6,2,20,18
18,129,0,3,23,20
18,129,1,1,18,17
18,129,2,1,9,8
18,129,3,5,20,15
18,129,4,0,10,10
18,129,5,1,15,14
18,129,6,3,24,21
18,130,0,4,18,14
18,130,1,3,15,12
18,130,2,5,19,14
18,130,3,4,20,16
18,130,4,0,15,15
18,130,5,0,14,14
18,130,6,4,17,13
18,131,0,9,21,12
18,131,1,4,14,10
18,131,2,2,15,13
18,131,3,3,20,17
18,131,4,0,12,12
18,131,5,2,25,23
18,131,6,3,16,13
18,132,0,5,17,12
18,132,1,1,9,8
18,132,2,2,13,11
18,132,3,0,21,21
18,132,4,1,16,15
18,132,5,2,20,18
18,132,6,0,15,15
18,133,0,3,13,10
18,133,1,0,7,7
18,133,2,1,16,15
18,133,3,1,17,16
18,133,4,0,17,17
18,133,5,1,22,21
18,133,6,3,15,12
18,134,0,4,22,18
18,134,1,1,9,8
18,134,2,5,17,12
18,134,3,7,15,8
18,134,4,2,17,15
18,134,5,2,20,18
18,134,6,2,16,14
18,135,0,2,12,10
18,135,1,4,12,8
18,135,2,5,17,12
18,135,3,0,7,7
18,135,4,2,10,8
18,135,5,0,12,12
18,135,6,0,10,10
18,136,0,5,18,13
18,136,1,2,7,5
18,136,2,4,15,11
18,136,3,4,17,13
18,136,4,1,13,12
18,136,5,0,11,11
18,136,6,1,17,16
18,137,0,5,16,11
18,137,1,1,8,7
18,137,2,3,11,8
18,137,3,0,14,14
18,137,4,3,21,18
18,137,5,1,17,16
18,137,6,1,11,10
18,138,0,1,7,6
18,138,1,0,17,17
18,138,2,4,13,9
18,138,3,3,9,6
18,138,4,0,8,8
18,138,5,2,16,14
18,138,6,2,9,7
18,139,0,1,8,7
18,139,1,3,8,5
18,139,2,2,7,5
18,139,3,0,3,3
18,139,4,6,20,14
18,139,5,2,13,11
18,139,6,0,4,4
18,140,0,2,12,10
18,140,1,3,8,5
18,140,2,1,7,6
18,140,3,0,9,9
18,140,4,4,15,11
18,140,5,3,15,12
18,140,6,3,5,2
18,141,0,4,13,9
18,141,1,0,7,7
18,141,2,3,10,7
18,141,3,5,13,8
18,141,4,0,5,5
18,141,5,1,7,6
18,141,6,2,7,5
18,142,0,8,17,9
18,142,1,0,5,5
18,142,2,7,16,9
18,142,3,0,4,4
18,142,4,0,10,10
18,142,5,2,7,5
18,142,6,4,11,7
18,143,0,4,12,8
18,143,1,3,4,1
18,143,2,4,11,7
18,143,3,2,8,6
18,143,4,2,9,7
18,143,5,10,16,6
18,143,6,4,7,3
19,0,0,5,70,65
19,0,1,19,90,71
19,0,2,7,70,63
19,0,3,11,72,61
19,0,4,2,93,91
19,0,5,3,99,96
19,0,6,6,76,70
19,1,0,11,65,54
19,1,1,7,58,51
19,1,2,5,65,60
19,1,3,6,77,71
19,1,4,6,79,73
19,1,5,1,58,57
19,1,6,4,63,59
19,2,0,7,46,39
19,2,1,6,52,46
19,2,2,6,50,44
19,2,3,10,70,60
19,2,4,8,86,78
19,2,5,5,54,49
19,2,6,2,59,57
19,3,0,12,65,53
19,3,1,3,61,58
19,3,2,2,53,51
19,3,3,10,69,59
19,3,4,2,73,71
19,3,5,5,70,65
19,3,6,4,50,46
19,4,0,1,35,34
19,4,1,5,41,36
19,4,2,2,30,28
19,4,3,8,52,44
19,4,4,6,66,60
19,4,5,9,61,52
19,4,6,9,62,53
19,5,0,4,53,49
19,5,1,10,50,40
19,5,2,1,50,49
19,5,3,9,54,45
19,5,4,15,71,56
19,5,5,9,59,50
19,5,6,3,56,53
19,6,0,20,56,36
19,6,1,11,43,32
19,6,2,3,36,33
19,6,3,6,48,42
19,6,4,2,52,50
19,6,5,1,38,37
19,6,6,7,48,41
19,7,0,5,47,42
19,7,1,0,33,33
19,7,2,4,38,34
19,7,3,3,42,39
19,7,4,4,36,32
19,7,5,3,41,38
19,7,6,11,62,51
19,8,0,1,21,20
19,8,1,4,31,27
19,8,2,4,39,35
19,8,3,7,33,26
19,8,4,1,39,38
19,8,5,4,53,49
19,8,6,5,38,33
19,9,0,0,27,27
19,9,1,8,36,28
19,9,2,2,26,24
19,9,3,8,38,30
19,9,4,0,30,30
19,9,5,5,42,37
19,9,6,5,44,39
19,10,0,1,21,20
19,10,1,1,31,30
19,10,2,7,37,30
19,10,3,6,28,22
19,10,4,3,38,35
19,10,5,1,31,30
19,10,6,5,48,43
19,11,0,4,25,21
19,11,1,4,25,21
19,11,2,5,33,28
19,11,3,4,33,29
19,11,4,1,32,31
19,11,5,2,34,32
19,11,6,4,31,27
19,12,0,6,31,25
19,12,1,9,41,32
19,12,2,2,34,32
19,12,3,1,21,20
19,12,4,2,25,23
19,12,5,4,38,34
19,12,6,10,47,37
19,13,0,6,29,23
19,13,1,9,35,26
19,13,2,5,20,15
19,13,3,5,30,25
19,13,4,2,39,37
19,13,5,8,37,29
19,13,6,5,37,32
19,14,0,1,22,21
19,14,1,10,29,19
19,14,2,4,31,27
19,14,3,5,28,23
19,14,4,1,27,26
19,14,5,1,17,16
19,14,6,4,34,30
19,15,0,7,21,14
19,15,1,13,33,20
19,15,2,2,19,17
19,15,3,8,24,16
19,15,4,5,28,23
19,15,5,7,25,18
19,15,6,1,24,23
19,16,0,10,30,20
19,16,1,1,15,14
19,16,2,0,13,13
19,16,3,8,21,13
19,16,4,4,25,21
19,16,5,5,22,17
19,16,6,5,31,26
19,17,0,9,24,15
19,17,1,1,15,14
19,17,2,4,16,12
19,17,3,3,18,15
19,17,4,14,48,34
19,17,5,5,24,19
19,17,6,4,20,16
19,18,0,3,21,18
19,18,1,2,17,15
19,18,2,8,19,11
19,18,3,0,12,12
19,18,4,24,41,17
19,18,5,2,23,21
19,18,6,1,16,15
19,19,0,11,19,8
19,19,1,0,10,10
19,19,2,3,15,12
19,19,3,4,20,16
19,19,4,6,23,17
19,19,5,3,21,18
19,19,6,2,20,18
19,20,0,2,15,13
19,20,1,0,11,11
19,20,2,9,24,15
19,20,3,6,21,15
19,20,4,6,24,18
19,20,5,3,15,12
19,20,6,7,16,9
19,21,0,1,7,6
19,21,1,3,15,12
19,21,2,5,18,13
19,21,3,0,12,12
19,21,4,12,30,18
19,21,5,2,17,15
19,21,6,2,11,9
19,22,0,1,12,11
19,22,1,1,8,7
19,22,2,1,13,12
19,22,3,0,12,12
19,22,4,3,18,15
19,22,5,1,19,18
19,22,6,4,18,14
19,23,0,4,16,12
19,23,1,2,9,7
19,23,2,11,17,6
19,23,3,3,12,9
19,23,4,8,21,13
19,23,5,10,16,6
19,23,6,8,17,9
19,24,0,4,14,10
19,24,1,13,23,10
19,24,2,12,19,7
19,24,3,1,14,13
19,24,4,8,20,12
19,24,5,0,4,4
19,24,6,2,10,8
19,25,0,1,7,6
19,25,1,8,20,12
19,25,2,9,17,8
19,25,3,4,8,4
19,25,4,6,13,7
19,25,5,4,16,12
19,25,6,2,9,7
19,26,0,3,11,8
19,26,1,2,7,5
19,26,2,5,8,3
19,26,3,1,4,3
19,26,4,2,14,12
19,26,5,5,14,9
19,26,6,0,8,8
19,27,0,3,4,1
19,27,1,3,8,5
19,27,2,1,3,2
19,27,3,0,7,7
19,27,4,0,5,5
19,27,5,0,7,7
19,27,6,3,9,6
19,28,0,5,11,6
19,28,1,9,17,8
19,28,2,5,13,8
19,28,3,2,8,6
19,28,4,3,11,8
19,28,5,6,9,3
19,28,6,1,7,6
19,29,0,2,9,7
19,29,1,4,11,7
19,29,2,3,9,6
19,29,3,3,9,6
19,29,4,6,18,12
19,29,5,0,7,7
19,29,6,2,9,7
19,30,0,0,8,8
19,30,1,8,16,8
19,30,2,3,9,6
19,30,3,3,8,5
19,30,4,10,14,4
19,30,5,4,11,7
19,30,6,7,13,6
19,31,0,5,12,7
19,31,1,7,11,4
19,31,2,1,7,6
19,31,3,2,8,6
19,31,4,8,12,4
19,31,5,5,16,11
19,31,6,6,10,4
19,32,0,3,6,3
19,32,1,10,13,3
19,32,2,12,19,7
19,32,3,1,4,3
19,32,4,14,21,7
19,32,5,2,11,9
19,32,6,3,9,6
19,33,0,3,8,5
19,33,1,2,8,6
19,33,2,3,11,8
19,33,3,0,6,6
19,33,4,13,22,9
19,33,5,7,14,7
19,33,6,3,13,10
19,34,0,7,23,16
19,34,1,7,14,7
19,34,2,2,11,9
19,34,3,9,17,8
19,34,4,21,37,16
19,34,5,1,9,8
19,34,6,5,11,6
19,35,0,5,17,12
19,35,1,11,22,11
19,35,2,13,18,5
19,35,3,9,14,5
19,35,4,7,11,4
19,35,5,0,10,10
19,35,6,2,9,7
19,36,0,12,27,15
19,36,1,13,25,12
19,36,2,14,25,11
19,36,3,15,21,6
19,36,4,14,22,8
19,36,5,10,27,17
19,36,6,10,24,14
19,37,0,12,26,14
19,37,1,14,25,11
19,37,2,10,29,19
19,37,3,10,22,12
19,37,4,16,27,11
19,37,5,15,32,17
19,37,6,12,26,14
19,38,0,15,30,15
19,38,1,15,28,13
19,38,2,12,38,26
19,38,3,8,30,22
19,38,4,13,29,16
19,38,5,13,29,16
19,38,6,8,24,16
19,39,0,1,40,39
19,39,1,1,42,41
19,39,2,2,58,56
19,39,3,2,37,35
19,39,4,14,48,34
19,39,5,0,39,39
19,39,6,3,30,27
19,40,0,0,41,41
19,40,1,1,41,40
19,40,2,2,51,49
19,40,3,2,40,38
19,40,4,17,69,52
19,40,5,4,49,45
19,40,6,1,27,26
19,41,0,1,58,57
19,41,1,1,41,40
19,41,2,0,53,53
19,41,3,3,54,51
19,41,4,6,51,45
19,41,5,4,39,35
19,41,6,1,38,37
19,42,0,1,107,106
19,42,1,3,95,92
19,42,2,2,106,104
19,42,3,3,95,92
19,42,4,4,92,88
19,42,5,2,56,54
19,42,6,7,51,44
19,43,0,0,114,114
19,43,1,1,110,109
19,43,2,5,133,128
19,43,3,3,119,116
19,43,4,1,97,96
19,43,5,4,71,67
19,43,6,5,57,52
19,44,0,5,173,168
19,44,1,3,157,154
19,44,2,7,172,165
19,44,3,1,164,163
19,44,4,4,121,117
19,44,5,7,107,100
19,44,6,6,84,78
19,45,0,6,249,243
19,45,1,3,224,221
19,45,2,4,237,233
19,45,3,15,277,262
19,45,4,6,176,170
19,45,5,4,116,112
19,45,6,5,100,95
19,46,0,16,287,271
19,46,1,8,251,243
19,46,2,6,269,263
19,46,3,18,312,294
19,46,4,11,255,244
19,46,5,5,149,144
19,46,6,4,125,121
19,47,0,36,351,315
19,47,1,4,277,273
19,47,2,15,303,288
19,47,3,44,356,312
19,47,4,10,239,229
19,47,5,5,149,144
19,47,6,4,117,113
19,48,0,134,486,352
19,48,1,22,374,352
19,48,2,58,415,357
19,48,3,79,438,359
19,48,4,20,296,276
19,48,5,10,205,195
19,48,6,4,149,145
19,49,0,258,563,305
19,49,1,147,560,413
19,49,2,73,434,361
19,49,3,96,475,379
19,49,4,52,332,280
19,49,5,7,222,215
19,49,6,9,173,164
19,50,0,160,535,375
19,50,1,164,545,381
19,50,2,85,481,396
19,50,3,103,526,423
19,50,4,26,306,280
19,50,5,5,212,207
19,50,6,7,166,159
19,51,0,222,595,373
19,51,1,135,505,370
19,51,2,80,448,368
19,51,3,134,503,369
19,51,4,58,347,289
19,51,5,9,230,221
19,51,6,8,223,215
19,52,0,192,521,329
19,52,1,72,389,317
19,52,2,74,385,311
19,52,3,110,444,334
19,52,4,80,333,253
19,52,5,8,201,193
19,52,6,7,207,200
19,53,0,57,322,265
19,53,1,30,268,238
19,53,2,16,262,246
19,53,3,23,285,262
19,53,4,7,184,177
19,53,5,5,143,138
19,53,6,10,133,123
19,54,0,7,243,236
19,54,1,5,202,197
19,54,2,6,220,214
19,54,3,3,211,208
19,54,4,1,168,167
19,54,5,3,121,118
19,54,6,6,161,155
19,55,0,11,183,172
19,55,1,7,156,149
19,55,2,4,181,177
19,55,3,7,188,181
19,55,4,2,143,141
19,55,5,5,143,138
19,55,6,4,130,126
19,56,0,5,158,153
19,56,1,4,165,161
19,56,2,2,138,136
19,56,3,6,169,163
19,56,4,2,152,150
19,56,5,8,139,131
19,56,6,5,108,103
19,57,0,3,171,168
19,57,1,2,139,137
19,57,2,7,147,140
19,57,3,5,149,144
19,57,4,2,128,126
19,57,5,2,166,164
19,57,6,3,137,134
19,58,0,5,123,118
19,58,1,4,128,124
19,58,2,6,143,137
19,58,3,5,150,145
19,58,4,5,142,137
19,58,5,3,128,125
19,58,6,2,131,129
19,59,0,2,110,108
19,59,1,5,135,130
19,59,2,12,139,127
19,59,3,5,147,142
19,59,4,2,123,121
19,59,5,3,115,112
19,59,6,8,116,108
19,60,0,5,108,103
19,60,1,5,123,118
19,60,2,4,114,110
19,60,3,4,133,129
19,60,4,4,103,99
19,60,5,3,131,128
19,60,6,1,126,125
19,61,0,0,111,111
19,61,1,4,124,120
19,61,2,5,111,106
19,61,3,8,128,120
19,61,4,4,112,108
19,61,5,5,158,153
19,61,6,4,119,115
19,62,0,3,118,115
19,62,1,7,99,92
19,62,2,10,133,123
19,62,3,3,103,100
19,62,4,7,131,124
19,62,5,4,131,127
19,62,6,5,115,110
19,63,0,5,105,100
19,63,1,5,107,102
19,63,2,7,113,106
19,63,3,4,122,118
19,63,4,14,140,126
19,63,5,2,135,133
19,63,6,4,126,122
19,64,0,8,121,113
19,64,1,1,112,111
19,64,2,6,113,107
19,64,3,1,107,106
19,64,4,8,136,128
19,64,5,6,153,147
19,64,6,4,157,153
19,65,0,4,115,111
19,65,1,1,97,96
19,65,2,13,127,114
19,65,3,5,102,97
19,65,4,23,143,120
19,65,5,2,124,122
19,65,6,6,132,126
19,66,0,5,131,126
19,66,1,2,118,116
19,66,2,3,119,116
19,66,3,1,121,120
19,66,4,23,140,117
19,66,5,4,144,140
19,66,6,3,130,127
19,67,0,4,96,92
19,67,1,9,114,105
19,67,2,6,115,109
19,67,3,3,116,113
19,67,4,34,154,120
19,67,5,4,134,130
19,67,6,3,126,123
19,68,0,3,126,123
19,68,1,5,90,85
19,68,2,11,127,116
19,68,3,8,143,135
19,68,4,26,125,99
19,68,5,7,137,130
19,68,6,10,147,137
19,69,0,3,113,110
19,69,1,3,121,118
19,69,2,20,144,124
19,69,3,9,141,132
19,69,4,11,167,156
19,69,5,1,148,147
19,69,6,7,147,140
19,70,0,7,131,124
19,70,1,4,135,131
19,70,2,9,137,128
19,70,3,5,140,135
19,70,4,11,139,128
19,70,5,3,134,131
19,70,6,4,151,147
19,71,0,3,111,108
19,71,1,3,125,122
19,71,2,11,117,106
19,71,3,8,147,139
19,71,4,22,148,126
19,71,5,5,140,135
19,71,6,5,150,145
19,72,0,5,141,136
19,72,1,8,145,137
19,72,2,5,130,125
19,72,3,2,130,128
19,72,4,12,130,118
19,72,5,8,133,125
19,72,6,8,160,152
19,73,0,7,138,131
19,73,1,4,127,123
19,73,2,4,123,119
19,73,3,9,133,124
19,73,4,24,150,126
19,73,5,10,174,164
19,73,6,4,166,162
19,74,0,7,145,138
19,74,1,5,129,124
19,74,2,0,132,132
19,74,3,8,137,129
19,74,4,33,162,129
19,74,5,5,154,149
19,74,6,7,141,134
19,75,0,5,149,144
19,75,1,6,139,133
19,75,2,5,139,134
19,75,3,2,130,128
19,75,4,22,152,130
19,75,5,6,159,153
19,75,6,11,158,147
19,76,0,4,133,129
19,76,1,3,145,142
19,76,2,5,125,120
19,76,3,7,148,141
19,76,4,17,149,132
19,76,5,8,149,141
19,76,6,14,189,175
19,77,0,9,148,139
19,77,1,4,158,154
19,77,2,4,133,129
19,77,3,4,138,134
19,77,4,17,161,144
19,77,5,8,167,159
19,77,6,8,161,153
19,78,0,2,149,147
19,78,1,4,129,125
19,78,2,4,131,127
19,78,3,3,145,142
19,78,4,11,146,135
19,78,5,3,184,181
19,78,6,7,168,161
19,79,0,6,176,170
19,79,1,6,172,166
19,79,2,4,139,135
19,79,3,9,140,131
19,79,4,6,161,155
19,79,5,11,174,163
19,79,6,4,177,173
19,80,0,6,138,132
19,80,1,11,158,147
19,80,2,2,139,137
19,80,3,14,157,143
19,80,4,21,197,176
19,80,5,7,198,191
19,80,6,3,154,151
19,81,0,2,163,161
19,81,1,5,145,140
19,81,2,8,162,154
19,81,3,3,145,142
19,81,4,17,161,144
19,81,5,9,166,157
19,81,6,9,180,171
19,82,0,7,149,142
19,82,1,2,138,136
19,82,2,6,153,147
19,82,3,6,160,154
19,82,4,13,176,163
19,82,5,7,132,125
19,82,6,7,177,170
19,83,0,6,135,129
19,83,1,4,142,138
19,83,2,5,136,131
19,83,3,8,134,126
19,83,4,20,150,130
19,83,5,6,157,151
19,83,6,4,164,160
19,84,0,5,141,136
19,84,1,3,130,127
19,84,2,3,118,115
19,84,3,5,144,139
19,84,4,30,187,157
19,84,5,6,165,159
19,84,6,7,170,163
19,85,0,7,134,127
19,85,1,9,168,159
19,85,2,7,139,132
19,85,3,7,147,140
19,85,4,31,145,114
19,85,5,3,161,158
19,85,6,5,157,152
19,86,0,4,132,128
19,86,1,10,144,134
19,86,2,4,134,130
19,86,3,2,140,138
19,86,4,24,173,149
19,86,5,8,170,162
19,86,6,5,155,150
19,87,0,9,158,149
19,87,1,3,123,120
19,87,2,8,171,163
19,87,3,7,159,152
19,87,4,30,192,162
19,87,5,3,161,158
19,87,6,6,149,143
19,88,0,7,126,119
19,88,1,0,117,117
19,88,2,3,119,116
19,88,3,5,140,135
19,88,4,18,170,152
19,88,5,3,152,149
19,88,6,4,173,169
19,89,0,5,163,158
19,89,1,5,137,132
19,89,2,5,140,135
19,89,3,4,139,135
19,89,4,14,142,128
19,89,5,4,149,145
19,89,6,4,179,175
19,90,0,8,149,141
19,90,1,3,131,128
19,90,2,5,144,139
19,90,3,3,140,137
19,90,4,9,134,125
19,90,5,4,168,164
19,90,6,5,147,142
19,91,0,5,142,137
19,91,1,5,134,129
19,91,2,9,141,132
19,91,3,2,141,139
19,91,4,19,178,159
19,91,5,8,172,164
19,91,6,9,179,170
19,92,0,4,142,138
19,92,1,6,126,120
19,92,2,8,151,143
19,92,3,12,144,132
19,92,4,14,136,122
19,92,5,5,158,153
19,92,6,2,156,154
19,93,0,7,135,128
19,93,1,5,153,148
19,93,2,1,138,137
19,93,3,5,158,153
19,93,4,6,186,180
19,93,5,3,160,157
19,93,6,2,163,161
19,94,0,3,150,147
19,94,1,5,166,161
19,94,2,3,152,149
19,94,3,3,145,142
19,94,4,10,172,162
19,94,5,4,158,154
19,94,6,5,196,191
19,95,0,6,146,140
19,95,1,8,166,158
19,95,2,5,149,144
19,95,3,9,153,144
19,95,4,8,170,162
19,95,5,9,194,185
19,95,6,1,173,172
19,96,0,6,171,165
19,96,1,6,185,179
19,96,2,5,192,187
19,96,3,2,147,145
19,96,4,7,181,174
19,96,5,9,199,190
19,96,6,7,171,164
19,97,0,7,117,110
19,97,1,5,148,143
19,97,2,6,161,155
19,97,3,1,150,149
19,97,4,3,161,158
19,97,5,6,171,165
19,97,6,3,174,171
19,98,0,3,140,137
19,98,1,2,147,145
19,98,2,6,175,169
19,98,3,1,137,136
19,98,4,2,168,166
19,98,5,7,168,161
19,98,6,6,191,185
19,99,0,11,197,186
19,99,1,8,141,133
19,99,2,9,184,175
19,99,3,8,192,184
19,99,4,5,180,175
19,99,5,5,182,177
19,99,6,6,210,204
19,100,0,11,152,141
19,100,1,16,187,171
19,100,2,5,164,159
19,100,3,7,175,168
19,100,4,11,195,184
19,100,5,8,182,174
19,100,6,4,190,186
19,101,0,7,197,190
19,101,1,3,221,218
19,101,2,9,248,239
19,101,3,2,230,228
19,101,4,6,174,168
19,101,5,5,208,203
19,101,6,7,216,209
19,102,0,8,275,267
19,102,1,8,335,327
19,102,2,12,345,333
19,102,3,6,378,372
19,102,4,8,264,256
19,102,5,12,270,258
19,102,6,5,236,231
19,103,0,8,293,285
19,103,1,7,267,260
19,103,2,9,274,265
19,103,3,10,290,280
19,103,4,5,242,237
19,103,5,4,235,231
19,103,6,14,230,216
19,104,0,5,204,199
19,104,1,7,276,269
19,104,2,10,271,261
19,104,3,2,265,263
19,104,4,8,275,267
19,104,5,6,250,244
19,104,6,3,219,216
19,105,0,13,336,323
19,105,1,6,277,271
19,105,2,33,343,310
19,105,3,7,325,318
19,105,4,16,297,281
19,105,5,6,245,239
19,105,6,7,208,201
19,106,0,6,285,279
19,106,1,9,296,287
19,106,2,41,318,277
19,106,3,8,307,299
19,106,4,13,278,265
19,106,5,3,214,211
19,106,6,5,221,216
19,107,0,8,267,259
19,107,1,8,246,238
19,107,2,17,250,233
19,107,3,22,273,251
19,107,4,12,245,233
19,107,5,5,192,187
19,107,6,4,221,217
19,108,0,7,275,268
19,108,1,6,262,256
19,108,2,21,300,279
19,108,3,22,344,322
19,108,4,5,259,254
19,108,5,9,215,206
19,108,6,6,230,224
19,109,0,10,255,245
19,109,1,10,272,262
19,109,2,15,255,240
19,109,3,11,278,267
19,109,4,6,246,240
19,109,5,7,249,242
19,109,6,11,248,237
19,110,0,6,212,206
19,110,1,9,238,229
19,110,2,17,270,253
19,110,3,11,256,245
19,110,4,7,209,202
19,110,5,9,223,214
19,110,6,6,196,190
19,111,0,10,246,236
19,111,1,6,230,224
19,111,2,7,243,236
19,111,3,9,203,194
19,111,4,10,234,224
19,111,5,5,203,198
19,111,6,7,214,207
19,112,0,3,200,197
19,112,1,3,213,210
19,112,2,7,244,237
19,112,3,8,203,195
19,112,4,2,199,197
19,112,5,4,180,176
19,112,6,4,199,195
19,113,0,9,211,202
19,113,1,9,179,170
19,113,2,2,210,208
19,113,3,3,204,201
19,113,4,5,198,193
19,113,5,9,189,180
19,113,6,14,190,176
19,114,0,9,184,175
19,114,1,1,179,178
19,114,2,10,202,192
19,114,3,8,168,160
19,114,4,4,169,165
19,114,5,6,181,175
19,114,6,6,166,160
19,115,0,3,162,159
19,115,1,2,153,151
19,115,2,7,189,182
19,115,3,6,171,165
19,115,4,2,156,154
19,115,5,7,166,159
19,115,6,5,185,180
19,116,0,4,187,183
19,116,1,7,152,145
19,116,2,6,188,182
19,116,3,1,159,158
19,116,4,9,195,186
19,116,5,6,166,160
19,116,6,8,166,158
19,117,0,6,152,146
19,117,1,7,183,176
19,117,2,4,168,164
19,117,3,3,160,157
19,117,4,8,161,153
19,117,5,7,158,151
19,117,6,9,183,174
19,118,0,7,140,133
19,118,1,4,148,144
19,118,2,3,173,170
19,118,3,10,163,153
19,118,4,6,146,140
19,118,5,9,190,181
19,118,6,6,164,158
19,119,0,7,150,143
19,119,1,7,161,154
19,119,2,8,159,151
19,119,3,5,173,168
19,119,4,5,167,162
19,119,5,5,141,136
19,119,6,9,161,152
19,120,0,9,175,166
19,120,1,4,177,173
19,120,2,7,191,184
19,120,3,9,194,185
19,120,4,6,156,150
19,120,5,5,204,199
19,120,6,3,211,208
19,121,0,2,158,156
19,121,1,7,185,178
19,121,2,3,193,190
19,121,3,3,191,188
19,121,4,4,155,151
19,121,5,9,191,182
19,121,6,6,166,160
19,122,0,2,159,157
19,122,1,7,156,149
19,122,2,5,206,201
19,122,3,7,153,146
19,122,4,4,149,145
19,122,5,8,164,156
19,122,6,17,170,153
19,123,0,9,156,147
19,123,1,8,165,157
19,123,2,3,163,160
19,123,3,6,167,161
19,123,4,4,196,192
19,123,5,2,170,168
19,123,6,12,179,167
19,124,0,3,157,154
19,124,1,7,160,153
19,124,2,6,188,182
19,124,3,1,146,145
19,124,4,8,181,173
19,124,5,6,144,138
19,124,6,10,152,142
19,125,0,2,150,148
19,125,1,5,149,144
19,125,2,6,153,147
19,125,3,7,128,121
19,125,4,9,171,162
19,125,5,4,147,143
19,125,6,4,155,151
19,126,0,3,155,152
19,126,1,5,163,158
19,126,2,6,195,189
19,126,3,3,146,143
19,126,4,14,196,182
19,126,5,4,170,166
19,126,6,5,158,153
19,127,0,4,148,144
19,127,1,7,142,135
19,127,2,6,161,155
19,127,3,6,142,136
19,127,4,2,173,171
19,127,5,5,196,191
19,127,6,6,152,146
19,128,0,6,134,128
19,128,1,9,176,167
19,128,2,3,153,150
19,128,3,2,142,140
19,128,4,4,171,167
19,128,5,7,147,140
19,128,6,3,159,156
19,129,0,9,121,112
19,129,1,8,154,146
19,129,2,7,121,114
19,129,3,3,138,135
19,129,4,3,135,132
19,129,5,6,174,168
19,129,6,6,174,168
19,130,0,8,134,126
19,130,1,6,151,145
19,130,2,0,141,141
19,130,3,5,148,143
19,130,4,7,146,139
19,130,5,5,156,151
19,130,6,3,108,105
19,131,0,5,139,134
19,131,1,6,154,148
19,131,2,7,130,123
19,131,3,6,127,121
19,131,4,3,137,134
19,131,5,2,166,164
19,131,6,4,128,124
19,132,0,7,157,150
19,132,1,2,123,121
19,132,2,3,148,145
19,132,3,6,119,113
19,132,4,6,156,150
19,132,5,9,162,153
19,132,6,1,143,142
19,133,0,6,123,117
19,133,1,6,120,114
19,133,2,4,122,118
19,133,3,5,139,134
19,133,4,5,141,136
19,133,5,9,159,150
19,133,6,1,103,102
19,134,0,7,113,106
19,134,1,1,107,106
19,134,2,4,95,91
19,134,3,4,117,113
19,134,4,2,118,116
19,134,5,25,185,160
19,134,6,4,96,92
19,135,0,3,105,102
19,135,1,2,100,98
19,135,2,4,122,118
19,135,3,5,123,118
19,135,4,3,125,122
19,135,5,20,145,125
19,135,6,4,108,104
19,136,0,0,72,72
19,136,1,3,78,75
19,136,2,2,110,108
19,136,3,4,117,113
19,136,4,3,114,111
19,136,5,5,112,107
19,136,6,4,93,89
19,137,0,12,104,92
19,137,1,5,77,72
19,137,2,5,93,88
19,137,3,1,91,90
19,137,4,7,111,104
19,137,5,10,122,112
19,137,6,7,99,92
19,138,0,4,91,87
19,138,1,5,92,87
19,138,2,4,110,106
19,138,3,5,99,94
19,138,4,7,104,97
19,138,5,2,82,80
19,138,6,6,97,91
19,139,0,4,73,69
19,139,1,6,61,55
19,139,2,6,81,75
19,139,3,3,79,76
19,139,4,2,89,87
19,139,5,1,84,83
19,139,6,6,95,89
19,140,0,4,57,53
19,140,1,6,81,75
19,140,2,4,81,77
19,140,3,3,71,68
19,140,4,4,98,94
19,140,5,5,98,93
19,140,6,4,74,70
19,141,0,1,76,75
19,141,1,8,82,74
19,141,2,1,64,63
19,141,3,3,59,56
19,141,4,5,79,74
19,141,5,4,86,82
19,141,6,6,80,74
19,142,0,6,65,59
19,142,1,7,63,56
19,142,2,4,70,66
19,142,3,3,70,67
19,142,4,6,81,75
19,142,5,5,70,65
19,142,6,5,66,61
19,143,0,2,49,47
19,143,1,7,72,65
19,143,2,2,79,77
19,143,3,6,48,42
19,143,4,6,56,50
19,143,5,5,73,68
19,143,6,6,76,70
20,0,0,15,92,77
20,0,1,48,141,93
20,0,2,21,130,109
20,0,3,16,115,99
20,0,4,11,124,113
20,0,5,7,88,81
20,0,6,8,99,91
20,1,0,15,70,55
20,1,1,26,95,69
20,1,2,24,81,57
20,1,3,22,75,53
20,1,4,2,72,70
20,1,5,7,56,49
20,1,6,0,50,50
20,2,0,5,36,31
20,2,1,8,56,48
20,2,2,7,63,56
20,2,3,3,54,51
20,2,4,1,58,57
20,2,5,2,44,42
20,2,6,1,54,53
20,3,0,3,43,40
20,3,1,6,43,37
20,3,2,10,46,36
20,3,3,4,38,34
20,3,4,0,65,65
20,3,5,1,33,32
20,3,6,3,30,27
20,4,0,3,29,26
20,4,1,6,36,30
20,4,2,2,28,26
20,4,3,1,27,26
20,4,4,6,55,49
20,4,5,3,38,35
20,4,6,3,25,22
20,5,0,4,23,19
20,5,1,0,25,25
20,5,2,4,34,30
20,5,3,7,46,39
20,5,4,1,42,41
20,5,5,2,31,29
20,5,6,2,24,22
20,6,0,4,23,19
20,6,1,7,31,24
20,6,2,4,30,26
20,6,3,10,48,38
20,6,4,7,46,39
20,6,5,4,29,25
20,6,6,1,36,35
20,7,0,3,17,14
20,7,1,6,27,21
20,7,2,13,40,27
20,7,3,2,25,23
20,7,4,1,24,23
20,7,5,0,20,20
20,7,6,1,25,24
20,8,0,7,25,18
20,8,1,3,15,12
20,8,2,3,19,16
20,8,3,1,20,19
20,8,4,3,25,22
20,8,5,0,17,17
20,8,6,2,22,20
20,9,0,2,14,12
20,9,1,1,19,18
20,9,2,6,26,20
20,9,3,4,21,17
20,9,4,1,27,26
20,9,5,1,21,20
20,9,6,2,28,26
20,10,0,3,17,14
20,10,1,1,10,9
20,10,2,5,18,13
20,10,3,2,19,17
20,10,4,0,28,28
20,10,5,0,13,13
20,10,6,2,14,12
20,11,0,5,22,17
20,11,1,3,16,13
20,11,2,0,14,14
20,11,3,3,15,12
20,11,4,1,23,22
20,11,5,0,16,16
20,11,6,2,18,16
20,12,0,3,11,8
20,12,1,1,16,15
20,12,2,1,13,12
20,12,3,9,34,25
20,12,4,3,22,19
20,12,5,2,17,15
20,12,6,3,20,17
20,13,0,3,14,11
20,13,1,0,7,7
20,13,2,2,15,13
20,13,3,6,25,19
20,13,4,1,24,23
20,13,5,1,14,13
20,13,6,1,14,13
20,14,0,0,11,11
20,14,1,3,10,7
20,14,2,1,11,10
20,14,3,0,9,9
20,14,4,1,9,8
20,14,5,2,10,8
20,14,6,1,17,16
20,15,0,4,10,6
20,15,1,0,12,12
20,15,2,1,12,11
20,15,3,1,12,11
20,15,4,2,17,15
20,15,5,5,20,15
20,15,6,0,5,5
20,16,0,1,5,4
20,16,1,2,9,7
20,16,2,1,8,7
20,16,3,3,11,8
20,16,4,1,5,4
20,16,5,1,6,5
20,16,6,3,15,12
20,17,0,2,7,5
20,17,1,1,2,1
20,17,2,0,5,5
20,17,3,10,18,8
20,17,4,1,14,13
20,17,5,0,6,6
20,17,6,3,8,5
20,18,0,4,9,5
20,18,1,0,5,5
20,18,2,1,9,8
20,18,3,2,5,3
20,18,4,0,7,7
20,18,5,1,5,4
20,18,6,3,11,8
20,19,0,0,4,4
20,19,1,1,4,3
20,19,2,2,8,6
20,19,3,0,3,3
20,19,4,1,7,6
20,19,5,0,2,2
20,19,6,4,17,13
20,20,0,1,6,5
20,20,1,1,8,7
20,20,2,0,8,8
20,20,3,1,3,2
20,20,4,4,9,5
20,20,5,1,8,7
20,20,6,0,5,5
20,21,0,1,5,4
20,21,1,0,1,1
20,21,2,1,5,4
20,21,3,2,5,3
20,21,4,0,7,7
20,21,5,0,1,1
20,21,6,1,5,4
20,22,0,4,8,4
20,22,1,0,2,2
20,22,2,2,7,5
20,22,3,2,5,3
20,22,4,1,4,3
20,22,5,0,5,5
20,22,6,1,6,5
20,23,1,1,3,2
20,23,2,3,5,2
20,23,3,1,2,1
20,23,4,1,5,4
20,23,5,1,8,7
20,23,6,2,7,5
20,24,0,1,2,1
20,24,1,1,2,1
20,24,2,2,4,2
20,24,3,0,1,1
20,24,4,1,3,2
20,24,5,3,6,3
20,24,6,4,9,5
20,25,0,0,8,8
20,25,1,1,3,2
20,25,2,2,10,8
20,25,3,3,7,4
20,25,4,3,10,7
20,25,5,1,5,4
20,25,6,2,6,4
20,26,0,2,4,2
20,26,1,5,9,4
20,26,2,1,3,2
20,26,3,0,2,2
20,26,4,0,3,3
20,26,5,4,9,5
20,26,6,2,7,5
20,27,0,1,4,3
20,27,1,2,4,2
20,27,2,4,8,4
20,27,3,2,8,6
20,27,4,1,6,5
20,27,5,3,5,2
20,27,6,1,4,3
20,28,0,0,3,3
20,28,1,1,6,5
20,28,2,4,11,7
20,28,3,0,5,5
20,28,4,4,7,3
20,28,5,1,8,7
20,28,6,0,3,3
20,29,0,6,8,2
20,29,1,1,5,4
20,29,2,6,6,0
20,29,3,0,4,4
20,29,4,2,5,3
20,29,5,1,3,2
20,29,6,11,16,5
20,30,0,1,6,5
20,30,1,1,2,1
20,30,2,4,7,3
20,30,3,1,2,1
20,30,4,5,8,3
20,30,5,1,6,5
20,30,6,2,3,1
20,31,0,1,5,4
20,31,1,5,9,4
20,31,2,2,5,3
20,31,3,2,4,2
20,31,4,25,32,7
20,31,5,1,2,1
20,31,6,4,12,8
20,32,0,1,4,3
20,32,1,4,10,6
20,32,2,0,7,7
20,32,3,2,4,2
20,32,4,21,32,11
20,32,5,1,6,5
20,32,6,1,10,9
20,33,0,8,10,2
20,33,1,5,8,3
20,33,2,1,4,3
20,33,3,2,6,4
20,33,4,9,18,9
20,33,5,1,1,0
20,33,6,0,3,3
20,34,0,7,9,2
20,34,1,10,15,5
20,34,2,4,7,3
20,34,3,2,7,5
20,34,4,21,25,4
20,34,5,2,5,3
20,34,6,2,11,9
20,35,0,7,14,7
20,35,1,4,8,4
20,35,2,1,6,5
20,35,3,2,14,12
20,35,4,17,25,8
20,35,5,4,10,6
20,35,6,1,7,6
20,36,0,13,23,10
20,36,1,3,12,9
20,36,2,4,11,7
20,36,3,8,14,6
20,36,4,26,38,12
20,36,5,5,15,10
20,36,6,9,16,7
20,37,0,16,26,10
20,37,1,15,19,4
20,37,2,10,19,9
20,37,3,6,12,6
20,37,4,9,20,11
20,37,5,7,17,10
20,37,6,9,22,13
20,38,0,10,20,10
20,38,1,8,17,9
20,38,2,7,20,13
20,38,3,4,15,11
20,38,4,41,61,20
20,38,5,2,13,11
20,38,6,8,20,12
20,39,0,2,50,48
20,39,1,3,48,45
20,39,2,2,38,36
20,39,3,1,49,48
20,39,4,39,71,32
20,39,5,1,28,27
20,39,6,2,20,18
20,40,0,6,96,90
20,40,1,1,57,56
20,40,2,2,75,73
20,40,3,2,62,60
20,40,4,49,120,71
20,40,5,12,53,41
20,40,6,8,34,26
20,41,0,2,94,92
20,41,1,1,66,65
20,41,2,2,84,82
20,41,3,2,58,56
20,41,4,39,108,69
20,41,5,8,40,32
20,41,6,9,46,37
20,42,0,5,151,146
20,42,1,4,122,118
20,42,2,4,153,149
20,42,3,5,141,136
20,42,4,29,154,125
20,42,5,10,65,55
20,42,6,2,57,55
20,43,0,6,253,247
20,43,1,3,207,204
20,43,2,4,198,194
20,43,3,5,205,200
20,43,4,9,164,155
20,43,5,10,104,94
20,43,6,5,70,65
20,44,0,7,293,286
20,44,1,4,275,271
20,44,2,4,262,258
20,44,3,17,305,288
20,44,4,20,233,213
20,44,5,7,109,102
20,44,6,19,88,69
20,45,0,13,398,385
20,45,1,13,327,314
20,45,2,10,386,376
20,45,3,18,391,373
20,45,4,23,275,252
20,45,5,4,150,146
20,45,6,26,141,115
20,46,0,51,549,498
20,46,1,11,476,465
20,46,2,24,507,483
20,46,3,43,536,493
20,46,4,15,371,356
20,46,5,7,196,189
20,46,6,31,172,141
20,47,0,310,941,631
20,47,1,101,707,606
20,47,2,85,711,626
20,47,3,147,797,650
20,47,4,26,462,436
20,47,5,17,251,234
20,47,6,11,144,133
20,48,0,796,1423,627
20,48,1,428,1177,749
20,48,2,447,1190,743
20,48,3,326,1031,705
20,48,4,184,742,558
20,48,5,9,290,281
20,48,6,10,203,193
20,49,0,946,1579,633
20,49,1,740,1427,687
20,49,2,668,1331,663
20,49,3,382,1101,719
20,49,4,291,751,460
20,49,5,20,308,288
20,49,6,10,197,187
20,50,0,642,1384,742
20,50,1,656,1373,717
20,50,2,337,1084,747
20,50,3,237,1045,808
20,50,4,169,725,556
20,50,5,16,310,294
20,50,6,8,195,187
20,51,0,782,1572,790
20,51,1,746,1617,871
20,51,2,418,1301,883
20,51,3,275,1125,850
20,51,4,211,856,645
20,51,5,38,404,366
20,51,6,8,262,254
20,52,0,857,1668,811
20,52,1,577,1438,861
20,52,2,402,1239,837
20,52,3,242,1143,901
20,52,4,149,733,584
20,52,5,68,434,366
20,52,6,15,254,239
20,53,0,353,1229,876
20,53,1,148,924,776
20,53,2,88,860,772
20,53,3,47,759,712
20,53,4,28,568,540
20,53,5,17,263,246
20,53,6,2,214,212
20,54,0,85,858,773
20,54,1,30,720,690
20,54,2,16,702,686
20,54,3,16,770,754
20,54,4,16,516,500
20,54,5,6,239,233
20,54,6,1,178,177
20,55,0,45,707,662
20,55,1,14,566,552
20,55,2,15,626,611
20,55,3,14,634,620
20,55,4,17,483,466
20,55,5,10,292,282
20,55,6,3,201,198
20,56,0,9,448,439
20,56,1,6,389,383
20,56,2,9,414,405
20,56,3,9,428,419
20,56,4,21,413,392
20,56,5,9,279,270
20,56,6,7,215,208
20,57,0,6,355,349
20,57,1,8,354,346
20,57,2,7,346,339
20,57,3,14,341,327
20,57,4,30,324,294
20,57,5,18,284,266
20,57,6,7,209,202
20,58,0,6,290,284
20,58,1,5,258,253
20,58,2,8,316,308
20,58,3,8,320,312
20,58,4,46,308,262
20,58,5,13,252,239
20,58,6,7,208,201
20,59,0,5,221,216
20,59,1,5,264,259
20,59,2,3,254,251
20,59,3,6,269,263
20,59,4,52,297,245
20,59,5,14,269,255
20,59,6,9,213,204
20,60,0,11,209,198
20,60,1,6,216,210
20,60,2,8,228,220
20,60,3,8,226,218
20,60,4,55,260,205
20,60,5,17,283,266
20,60,6,14,220,206
20,61,0,3,180,177
20,61,1,2,181,179
20,61,2,2,199,197
20,61,3,1,200,199
20,61,4,54,260,206
20,61,5,22,265,243
20,61,6,11,232,221
20,62,0,7,204,197
20,62,1,2,181,179
20,62,2,8,186,178
20,62,3,7,198,191
20,62,4,62,257,195
20,62,5,13,265,252
20,62,6,11,200,189
20,63,0,9,175,166
20,63,1,4,174,170
20,63,2,7,167,160
20,63,3,5,184,179
20,63,4,49,230,181
20,63,5,24,266,242
20,63,6,6,205,199
20,64,0,5,178,173
20,64,1,4,172,168
20,64,2,3,168,165
20,64,3,8,166,158
20,64,4,62,254,192
20,64,5,17,262,245
20,64,6,15,241,226
20,65,0,9,162,153
20,65,1,2,170,168
20,65,2,7,174,167
20,65,3,7,167,160
20,65,4,62,277,215
20,65,5,16,223,207
20,65,6,29,250,221
20,66,0,5,163,158
20,66,1,5,177,172
20,66,2,7,163,156
20,66,3,5,200,195
20,66,4,84,271,187
20,66,5,17,251,234
20,66,6,30,246,216
20,67,0,5,161,156
20,67,1,9,199,190
20,67,2,4,168,164
20,67,3,6,200,194
20,67,4,88,287,199
20,67,5,15,250,235
20,67,6,52,299,247
20,68,0,5,209,204
20,68,1,16,214,198
20,68,2,5,188,183
20,68,3,7,188,181
20,68,4,82,320,238
20,68,5,16,220,204
20,68,6,43,262,219
20,69,0,8,199,191
20,69,1,11,240,229
20,69,2,20,251,231
20,69,3,6,229,223
20,69,4,70,317,247
20,69,5,32,286,254
20,69,6,50,292,242
20,70,0,9,240,231
20,70,1,11,229,218
20,70,2,15,272,257
20,70,3,7,217,210
20,70,4,93,311,218
20,70,5,44,299,255
20,70,6,53,293,240
20,71,0,8,214,206
20,71,1,8,287,279
20,71,2,12,253,241
20,71,3,10,267,257
20,71,4,75,351,276
20,71,5,37,287,250
20,71,6,33,240,207
20,72,0,9,305,296
20,72,1,9,278,269
20,72,2,9,288,279
20,72,3,14,292,278
20,72,4,89,376,287
20,72,5,16,275,259
20,72,6,17,299,282
20,73,0,6,259,253
20,73,1,17,272,255
20,73,2,8,250,242
20,73,3,16,273,257
20,73,4,49,287,238
20,73,5,15,268,253
20,73,6,16,260,244
20,74,0,7,248,241
20,74,1,21,249,228
20,74,2,14,228,214
20,74,3,4,232,228
20,74,4,57,291,234
20,74,5,13,261,248
20,74,6,16,285,269
20,75,0,7,243,236
20,75,1,15,239,224
20,75,2,3,248,245
20,75,3,8,222,214
20,75,4,47,273,226
20,75,5,33,307,274
20,75,6,9,283,274
20,76,0,10,264,254
20,76,1,8,227,219
20,76,2,10,255,245
20,76,3,7,225,218
20,76,4,63,288,225
20,76,5,17,271,254
20,76,6,18,278,260
20,77,0,13,249,236
20,77,1,6,222,216
20,77,2,6,227,221
20,77,3,6,223,217
20,77,4,78,304,226
20,77,5,32,299,267
20,77,6,12,288,276
20,78,0,12,257,245
20,78,1,11,246,235
20,78,2,6,215,209
20,78,3,2,203,201
20,78,4,71,342,271
20,78,5,18,305,287
20,78,6,20,302,282
20,79,0,4,237,233
20,79,1,5,237,232
20,79,2,19,236,217
20,79,3,14,236,222
20,79,4,68,291,223
20,79,5,16,267,251
20,79,6,15,278,263
20,80,0,13,224,211
20,80,1,15,249,234
20,80,2,20,255,235
20,80,3,21,235,214
20,80,4,66,310,244
20,80,5,23,304,281
20,80,6,8,259,251
20,81,0,7,213,206
20,81,1,11,244,233
20,81,2,15,252,237
20,81,3,15,220,205
20,81,4,68,328,260
20,81,5,19,327,308
20,81,6,22,331,309
20,82,0,4,237,233
20,82,1,12,232,220
20,82,2,10,232,222
20,82,3,7,240,233
20,82,4,91,291,200
20,82,5,33,299,266
20,82,6,23,296,273
20,83,0,14,209,195
20,83,1,9,202,193
20,83,2,10,238,228
20,83,3,1,213,212
20,83,4,73,306,233
20,83,5,14,244,230
20,83,6,18,342,324
20,84,0,14,216,202
20,84,1,13,203,190
20,84,2,8,203,195
20,84,3,2,175,173
20,84,4,64,269,205
20,84,5,16,288,272
20,84,6,2,266,264
20,85,0,8,198,190
20,85,1,12,183,171
20,85,2,8,208,200
20,85,3,6,198,192
20,85,4,58,272,214
20,85,5,21,256,235
20,85,6,8,254,246
20,86,0,5,196,191
20,86,1,10,206,196
20,86,2,10,184,174
20,86,3,5,211,206
20,86,4,39,263,224
20,86,5,11,263,252
20,86,6,8,280,272
20,87,0,5,198,193
20,87,1,7,224,217
20,87,2,6,222,216
20,87,3,6,204,198
20,87,4,70,279,209
20,87,5,12,254,242
20,87,6,6,280,274
20,88,0,5,190,185
20,88,1,5,189,184
20,88,2,9,204,195
20,88,3,8,208,200
20,88,4,84,319,235
20,88,5,8,251,243
20,88,6,8,303,295
20,89,0,3,215,212
20,89,1,8,166,158
20,89,2,4,177,173
20,89,3,8,222,214
20,89,4,61,297,236
20,89,5,13,229,216
20,89,6,15,319,304
20,90,0,3,219,216
20,90,1,13,219,206
20,90,2,4,218,214
20,90,3,10,209,199
20,90,4,46,275,229
20,90,5,10,265,255
20,90,6,12,304,292
20,91,0,11,230,219
20,91,1,7,227,220
20,91,2,12,204,192
20,91,3,17,217,200
20,91,4,29,264,235
20,91,5,13,298,285
20,91,6,12,286,274
20,92,0,10,188,178
20,92,1,12,213,201
20,92,2,25,225,200
20,92,3,24,212,188
20,92,4,46,276,230
20,92,5,11,254,243
20,92,6,8,326,318
20,93,0,10,247,237
20,93,1,6,201,195
20,93,2,12,212,200
20,93,3,7,207,200
20,93,4,3,255,252
20,93,5,13,283,270
20,93,6,5,297,292
20,94,0,4,195,191
20,94,1,10,254,244
20,94,2,7,202,195
20,94,3,6,213,207
20,94,4,9,282,273
20,94,5,11,265,254
20,94,6,11,310,299
20,95,0,6,241,235
20,95,1,12,222,210
20,95,2,8,245,237
20,95,3,4,223,219
20,95,4,11,283,272
20,95,5,8,274,266
20,95,6,3,280,277
20,96,0,6,236,230
20,96,1,9,257,248
20,96,2,7,279,272
20,96,3,6,249,243
20,96,4,11,248,237
20,96,5,8,333,325
20,96,6,10,330,320
20,97,0,4,221,217
20,97,1,8,210,202
20,97,2,11,254,243
20,97,3,8,228,220
20,97,4,5,246,241
20,97,5,10,303,293
20,97,6,8,335,327
20,98,0,6,261,255
20,98,1,10,258,248
20,98,2,10,275,265
20,98,3,7,242,235
20,98,4,11,278,267
20,98,5,16,323,307
20,98,6,12,338,326
20,99,0,6,252,246
20,99,1,10,253,243
20,99,2,7,233,226
20,99,3,7,280,273
20,99,4,13,287,274
20,99,5,5,338,333
20,99,6,7,361,354
20,100,0,21,242,221
20,100,1,11,216,205
20,100,2,8,259,251
20,100,3,4,247,243
20,100,4,14,277,263
20,100,5,9,308,299
20,100,6,8,364,356
20,101,0,5,284,279
20,101,1,7,277,270
20,101,2,8,310,302
20,101,3,8,346,338
20,101,4,16,338,322
20,101,5,13,371,358
20,101,6,7,350,343
20,102,0,7,455,448
20,102,1,13,532,519
20,102,2,15,559,544
20,102,3,25,618,593
20,102,4,13,481,468
20,102,5,7,443,436
20,102,6,12,370,358
20,103,0,9,401,392
20,103,1,12,459,447
20,103,2,18,429,411
20,103,3,14,459,445
20,103,4,21,433,412
20,103,5,12,450,438
20,103,6,13,384,371
20,104,0,3,420,417
20,104,1,13,467,454
20,104,2,25,553,528
20,104,3,19,499,480
20,104,4,22,441,419
20,104,5,11,395,384
20,104,6,9,412,403
20,105,0,29,827,798
20,105,1,22,878,856
20,105,2,257,1144,887
20,105,3,51,997,946
20,105,4,35,768,733
20,105,5,19,527,508
20,105,6,8,497,489
20,106,0,27,819,792
20,106,1,30,803,773
20,106,2,259,994,735
20,106,3,112,893,781
20,106,4,56,748,692
20,106,5,13,479,466
20,106,6,11,429,418
20,107,0,17,682,665
20,107,1,18,718,700
20,107,2,219,926,707
20,107,3,100,875,775
20,107,4,83,722,639
20,107,5,14,448,434
20,107,6,10,374,364
20,108,0,53,1157,1104
20,108,1,92,1221,1129
20,108,2,445,1518,1073
20,108,3,275,1396,1121
20,108,4,358,1297,939
20,108,5,21,610,589
20,108,6,11,453,442
20,109,0,160,1274,1114
20,109,1,188,1163,975
20,109,2,375,1311,936
20,109,3,287,1282,995
20,109,4,535,1426,891
20,109,5,11,522,511
20,109,6,10,420,410
20,110,0,59,885,826
20,110,1,86,882,796
20,110,2,254,1091,837
20,110,3,384,1199,815
20,110,4,269,1081,812
20,110,5,15,424,409
20,110,6,6,387,381
20,111,0,24,776,752
20,111,1,32,763,731
20,111,2,171,923,752
20,111,3,121,976,855
20,111,4,146,902,756
20,111,5,11,439,428
20,111,6,13,382,369
20,112,0,12,632,620
20,112,1,17,661,644
20,112,2,124,794,670
20,112,3,16,693,677
20,112,4,38,674,636
20,112,5,17,376,359
20,112,6,9,343,334
20,113,0,17,632,615
20,113,1,19,588,569
20,113,2,38,665,627
20,113,3,25,650,625
20,113,4,16,551,535
20,113,5,6,354,348
20,113,6,13,313,300
20,114,0,18,564,546
20,114,1,7,534,527
20,114,2,31,593,562
20,114,3,18,615,597
20,114,4,26,521,495
20,114,5,5,268,263
20,114,6,6,327,321
20,115,0,13,484,471
20,115,1,10,540,530
20,115,2,21,592,571
20,115,3,14,514,500
20,115,4,19,462,443
20,115,5,5,311,306
20,115,6,5,292,287
20,116,0,17,497,480
20,116,1,9,471,462
20,116,2,15,539,524
20,116,3,17,511,494
20,116,4,14,452,438
20,116,5,10,265,255
20,116,6,7,239,232
20,117,0,16,538,522
20,117,1,11,451,440
20,117,2,18,484,466
20,117,3,13,482,469
20,117,4,10,415,405
20,117,5,8,235,227
20,117,6,11,223,212
20,118,0,13,464,451
20,118,1,18,434,416
20,118,2,11,503,492
20,118,3,14,460,446
20,118,4,9,366,357
20,118,5,6,254,248
20,118,6,5,232,227
20,119,0,24,432,408
20,119,1,15,437,422
20,119,2,16,507,491
20,119,3,11,433,422
20,119,4,11,343,332
20,119,5,8,251,243
20,119,6,6,249,243
20,120,0,14,514,500
20,120,1,26,566,540
20,120,2,7,522,515
20,120,3,15,538,523
20,120,4,14,388,374
20,120,5,9,256,247
20,120,6,8,289,281
20,121,0,21,503,482
20,121,1,16,457,441
20,121,2,21,525,504
20,121,3,14,502,488
20,121,4,10,372,362
20,121,5,6,245,239
20,121,6,6,258,252
20,122,0,12,473,461
20,122,1,15,433,418
20,122,2,18,504,486
20,122,3,14,518,504
20,122,4,13,299,286
20,122,5,8,206,198
20,122,6,9,266,257
20,123,0,20,560,540
20,123,1,17,619,602
20,123,2,20,637,617
20,123,3,14,536,522
20,123,4,17,354,337
20,123,5,9,241,232
20,123,6,7,233,226
20,124,0,22,555,533
20,124,1,29,603,574
20,124,2,21,586,565
20,124,3,21,547,526
20,124,4,13,327,314
20,124,5,9,241,232
20,124,6,1,212,211
20,125,0,22,570,548
20,125,1,16,599,583
20,125,2,23,527,504
20,125,3,20,539,519
20,125,4,14,315,301
20,125,5,3,258,255
20,125,6,10,256,246
20,126,0,24,597,573
20,126,1,17,680,663
20,126,2,23,622,599
20,126,3,27,674,647
20,126,4,13,333,320
20,126,5,13,285,272
20,126,6,10,278,268
20,127,0,33,595,562
20,127,1,44,647,603
20,127,2,18,573,555
20,127,3,23,577,554
20,127,4,11,356,345
20,127,5,9,230,221
20,127,6,6,274,268
20,128,0,37,500,463
20,128,1,34,550,516
20,128,2,18,540,522
20,128,3,12,461,449
20,128,4,13,325,312
20,128,5,8,241,233
20,128,6,7,257,250
20,129,0,19,532,513
20,129,1,30,551,521
20,129,2,11,466,455
20,129,3,21,522,501
20,129,4,11,341,330
20,129,5,11,273,262
20,129,6,2,286,284
20,130,0,12,449,437
20,130,1,15,437,422
20,130,2,9,381,372
20,130,3,12,446,434
20,130,4,14,316,302
20,130,5,5,229,224
20,130,6,7,236,229
20,131,0,16,399,383
20,131,1,11,389,378
20,131,2,13,357,344
20,131,3,13,383,370
20,131,4,5,270,265
20,131,5,9,241,232
20,131,6,7,217,210
20,132,0,14,415,401
20,132,1,16,399,383
20,132,2,7,376,369
20,132,3,16,424,408
20,132,4,17,327,310
20,132,5,16,252,236
20,132,6,9,215,206
20,133,0,11,337,326
20,133,1,12,363,351
20,133,2,5,316,311
20,133,3,11,324,313
20,133,4,15,253,238
20,133,5,56,280,224
20,133,6,7,167,160
20,134,0,10,267,257
20,134,1,8,276,268
20,134,2,11,249,238
20,134,3,12,272,260
20,134,4,7,237,230
20,134,5,17,203,186
20,134,6,3,203,200
20,135,0,10,254,244
20,135,1,7,274,267
20,135,2,5,248,243
20,135,3,12,293,281
20,135,4,1,191,190
20,135,5,6,201,195
20,135,6,2,184,182
20,136,0,6,241,235
20,136,1,12,231,219
20,136,2,8,243,235
20,136,3,16,251,235
20,136,4,4,172,168
20,136,5,4,146,142
20,136,6,3,138,135
20,137,0,7,203,196
20,137,1,10,223,213
20,137,2,11,196,185
20,137,3,8,216,208
20,137,4,3,154,151
20,137,5,7,175,168
20,137,6,6,156,150
20,138,0,2,159,157
20,138,1,8,194,186
20,138,2,3,176,173
20,138,3,11,184,173
20,138,4,4,135,131
20,138,5,7,159,152
20,138,6,16,164,148
20,139,0,4,124,120
20,139,1,18,189,171
20,139,2,5,132,127
20,139,3,6,179,173
20,139,4,4,118,114
20,139,5,4,134,130
20,139,6,11,130,119
20,140,0,8,132,124
20,140,1,9,136,127
20,140,2,8,118,110
20,140,3,8,154,146
20,140,4,3,85,82
20,140,5,4,98,94
20,140,6,6,98,92
20,141,0,12,116,104
20,141,1,4,101,97
20,141,2,9,140,131
20,141,3,7,123,116
20,141,4,6,95,89
20,141,5,1,87,86
20,141,6,10,94,84
20,142,0,6,94,88
20,142,1,3,64,61
20,142,2,9,107,98
20,142,3,7,99,92
20,142,4,3,71,68
20,142,5,4,65,61
20,142,6,8,76,68
20,143,0,4,72,68
20,143,1,2,66,64
20,143,2,5,93,88
20,143,3,2,83,81
20,143,4,0,73,73
20,143,5,7,68,61
20,143,6,10,61,51
21,0,0,20,108,88
21,0,1,47,144,97
21,0,2,13,99,86
21,0,3,14,109,95
21,0,4,26,137,111
21,0,5,4,86,82
21,0,6,2,96,94
21,1,0,5,48,43
21,1,1,5,40,35
21,1,2,7,41,34
21,1,3,3,40,37
21,1,4,11,70,59
21,1,5,1,46,45
21,1,6,3,54,51
21,2,0,4,49,45
21,2,1,1,17,16
21,2,2,5,31,26
21,2,3,0,31,31
21,2,4,4,66,62
21,2,5,4,50,46
21,2,6,0,50,50
21,3,0,0,29,29
21,3,1,0,32,32
21,3,2,0,38,38
21,3,3,6,35,29
21,3,4,3,83,80
21,3,5,5,51,46
21,3,6,1,49,48
21,4,0,5,38,33
21,4,1,1,20,19
21,4,2,1,34,33
21,4,3,1,20,19
21,4,4,4,56,52
21,4,5,3,30,27
21,4,6,2,35,33
21,5,0,1,30,29
21,5,1,2,19,17
21,5,2,0,10,10
21,5,3,0,12,12
21,5,4,3,45,42
21,5,5,2,29,27
21,5,6,2,36,34
21,6,0,1,45,44
21,6,1,6,30,24
21,6,2,2,23,21
21,6,3,0,25,25
21,6,4,0,53,53
21,6,5,5,48,43
21,6,6,3,41,38
21,7,0,1,19,18
21,7,1,2,16,14
21,7,2,1,16,15
21,7,3,5,13,8
21,7,4,3,41,38
21,7,5,2,30,28
21,7,6,0,17,17
21,8,0,0,19,19
21,8,1,0,12,12
21,8,2,2,13,11
21,8,3,2,20,18
21,8,4,1,34,33
21,8,5,3,30,27
21,8,6,0,33,33
21,9,0,2,13,11
21,9,1,0,10,10
21,9,2,1,13,12
21,9,3,1,22,21
21,9,4,2,37,35
21,9,5,1,14,13
21,9,6,2,35,33
21,10,0,1,6,5
21,10,1,0,8,8
21,10,2,2,13,11
21,10,3,2,12,10
21,10,4,3,35,32
21,10,5,2,13,11
21,10,6,10,46,36
21,11,0,1,8,7
21,11,1,2,9,7
21,11,2,2,10,8
21,11,3,2,19,17
21,11,4,3,26,23
21,11,5,4,19,15
21,11,6,9,19,10
21,12,0,3,12,9
21,12,1,2,8,6
21,12,2,1,6,5
21,12,3,0,8,8
21,12,4,1,25,24
21,12,5,0,13,13
21,12,6,2,17,15
21,13,0,1,4,3
21,13,1,3,9,6
21,13,2,4,13,9
21,13,3,1,13,12
21,13,4,0,22,22
21,13,5,0,14,14
21,13,6,1,12,11
21,14,0,2,8,6
21,14,1,0,5,5
21,14,2,0,7,7
21,14,3,0,8,8
21,14,4,1,26,25
21,14,5,3,18,15
21,14,6,2,15,13
21,15,0,1,6,5
21,15,1,1,11,10
21,15,2,0,5,5
21,15,3,4,10,6
21,15,4,1,19,18
21,15,5,1,18,17
21,15,6,0,3,3
21,16,0,0,7,7
21,16,1,2,6,4
21,16,2,0,8,8
21,16,3,1,12,11
21,16,4,1,19,18
21,16,5,0,6,6
21,16,6,1,14,13
21,17,0,0,4,4
21,17,1,3,5,2
21,17,2,0,10,10
21,17,3,8,15,7
21,17,4,3,15,12
21,17,5,0,8,8
21,17,6,3,9,6
21,18,0,0,2,2
21,18,1,0,5,5
21,18,2,2,11,9
21,18,3,0,5,5
21,18,4,1,12,11
21,18,5,1,10,9
21,18,6,7,19,12
21,19,0,0,3,3
21,19,1,1,3,2
21,19,2,5,11,6
21,19,3,1,5,4
21,19,4,3,11,8
21,19,5,3,8,5
21,19,6,1,7,6
21,20,0,0,4,4
21,20,1,2,6,4
21,20,2,0,5,5
21,20,3,0,4,4
21,20,4,2,7,5
21,20,5,0,4,4
21,20,6,1,9,8
21,21,0,0,4,4
21,21,1,1,7,6
21,21,2,1,3,2
21,21,3,1,4,3
21,21,4,0,6,6
21,21,5,4,13,9
21,21,6,5,11,6
21,22,0,0,2,2
21,22,1,1,1,0
21,22,2,0,2,2
21,22,3,2,5,3
21,22,4,1,10,9
21,22,5,5,15,10
21,22,6,6,14,8
21,23,1,1,3,2
21,23,3,6,10,4
21,23,4,2,8,6
21,23,5,6,17,11
21,23,6,1,8,7
21,24,0,0,2,2
21,24,1,0,3,3
21,24,2,0,1,1
21,24,3,5,10,5
21,24,4,0,7,7
21,24,5,6,10,4
21,24,6,0,4,4
21,25,0,0,3,3
21,25,1,2,4,2
21,25,2,0,1,1
21,25,3,1,4,3
21,25,4,0,4,4
21,25,5,1,1,0
21,25,6,0,3,3
21,26,0,1,3,2
21,26,1,0,5,5
21,26,2,0,3,3
21,26,3,4,12,8
21,26,4,1,6,5
21,26,5,0,6,6
21,26,6,0,5,5
21,27,0,0,2,2
21,27,2,1,3,2
21,27,3,8,14,6
21,27,4,0,7,7
21,27,5,1,3,2
21,27,6,0,4,4
21,28,1,1,3,2
21,28,2,3,6,3
21,28,3,0,3,3
21,28,4,1,7,6
21,28,5,2,9,7
21,28,6,1,1,0
21,29,0,1,3,2
21,29,1,2,6,4
21,29,2,0,3,3
21,29,3,2,3,1
21,29,4,3,9,6
21,29,5,2,12,10
21,29,6,2,7,5
21,30,0,4,9,5
21,30,1,0,2,2
21,30,2,0,2,2
21,30,3,1,5,4
21,30,4,2,7,5
21,30,5,0,4,4
21,30,6,2,7,5
21,31,1,0,3,3
21,31,2,3,4,1
21,31,3,2,12,10
21,31,4,0,2,2
21,31,5,0,5,5
21,31,6,0,6,6
21,32,0,0,6,6
21,32,1,3,9,6
21,32,2,2,6,4
21,32,3,1,10,9
21,32,4,0,7,7
21,32,5,5,8,3
21,32,6,3,11,8
21,33,0,0,6,6
21,33,1,4,9,5
21,33,2,2,7,5
21,33,3,2,9,7
21,33,4,6,16,10
21,33,5,9,12,3
21,33,6,5,9,4
21,34,0,0,6,6
21,34,1,1,9,8
21,34,2,3,12,9
21,34,3,4,12,8
21,34,4,11,21,10
21,34,5,6,18,12
21,34,6,8,16,8
21,35,0,2,12,10
21,35,1,8,16,8
21,35,2,5,18,13
21,35,3,6,11,5
21,35,4,16,41,25
21,35,5,8,20,12
21,35,6,4,11,7
21,36,0,9,23,14
21,36,1,14,28,14
21,36,2,7,19,12
21,36,3,2,17,15
21,36,4,26,40,14
21,36,5,4,21,17
21,36,6,6,19,13
21,37,0,8,24,16
21,37,1,11,27,16
21,37,2,8,28,20
21,37,3,14,32,18
21,37,4,20,50,30
21,37,5,2,19,17
21,37,6,2,16,14
21,38,0,12,33,21
21,38,1,9,45,36
21,38,2,10,44,34
21,38,3,6,33,27
21,38,4,17,54,37
21,38,5,0,23,23
21,38,6,3,23,20
21,39,0,4,68,64
21,39,1,4,47,43
21,39,2,1,40,39
21,39,3,3,51,48
21,39,4,5,53,48
21,39,5,3,42,39
21,39,6,1,32,31
21,40,0,3,63,60
21,40,1,1,52,51
21,40,2,0,60,60
21,40,3,2,86,84
21,40,4,3,61,58
21,40,5,1,62,61
21,40,6,4,51,47
21,41,0,2,90,88
21,41,1,6,88,82
21,41,2,1,97,96
21,41,3,2,93,91
21,41,4,6,94,88
21,41,5,1,49,48
21,41,6,3,56,53
21,42,0,8,178,170
21,42,1,1,157,156
21,42,2,4,171,167
21,42,3,4,182,178
21,42,4,4,137,133
21,42,5,3,71,68
21,42,6,2,89,87
21,43,0,5,251,246
21,43,1,2,190,188
21,43,2,6,205,199
21,43,3,8,210,202
21,43,4,12,198,186
21,43,5,1,108,107
21,43,6,2,86,84
21,44,0,4,327,323
21,44,1,8,319,311
21,44,2,7,342,335
21,44,3,4,344,340
21,44,4,9,207,198
21,44,5,5,158,153
21,44,6,7,122,115
21,45,0,13,458,445
21,45,1,12,436,424
21,45,2,4,446,442
21,45,3,13,492,479
21,45,4,11,337,326
21,45,5,3,237,234
21,45,6,3,162,159
21,46,0,15,537,522
21,46,1,14,523,509
21,46,2,7,534,527
21,46,3,47,587,540
21,46,4,5,429,424
21,46,5,4,236,232
21,46,6,4,207,203
21,47,0,11,468,457
21,47,1,14,482,468
21,47,2,5,527,522
21,47,3,43,575,532
21,47,4,2,380,378
21,47,5,2,226,224
21,47,6,3,181,178
21,48,0,20,778,758
21,48,1,21,750,729
21,48,2,19,763,744
21,48,3,172,910,738
21,48,4,10,565,555
21,48,5,6,335,329
21,48,6,2,243,241
21,49,0,313,1070,757
21,49,1,250,1054,804
21,49,2,89,921,832
21,49,3,212,1019,807
21,49,4,41,682,641
21,49,5,9,399,390
21,49,6,8,297,289
21,50,0,78,694,616
21,50,1,65,671,606
21,50,2,15,606,591
21,50,3,74,696,622
21,50,4,8,458,450
21,50,5,11,292,281
21,50,6,5,250,245
21,51,0,15,705,690
21,51,1,18,682,664
21,51,2,13,670,657
21,51,3,31,736,705
21,51,4,9,534,525
21,51,5,4,367,363
21,51,6,4,330,326
21,52,0,152,932,780
21,52,1,97,918,821
21,52,2,69,859,790
21,52,3,146,974,828
21,52,4,22,597,575
21,52,5,18,435,417
21,52,6,9,344,335
21,53,0,48,561,513
21,53,1,44,599,555
21,53,2,41,545,504
21,53,3,37,559,522
21,53,4,8,417,409
21,53,5,16,298,282
21,53,6,3,235,232
21,54,0,3,361,358
21,54,1,5,342,337
21,54,2,7,378,371
21,54,3,6,408,402
21,54,4,8,291,283
21,54,5,10,261,251
21,54,6,9,191,182
21,55,0,8,302,294
21,55,1,4,294,290
21,55,2,7,300,293
21,55,3,1,273,272
21,55,4,6,282,276
21,55,5,3,243,240
21,55,6,4,187,183
21,56,0,21,246,225
21,56,1,8,285,277
21,56,2,7,293,286
21,56,3,12,305,293
21,56,4,4,276,272
21,56,5,2,220,218
21,56,6,5,189,184
21,57,0,4,228,224
21,57,1,7,253,246
21,57,2,9,234,225
21,57,3,6,286,280
21,57,4,8,258,250
21,57,5,8,273,265
21,57,6,4,175,171
21,58,0,9,282,273
21,58,1,15,271,256
21,58,2,7,292,285
21,58,3,8,292,284
21,58,4,9,251,242
21,58,5,9,279,270
21,58,6,7,224,217
21,59,0,7,173,166
21,59,1,7,205,198
21,59,2,5,230,225
21,59,3,11,225,214
21,59,4,5,220,215
21,59,5,2,210,208
21,59,6,5,184,179
21,60,0,4,159,155
21,60,1,2,166,164
21,60,2,6,205,199
21,60,3,6,186,180
21,60,4,1,209,208
21,60,5,3,179,176
21,60,6,5,160,155
21,61,0,3,189,186
21,61,1,7,176,169
21,61,2,10,160,150
21,61,3,3,184,181
21,61,4,3,179,176
21,61,5,8,181,173
21,61,6,7,189,182
21,62,0,4,162,158
21,62,1,6,144,138
21,62,2,5,166,161
21,62,3,6,171,165
21,62,4,9,172,163
21,62,5,4,182,178
21,62,6,5,178,173
21,63,0,2,153,151
21,63,1,7,168,161
21,63,2,3,161,158
21,63,3,4,170,166
21,63,4,9,183,174
21,63,5,4,178,174
21,63,6,4,214,210
21,64,0,3,204,201
21,64,1,5,162,157
21,64,2,6,171,165
21,64,3,2,151,149
21,64,4,5,234,229
21,64,5,5,190,185
21,64,6,6,173,167
21,65,0,9,144,135
21,65,1,6,165,159
21,65,2,9,170,161
21,65,3,2,207,205
21,65,4,14,201,187
21,65,5,1,205,204
21,65,6,4,186,182
21,66,0,2,170,168
21,66,1,7,137,130
21,66,2,5,193,188
21,66,3,4,198,194
21,66,4,11,213,202
21,66,5,4,202,198
21,66,6,14,191,177
21,67,0,3,191,188
21,67,1,6,172,166
21,67,2,6,223,217
21,67,3,5,214,209
21,67,4,11,232,221
21,67,5,10,217,207
21,67,6,11,217,206
21,68,0,16,206,190
21,68,1,6,194,188
21,68,2,8,198,190
21,68,3,6,208,202
21,68,4,17,227,210
21,68,5,2,202,200
21,68,6,6,197,191
21,69,0,11,234,223
21,69,1,13,224,211
21,69,2,21,234,213
21,69,3,13,247,234
21,69,4,27,261,234
21,69,5,9,207,198
21,69,6,6,228,222
21,70,0,5,192,187
21,70,1,5,218,213
21,70,2,35,250,215
21,70,3,4,201,197
21,70,4,33,245,212
21,70,5,1,209,208
21,70,6,9,247,238
21,71,0,9,212,203
21,71,1,6,216,210
21,71,2,15,254,239
21,71,3,7,248,241
21,71,4,18,235,217
21,71,5,16,244,228
21,71,6,7,230,223
21,72,0,8,231,223
21,72,1,6,222,216
21,72,2,7,259,252
21,72,3,11,228,217
21,72,4,12,287,275
21,72,5,7,239,232
21,72,6,4,230,226
21,73,0,3,197,194
21,73,1,2,192,190
21,73,2,6,216,210
21,73,3,9,224,215
21,73,4,9,219,210
21,73,5,6,225,219
21,73,6,8,224,216
21,74,0,9,211,202
21,74,1,5,200,195
21,74,2,8,228,220
21,74,3,10,227,217
21,74,4,12,265,253
21,74,5,8,217,209
21,74,6,2,241,239
21,75,0,5,220,215
21,75,1,5,243,238
21,75,2,12,270,258
21,75,3,9,255,246
21,75,4,9,293,284
21,75,5,6,245,239
21,75,6,8,256,248
21,76,0,12,277,265
21,76,1,8,235,227
21,76,2,9,224,215
21,76,3,7,231,224
21,76,4,20,284,264
21,76,5,3,223,220
21,76,6,5,246,241
21,77,0,14,231,217
21,77,1,15,273,258
21,77,2,13,282,269
21,77,3,5,239,234
21,77,4,6,271,265
21,77,5,5,236,231
21,77,6,2,231,229
21,78,0,12,252,240
21,78,1,14,260,246
21,78,2,11,293,282
21,78,3,4,256,252
21,78,4,5,234,229
21,78,5,6,233,227
21,78,6,11,288,277
21,79,0,5,230,225
21,79,1,6,253,247
21,79,2,7,253,246
21,79,3,6,262,256
21,79,4,11,265,254
21,79,5,9,229,220
21,79,6,8,267,259
21,80,0,4,225,221
21,80,1,8,228,220
21,80,2,8,220,212
21,80,3,9,213,204
21,80,4,9,262,253
21,80,5,7,234,227
21,80,6,6,244,238
21,81,0,7,201,194
21,81,1,12,230,218
21,81,2,6,231,225
21,81,3,6,217,211
21,81,4,11,248,237
21,81,5,12,224,212
21,81,6,6,227,221
21,82,0,11,203,192
21,82,1,6,205,199
21,82,2,6,191,185
21,82,3,7,226,219
21,82,4,6,222,216
21,82,5,7,228,221
21,82,6,3,258,255
21,83,0,7,181,174
21,83,1,9,202,193
21,83,2,10,240,230
21,83,3,16,208,192
21,83,4,12,283,271
21,83,5,5,213,208
21,83,6,6,281,275
21,84,0,7,176,169
21,84,1,6,221,215
21,84,2,7,204,197
21,84,3,12,234,222
21,84,4,7,261,254
21,84,5,6,230,224
21,84,6,8,271,263
21,85,0,4,201,197
21,85,1,6,209,203
21,85,2,11,227,216
21,85,3,6,207,201
21,85,4,4,233,229
21,85,5,10,221,211
21,85,6,3,231,228
21,86,0,12,164,152
21,86,1,7,211,204
21,86,2,12,195,183
21,86,3,12,191,179
21,86,4,6,238,232
21,86,5,15,240,225
21,86,6,6,276,270
21,87,0,4,170,166
21,87,1,4,192,188
21,87,2,8,212,204
21,87,3,6,219,213
21,87,4,9,239,230
21,87,5,7,246,239
21,87,6,2,249,247
21,88,0,3,175,172
21,88,1,8,200,192
21,88,2,5,215,210
21,88,3,32,256,224
21,88,4,11,272,261
21,88,5,3,204,201
21,88,6,3,249,246
21,89,0,5,164,159
21,89,1,4,174,170
21,89,2,9,201,192
21,89,3,27,238,211
21,89,4,13,258,245
21,89,5,5,191,186
21,89,6,5,239,234
21,90,0,9,202,193
21,90,1,9,214,205
21,90,2,19,231,212
21,90,3,51,280,229
21,90,4,4,248,244
21,90,5,5,234,229
21,90,6,12,290,278
21,91,0,9,216,207
21,91,1,20,248,228
21,91,2,25,240,215
21,91,3,64,316,252
21,91,4,11,237,226
21,91,5,9,230,221
21,91,6,2,279,277
21,92,0,9,227,218
21,92,1,8,242,234
21,92,2,33,259,226
21,92,3,57,298,241
21,92,4,10,231,221
21,92,5,7,213,206
21,92,6,7,238,231
21,93,0,13,256,243
21,93,1,8,247,239
21,93,2,8,239,231
21,93,3,6,228,222
21,93,4,16,304,288
21,93,5,4,221,217
21,93,6,7,267,260
21,94,0,4,219,215
21,94,1,8,248,240
21,94,2,5,267,262
21,94,3,4,221,217
21,94,4,9,253,244
21,94,5,8,236,228
21,94,6,7,255,248
21,95,0,13,251,238
21,95,1,2,211,209
21,95,2,3,237,234
21,95,3,11,217,206
21,95,4,7,245,238
21,95,5,5,221,216
21,95,6,5,271,266
21,96,0,6,246,240
21,96,1,10,246,236
21,96,2,8,253,245
21,96,3,11,241,230
21,96,4,10,246,236
21,96,5,12,256,244
21,96,6,4,283,279
21,97,0,3,256,253
21,97,1,8,245,237
21,97,2,8,263,255
21,97,3,5,252,247
21,97,4,9,256,247
21,97,5,1,225,224
21,97,6,9,309,300
21,98,0,7,249,242
21,98,1,5,237,232
21,98,2,14,257,243
21,98,3,8,271,263
21,98,4,12,276,264
21,98,5,10,252,242
21,98,6,10,300,290
21,99,0,10,281,271
21,99,1,11,295,284
21,99,2,15,308,293
21,99,3,11,325,314
21,99,4,7,305,298
21,99,5,14,248,234
21,99,6,9,374,365
21,100,0,10,265,255
21,100,1,11,282,271
21,100,2,8,283,275
21,100,3,16,292,276
21,100,4,7,275,268
21,100,5,6,289,283
21,100,6,3,272,269
21,101,0,11,243,232
21,101,1,4,247,243
21,101,2,8,252,244
21,101,3,9,253,244
21,101,4,6,264,258
21,101,5,17,256,239
21,101,6,6,292,286
21,102,0,12,366,354
21,102,1,10,341,331
21,102,2,18,366,348
21,102,3,9,354,345
21,102,4,10,357,347
21,102,5,9,324,315
21,102,6,12,357,345
21,103,0,13,351,338
21,103,1,11,341,330
21,103,2,8,361,353
21,103,3,4,326,322
21,103,4,17,335,318
21,103,5,12,335,323
21,103,6,5,325,320
21,104,0,13,337,324
21,104,1,8,327,319
21,104,2,23,332,309
21,104,3,22,327,305
21,104,4,7,358,351
21,104,5,12,318,306
21,104,6,8,313,305
21,105,0,19,495,476
21,105,1,11,541,530
21,105,2,12,497,485
21,105,3,14,500,486
21,105,4,17,478,461
21,105,5,16,376,360
21,105,6,10,376,366
21,106,0,21,530,509
21,106,1,12,503,491
21,106,2,24,521,497
21,106,3,9,450,441
21,106,4,17,425,408
21,106,5,4,341,337
21,106,6,5,369,364
21,107,0,7,365,358
21,107,1,7,465,458
21,107,2,15,386,371
21,107,3,11,417,406
21,107,4,11,407,396
21,107,5,11,316,305
21,107,6,12,369,357
21,108,0,10,481,471
21,108,1,11,577,566
21,108,2,13,539,526
21,108,3,15,511,496
21,108,4,10,461,451
21,108,5,9,366,357
21,108,6,7,358,351
21,109,0,6,507,501
21,109,1,17,492,475
21,109,2,9,463,454
21,109,3,9,476,467
21,109,4,14,405,391
21,109,5,6,353,347
21,109,6,8,325,317
21,110,0,17,379,362
21,110,1,9,387,378
21,110,2,14,444,430
21,110,3,12,336,324
21,110,4,10,368,358
21,110,5,4,296,292
21,110,6,7,316,309
21,111,0,7,370,363
21,111,1,5,393,388
21,111,2,14,402,388
21,111,3,19,432,413
21,111,4,10,370,360
21,111,5,11,263,252
21,111,6,8,303,295
21,112,0,11,354,343
21,112,1,23,347,324
21,112,2,8,338,330
21,112,3,13,332,319
21,112,4,6,317,311
21,112,5,8,277,269
21,112,6,6,250,244
21,113,0,11,303,292
21,113,1,16,312,296
21,113,2,9,321,312
21,113,3,15,351,336
21,113,4,10,297,287
21,113,5,19,291,272
21,113,6,12,291,279
21,114,0,6,274,268
21,114,1,12,298,286
21,114,2,11,285,274
21,114,3,7,312,305
21,114,4,4,261,257
21,114,5,12,241,229
21,114,6,4,255,251
21,115,0,8,273,265
21,115,1,9,284,275
21,115,2,11,272,261
21,115,3,4,266,262
21,115,4,9,286,277
21,115,5,12,218,206
21,115,6,9,262,253
21,116,0,12,259,247
21,116,1,7,281,274
21,116,2,10,277,267
21,116,3,7,235,228
21,116,4,9,270,261
21,116,5,7,219,212
21,116,6,17,264,247
21,117,0,8,300,292
21,117,1,11,291,280
21,117,2,10,338,328
21,117,3,4,225,221
21,117,4,6,244,238
21,117,5,7,226,219
21,117,6,15,243,228
21,118,0,6,226,220
21,118,1,12,290,278
21,118,2,3,255,252
21,118,3,5,218,213
21,118,4,8,263,255
21,118,5,6,221,215
21,118,6,7,266,259
21,119,0,11,244,233
21,119,1,9,257,248
21,119,2,7,250,243
21,119,3,5,202,197
21,119,4,16,272,256
21,119,5,3,193,190
21,119,6,10,243,233
21,120,0,5,275,270
21,120,1,8,273,265
21,120,2,8,315,307
21,120,3,7,253,246
21,120,4,8,266,258
21,120,5,10,235,225
21,120,6,9,270,261
21,121,0,10,255,245
21,121,1,5,239,234
21,121,2,6,270,264
21,121,3,11,254,243
21,121,4,5,257,252
21,121,5,10,249,239
21,121,6,6,236,230
21,122,0,13,233,220
21,122,1,10,219,209
21,122,2,6,261,255
21,122,3,5,241,236
21,122,4,7,256,249
21,122,5,3,216,213
21,122,6,8,234,226
21,123,0,7,303,296
21,123,1,9,293,284
21,123,2,11,273,262
21,123,3,4,235,231
21,123,4,6,251,245
21,123,5,3,216,213
21,123,6,6,241,235
21,124,0,7,275,268
21,124,1,7,267,260
21,124,2,4,241,237
21,124,3,8,220,212
21,124,4,6,265,259
21,124,5,8,169,161
21,124,6,10,233,223
21,125,0,7,224,217
21,125,1,8,268,260
21,125,2,4,218,214
21,125,3,7,216,209
21,125,4,11,240,229
21,125,5,8,204,196
21,125,6,6,192,186
21,126,0,4,318,314
21,126,1,12,322,310
21,126,2,19,367,348
21,126,3,11,308,297
21,126,4,9,291,282
21,126,5,4,234,230
21,126,6,14,281,267
21,127,0,7,274,267
21,127,1,4,274,270
21,127,2,5,316,311
21,127,3,7,229,222
21,127,4,8,287,279
21,127,5,7,222,215
21,127,6,11,248,237
21,128,0,9,230,221
21,128,1,7,233,226
21,128,2,2,276,274
21,128,3,5,228,223
21,128,4,11,263,252
21,128,5,4,219,215
21,128,6,9,249,240
21,129,0,4,226,222
21,129,1,9,256,247
21,129,2,4,262,258
21,129,3,3,236,233
21,129,4,2,256,254
21,129,5,1,192,191
21,129,6,6,231,225
21,130,0,6,242,236
21,130,1,5,234,229
21,130,2,3,241,238
21,130,3,7,203,196
21,130,4,4,231,227
21,130,5,9,210,201
21,130,6,5,202,197
21,131,0,3,197,194
21,131,1,4,228,224
21,131,2,12,227,215
21,131,3,5,189,184
21,131,4,5,269,264
21,131,5,7,225,218
21,131,6,10,191,181
21,132,0,5,227,222
21,132,1,7,228,221
21,132,2,13,244,231
21,132,3,5,191,186
21,132,4,6,271,265
21,132,5,11,271,260
21,132,6,8,211,203
21,133,0,4,178,174
21,133,1,6,214,208
21,133,2,7,216,209
21,133,3,3,187,184
21,133,4,6,188,182
21,133,5,10,243,233
21,133,6,9,199,190
21,134,0,6,152,146
21,134,1,3,175,172
21,134,2,2,169,167
21,134,3,4,148,144
21,134,4,6,189,183
21,134,5,14,220,206
21,134,6,5,157,152
21,135,0,6,148,142
21,135,1,6,156,150
21,135,2,5,126,121
21,135,3,5,145,140
21,135,4,4,150,146
21,135,5,3,181,178
21,135,6,3,138,135
21,136,0,9,124,115
21,136,1,5,155,150
21,136,2,7,141,134
21,136,3,6,146,140
21,136,4,5,163,158
21,136,5,6,167,161
21,136,6,5,137,132
21,137,0,3,96,93
21,137,1,6,88,82
21,137,2,5,113,108
21,137,3,9,110,101
21,137,4,9,162,153
21,137,5,7,132,125
21,137,6,6,110,104
21,138,0,1,90,89
21,138,1,3,94,91
21,138,2,5,118,113
21,138,3,6,77,71
21,138,4,2,121,119
21,138,5,3,121,118
21,138,6,5,90,85
21,139,0,4,73,69
21,139,1,6,77,71
21,139,2,3,69,66
21,139,3,9,126,117
21,139,4,3,90,87
21,139,5,2,116,114
21,139,6,5,73,68
21,140,0,3,56,53
21,140,1,1,56,55
21,140,2,1,69,68
21,140,3,3,64,61
21,140,4,3,78,75
21,140,5,5,90,85
21,140,6,3,66,63
21,141,0,2,58,56
21,141,1,3,57,54
21,141,2,2,60,58
21,141,3,6,64,58
21,141,4,4,85,81
21,141,5,5,98,93
21,141,6,0,50,50
21,142,0,2,43,41
21,142,1,1,41,40
21,142,2,4,52,48
21,142,3,5,48,43
21,142,4,2,62,60
21,142,5,7,77,70
21,142,6,1,35,34
21,143,0,3,49,46
21,143,1,0,44,44
21,143,2,5,55,50
21,143,3,1,35,34
21,143,4,1,45,44
21,143,5,1,63,62
21,143,6,0,38,38
22,0,0,21,62,41
22,0,1,26,67,41
22,0,2,30,74,44
22,0,3,27,78,51
22,0,4,28,85,57
22,0,5,25,89,64
22,0,6,28,83,55
22,1,0,25,60,35
22,1,1,19,74,55
22,1,2,19,69,50
22,1,3,14,80,66
22,1,4,11,66,55
22,1,5,18,81,63
22,1,6,20,70,50
22,2,0,25,74,49
22,2,1,18,66,48
22,2,2,16,58,42
22,2,3,6,50,44
22,2,4,13,70,57
22,2,5,11,61,50
22,2,6,10,65,55
22,3,0,23,68,45
22,3,1,19,59,40
22,3,2,8,42,34
22,3,3,25,78,53
22,3,4,15,87,72
22,3,5,11,72,61
22,3,6,16,73,57
22,4,0,17,62,45
22,4,1,23,66,43
22,4,2,6,44,38
22,4,3,17,78,61
22,4,4,5,50,45
22,4,5,9,54,45
22,4,6,17,70,53
22,5,0,17,47,30
22,5,1,10,56,46
22,5,2,23,89,66
22,5,3,16,61,45
22,5,4,11,65,54
22,5,5,15,73,58
22,5,6,13,65,52
22,6,0,17,44,27
22,6,1,17,67,50
22,6,2,17,55,38
22,6,3,9,50,41
22,6,4,19,69,50
22,6,5,8,42,34
22,6,6,20,72,52
22,7,0,26,60,34
22,7,1,13,56,43
22,7,2,4,51,47
22,7,3,18,50,32
22,7,4,16,64,48
22,7,5,3,35,32
22,7,6,5,43,38
22,8,0,4,30,26
22,8,1,8,42,34
22,8,2,8,50,42
22,8,3,9,31,22
22,8,4,14,56,42
22,8,5,6,42,36
22,8,6,10,40,30
22,9,0,4,25,21
22,9,1,10,36,26
22,9,2,11,44,33
22,9,3,23,67,44
22,9,4,11,59,48
22,9,5,16,48,32
22,9,6,7,41,34
22,10,0,9,37,28
22,10,1,20,50,30
22,10,2,5,38,33
22,10,3,13,36,23
22,10,4,5,42,37
22,10,5,17,47,30
22,10,6,6,43,37
22,11,0,6,30,24
22,11,1,15,37,22
22,11,2,5,33,28
22,11,3,20,48,28
22,11,4,4,33,29
22,11,5,14,36,22
22,11,6,12,42,30
22,12,0,18,38,20
22,12,1,9,31,22
22,12,2,6,31,25
22,12,3,7,26,19
22,12,4,12,44,32
22,12,5,9,26,17
22,12,6,8,37,29
22,13,0,9,31,22
22,13,1,3,14,11
22,13,2,7,26,19
22,13,3,8,24,16
22,13,4,2,31,29
22,13,5,9,31,22
22,13,6,4,22,18
22,14,0,9,17,8
22,14,1,6,18,12
22,14,2,7,17,10
22,14,3,8,26,18
22,14,4,8,27,19
22,14,5,9,25,16
22,14,6,2,20,18
22,15,0,4,18,14
22,15,1,3,18,15
22,15,2,11,25,14
22,15,3,2,10,8
22,15,4,7,33,26
22,15,5,2,26,24
22,15,6,1,17,16
22,16,0,3,16,13
22,16,1,2,11,9
22,16,2,9,24,15
22,16,3,8,21,13
22,16,4,14,27,13
22,16,5,9,22,13
22,16,6,6,24,18
22,17,0,7,21,14
22,17,1,3,10,7
22,17,2,12,28,16
22,17,3,5,16,11
22,17,4,5,25,20
22,17,5,7,20,13
22,17,6,5,17,12
22,18,0,5,11,6
22,18,1,3,20,17
22,18,2,2,12,10
22,18,3,7,17,10
22,18,4,4,13,9
22,18,5,7,21,14
22,18,6,8,27,19
22,19,0,8,24,16
22,19,1,7,22,15
22,19,2,8,21,13
22,19,3,11,24,13
22,19,4,7,23,16
22,19,5,6,17,11
22,19,6,4,17,13
22,20,0,4,20,16
22,20,1,3,15,12
22,20,2,10,16,6
22,20,3,11,21,10
22,20,4,8,19,11
22,20,5,9,16,7
22,20,6,3,14,11
22,21,0,1,9,8
22,21,1,3,9,6
22,21,2,7,17,10
22,21,3,10,14,4
22,21,4,2,13,11
22,21,5,7,16,9
22,21,6,2,8,6
22,22,0,1,8,7
22,22,1,5,12,7
22,22,2,9,19,10
22,22,3,1,8,7
22,22,4,5,14,9
22,22,5,9,20,11
22,22,6,5,22,17
22,23,0,5,16,11
22,23,1,6,16,10
22,23,2,0,6,6
22,23,3,3,9,6
22,23,4,4,10,6
22,23,5,2,8,6
22,23,6,4,14,10
22,24,0,9,16,7
22,24,1,1,8,7
22,24,2,1,10,9
22,24,3,6,15,9
22,24,4,3,9,6
22,24,5,10,17,7
22,24,6,1,8,7
22,25,0,3,10,7
22,25,1,4,6,2
22,25,2,5,10,5
22,25,3,2,6,4
22,25,4,4,12,8
22,25,5,2,7,5
22,25,6,5,12,7
22,26,0,0,3,3
22,26,1,0,1,1
22,26,2,3,3,0
22,26,3,2,5,3
22,26,4,2,9,7
22,26,5,5,15,10
22,26,6,2,8,6
22,27,0,1,2,1
22,27,1,3,9,6
22,27,2,2,7,5
22,27,3,4,8,4
22,27,4,4,6,2
22,27,5,4,8,4
22,27,6,7,14,7
22,28,0,1,3,2
22,28,1,2,7,5
22,28,2,5,10,5
22,28,3,1,6,5
22,28,4,11,18,7
22,28,5,4,8,4
22,28,6,5,11,6
22,29,0,8,11,3
22,29,1,2,6,4
22,29,2,3,5,2
22,29,3,1,3,2
22,29,4,7,11,4
22,29,5,3,6,3
22,29,6,2,7,5
22,30,0,3,5,2
22,30,1,0,3,3
22,30,2,2,11,9
22,30,3,2,6,4
22,30,4,1,3,2
22,30,5,1,3,2
22,30,6,6,10,4
22,31,0,1,3,2
22,31,1,3,7,4
22,31,2,10,11,1
22,31,3,3,12,9
22,31,4,1,5,4
22,31,5,1,3,2
22,31,6,8,14,6
22,32,0,5,6,1
22,32,1,1,4,3
22,32,2,4,8,4
22,32,3,2,5,3
22,32,4,1,4,3
22,32,5,6,10,4
22,32,6,3,6,3
22,33,0,1,5,4
22,33,1,4,6,2
22,33,2,1,4,3
22,33,3,1,1,0
22,33,4,4,6,2
22,33,5,4,8,4
22,33,6,4,6,2
22,34,0,2,5,3
22,34,1,0,4,4
22,34,2,0,1,1
22,34,3,3,6,3
22,34,4,6,11,5
22,34,5,9,13,4
22,34,6,3,6,3
22,35,0,3,7,4
22,35,1,0,2,2
22,35,2,1,4,3
22,35,3,7,11,4
22,35,4,2,5,3
22,35,5,4,7,3
22,35,6,4,6,2
22,36,0,4,9,5
22,36,1,3,8,5
22,36,2,1,4,3
22,36,3,2,6,4
22,36,4,1,3,2
22,36,5,3,7,4
22,36,6,5,8,3
22,37,0,10,12,2
22,37,1,7,12,5
22,37,2,3,5,2
22,37,3,7,10,3
22,37,4,0,5,5
22,37,5,4,7,3
22,37,6,2,5,3
22,38,0,4,11,7
22,38,1,9,19,10
22,38,2,7,16,9
22,38,3,8,16,8
22,38,4,8,14,6
22,38,5,1,10,9
22,38,6,2,10,8
22,39,0,8,22,14
22,39,1,7,14,7
22,39,2,8,30,22
22,39,3,1,11,10
22,39,4,4,16,12
22,39,5,3,11,8
22,39,6,3,13,10
22,40,0,9,29,20
22,40,1,9,26,17
22,40,2,11,31,20
22,40,3,0,15,15
22,40,4,4,20,16
22,40,5,4,15,11
22,40,6,4,12,8
22,41,0,16,48,32
22,41,1,5,25,20
22,41,2,15,38,23
22,41,3,10,35,25
22,41,4,11,29,18
22,41,5,5,16,11
22,41,6,16,34,18
22,42,0,19,48,29
22,42,1,10,35,25
22,42,2,14,46,32
22,42,3,8,38,30
22,42,4,6,31,25
22,42,5,9,22,13
22,42,6,12,31,19
22,43,0,18,79,61
22,43,1,16,76,60
22,43,2,17,81,64
22,43,3,13,67,54
22,43,4,11,53,42
22,43,5,2,24,22
22,43,6,2,19,17
22,44,0,22,89,67
22,44,1,12,72,60
22,44,2,21,88,67
22,44,3,10,66,56
22,44,4,11,64,53
22,44,5,11,47,36
22,44,6,6,30,24
22,45,0,21,120,99
22,45,1,8,93,85
22,45,2,14,111,97
22,45,3,15,111,96
22,45,4,15,75,60
22,45,5,13,70,57
22,45,6,15,67,52
22,46,0,21,149,128
22,46,1,24,134,110
22,46,2,26,144,118
22,46,3,23,151,128
22,46,4,16,98,82
22,46,5,13,65,52
22,46,6,12,73,61
22,47,0,22,143,121
22,47,1,33,150,117
22,47,2,26,160,134
22,47,3,18,139,121
22,47,4,11,113,102
22,47,5,16,70,54
22,47,6,12,53,41
22,48,0,34,180,146
22,48,1,34,200,166
22,48,2,30,161,131
22,48,3,30,189,159
22,48,4,9,123,114
22,48,5,13,99,86
22,48,6,9,84,75
22,49,0,30,160,130
22,49,1,16,178,162
22,49,2,16,188,172
22,49,3,53,229,176
22,49,4,32,147,115
22,49,5,13,96,83
22,49,6,8,73,65
22,50,0,28,180,152
22,50,1,30,161,131
22,50,2,27,148,121
22,50,3,35,161,126
22,50,4,22,112,90
22,50,5,17,94,77
22,50,6,27,104,77
22,51,0,26,168,142
22,51,1,23,166,143
22,51,2,26,180,154
22,51,3,29,167,138
22,51,4,33,156,123
22,51,5,30,117,87
22,51,6,18,83,65
22,52,0,49,199,150
22,52,1,23,184,161
22,52,2,29,188,159
22,52,3,32,184,152
22,52,4,19,136,117
22,52,5,23,118,95
22,52,6,24,131,107
22,53,0,25,131,106
22,53,1,19,144,125
22,53,2,37,163,126
22,53,3,26,148,122
22,53,4,13,115,102
22,53,5,14,83,69
22,53,6,33,95,62
22,54,0,11,124,113
22,54,1,16,130,114
22,54,2,24,136,112
22,54,3,21,111,90
22,54,4,16,103,87
22,54,5,14,83,69
22,54,6,23,102,79
22,55,0,24,116,92
22,55,1,25,132,107
22,55,2,23,131,108
22,55,3,29,132,103
22,55,4,29,110,81
22,55,5,18,100,82
22,55,6,13,79,66
22,56,0,17,98,81
22,56,1,22,105,83
22,56,2,31,124,93
22,56,3,24,123,99
22,56,4,20,108,88
22,56,5,25,91,66
22,56,6,8,76,68
22,57,0,23,99,76
22,57,1,9,103,94
22,57,2,20,114,94
22,57,3,20,128,108
22,57,4,28,109,81
22,57,5,13,89,76
22,57,6,15,94,79
22,58,0,35,113,78
22,58,1,22,114,92
22,58,2,14,100,86
22,58,3,22,92,70
22,58,4,27,101,74
22,58,5,33,86,53
22,58,6,26,96,70
22,59,0,28,117,89
22,59,1,24,101,77
22,59,2,33,130,97
22,59,3,10,84,74
22,59,4,39,120,81
22,59,5,36,109,73
22,59,6,18,82,64
22,60,0,39,109,70
22,60,1,25,105,80
22,60,2,18,89,71
22,60,3,22,87,65
22,60,4,32,102,70
22,60,5,26,98,72
22,60,6,19,103,84
22,61,0,20,96,76
22,61,1,49,109,60
22,61,2,18,85,67
22,61,3,23,104,81
22,61,4,37,127,90
22,61,5,33,119,86
22,61,6,18,86,68
22,62,0,38,104,66
22,62,1,46,129,83
22,62,2,18,92,74
22,62,3,34,114,80
22,62,4,37,105,68
22,62,5,24,99,75
22,62,6,21,90,69
22,63,0,32,106,74
22,63,1,31,108,77
22,63,2,14,83,69
22,63,3,36,108,72
22,63,4,34,104,70
22,63,5,19,87,68
22,63,6,27,98,71
22,64,0,33,108,75
22,64,1,13,94,81
22,64,2,36,105,69
22,64,3,23,107,84
22,64,4,38,111,73
22,64,5,26,93,67
22,64,6,21,86,65
22,65,0,34,114,80
22,65,1,22,95,73
22,65,2,19,108,89
22,65,3,25,101,76
22,65,4,40,115,75
22,65,5,24,104,80
22,65,6,26,108,82
22,66,0,40,130,90
22,66,1,35,106,71
22,66,2,32,127,95
22,66,3,33,137,104
22,66,4,36,124,88
22,66,5,57,132,75
22,66,6,27,108,81
22,67,0,25,112,87
22,67,1,36,125,89
22,67,2,18,99,81
22,67,3,24,117,93
22,67,4,42,131,89
22,67,5,53,150,97
22,67,6,45,126,81
22,68,0,47,141,94
22,68,1,31,123,92
22,68,2,16,103,87
22,68,3,32,129,97
22,68,4,39,142,103
22,68,5,28,115,87
22,68,6,28,109,81
22,69,0,19,119,100
22,69,1,43,135,92
22,69,2,25,112,87
22,69,3,43,144,101
22,69,4,59,154,95
22,69,5,50,142,92
22,69,6,44,153,109
22,70,0,26,114,88
22,70,1,21,114,93
22,70,2,32,130,98
22,70,3,29,117,88
22,70,4,44,127,83
22,70,5,35,118,83
22,70,6,47,159,112
22,71,0,36,125,89
22,71,1,26,122,96
22,71,2,33,122,89
22,71,3,52,147,95
22,71,4,54,142,88
22,71,5,35,121,86
22,71,6,46,147,101
22,72,0,31,114,83
22,72,1,26,112,86
22,72,2,26,117,91
22,72,3,27,117,90
22,72,4,41,131,90
22,72,5,29,108,79
22,72,6,32,122,90
22,73,0,28,104,76
22,73,1,22,93,71
22,73,2,24,123,99
22,73,3,19,87,68
22,73,4,44,129,85
22,73,5,32,120,88
22,73,6,44,139,95
22,74,0,21,100,79
22,74,1,28,131,103
22,74,2,22,110,88
22,74,3,26,119,93
22,74,4,46,143,97
22,74,5,25,104,79
22,74,6,28,128,100
22,75,0,20,90,70
22,75,1,21,109,88
22,75,2,23,97,74
22,75,3,25,94,69
22,75,4,34,111,77
22,75,5,24,104,80
22,75,6,48,145,97
22,76,0,20,84,64
22,76,1,31,101,70
22,76,2,22,90,68
22,76,3,16,102,86
22,76,4,35,110,75
22,76,5,45,130,85
22,76,6,41,143,102
22,77,0,24,81,57
22,77,1,32,98,66
22,77,2,27,108,81
22,77,3,27,116,89
22,77,4,42,132,90
22,77,5,36,109,73
22,77,6,28,122,94
22,78,0,34,121,87
22,78,1,23,104,81
22,78,2,26,116,90
22,78,3,54,123,69
22,78,4,32,104,72
22,78,5,25,98,73
22,78,6,38,111,73
22,79,0,28,95,67
22,79,1,34,117,83
22,79,2,41,127,86
22,79,3,33,121,88
22,79,4,37,147,110
22,79,5,54,138,84
22,79,6,28,119,91
22,80,0,30,111,81
22,80,1,23,103,80
22,80,2,30,103,73
22,80,3,26,120,94
22,80,4,38,134,96
22,80,5,40,117,77
22,80,6,28,110,82
22,81,0,33,137,104
22,81,1,41,127,86
22,81,2,60,172,112
22,81,3,23,116,93
22,81,4,40,134,94
22,81,5,32,109,77
22,81,6,22,125,103
22,82,0,23,119,96
22,82,1,24,115,91
22,82,2,45,135,90
22,82,3,37,114,77
22,82,4,45,124,79
22,82,5,37,136,99
22,82,6,38,108,70
22,83,0,35,125,90
22,83,1,30,125,95
22,83,2,31,129,98
22,83,3,33,118,85
22,83,4,52,130,78
22,83,5,32,98,66
22,83,6,42,121,79
22,84,0,48,143,95
22,84,1,22,106,84
22,84,2,28,117,89
22,84,3,32,135,103
22,84,4,41,133,92
22,84,5,26,119,93
22,84,6,23,117,94
22,85,0,38,132,94
22,85,1,28,120,92
22,85,2,16,109,93
22,85,3,40,126,86
22,85,4,39,116,77
22,85,5,23,117,94
22,85,6,37,135,98
22,86,0,50,144,94
22,86,1,38,128,90
22,86,2,27,122,95
22,86,3,49,132,83
22,86,4,51,132,81
22,86,5,36,120,84
22,86,6,39,145,106
22,87,0,30,131,101
22,87,1,30,113,83
22,87,2,31,135,104
22,87,3,23,100,77
22,87,4,72,179,107
22,87,5,42,139,97
22,87,6,57,145,88
22,88,0,38,133,95
22,88,1,33,116,83
22,88,2,35,144,109
22,88,3,33,123,90
22,88,4,43,128,85
22,88,5,50,136,86
22,88,6,29,118,89
22,89,0,51,145,94
22,89,1,21,93,72
22,89,2,44,146,102
22,89,3,29,98,69
22,89,4,47,149,102
22,89,5,20,90,70
22,89,6,34,117,83
22,90,0,31,118,87
22,90,1,29,119,90
22,90,2,35,124,89
22,90,3,36,116,80
22,90,4,57,158,101
22,90,5,39,130,91
22,90,6,32,119,87
22,91,0,43,122,79
22,91,1,41,129,88
22,91,2,31,117,86
22,91,3,39,126,87
22,91,4,26,116,90
22,91,5,33,118,85
22,91,6,46,150,104
22,92,0,35,159,124
22,92,1,30,105,75
22,92,2,35,139,104
22,92,3,18,117,99
22,92,4,48,138,90
22,92,5,39,151,112
22,92,6,37,128,91
22,93,0,33,150,117
22,93,1,37,126,89
22,93,2,43,146,103
22,93,3,36,123,87
22,93,4,41,135,94
22,93,5,41,118,77
22,93,6,35,110,75
22,94,0,29,124,95
22,94,1,30,140,110
22,94,2,22,115,93
22,94,3,27,126,99
22,94,4,52,156,104
22,94,5,38,122,84
22,94,6,51,145,94
22,95,0,27,121,94
22,95,1,46,144,98
22,95,2,26,148,122
22,95,3,24,127,103
22,95,4,60,159,99
22,95,5,57,153,96
22,95,6,74,164,90
22,96,0,26,133,107
22,96,1,35,156,121
22,96,2,42,174,132
22,96,3,51,175,124
22,96,4,26,113,87
22,96,5,63,174,111
22,96,6,44,139,95
22,97,0,29,132,103
22,97,1,30,148,118
22,97,2,64,176,112
22,97,3,31,127,96
22,97,4,70,166,96
22,97,5,56,151,95
22,97,6,63,193,130
22,98,0,42,137,95
22,98,1,37,162,125
22,98,2,46,164,118
22,98,3,59,190,131
22,98,4,53,167,114
22,98,5,51,144,93
22,98,6,50,159,109
22,99,0,30,154,124
22,99,1,43,182,139
22,99,2,49,164,115
22,99,3,31,164,133
22,99,4,62,175,113
22,99,5,52,152,100
22,99,6,58,162,104
22,100,0,37,143,106
22,100,1,23,119,96
22,100,2,47,150,103
22,100,3,35,163,128
22,100,4,53,170,117
22,100,5,62,187,125
22,100,6,41,141,100
22,101,0,54,192,138
22,101,1,35,165,130
22,101,2,51,221,170
22,101,3,52,213,161
22,101,4,69,204,135
22,101,5,59,198,139
22,101,6,53,205,152
22,102,0,39,224,185
22,102,1,26,198,172
22,102,2,75,249,174
22,102,3,84,315,231
22,102,4,73,258,185
22,102,5,57,201,144
22,102,6,44,206,162
22,103,0,49,221,172
22,103,1,50,225,175
22,103,2,63,232,169
22,103,3,58,218,160
22,103,4,38,176,138
22,103,5,63,205,142
22,103,6,52,199,147
22,104,0,48,209,161
22,104,1,57,209,152
22,104,2,76,238,162
22,104,3,47,205,158
22,104,4,52,232,180
22,104,5,52,180,128
22,104,6,53,200,147
22,105,0,47,198,151
22,105,1,66,236,170
22,105,2,77,255,178
22,105,3,54,256,202
22,105,4,49,212,163
22,105,5,52,194,142
22,105,6,43,183,140
22,106,0,39,191,152
22,106,1,50,198,148
22,106,2,62,227,165
22,106,3,67,231,164
22,106,4,63,216,153
22,106,5,73,215,142
22,106,6,39,173,134
22,107,0,47,189,142
22,107,1,44,194,150
22,107,2,84,255,171
22,107,3,56,195,139
22,107,4,54,208,154
22,107,5,76,190,114
22,107,6,68,213,145
22,108,0,55,188,133
22,108,1,85,254,169
22,108,2,83,238,155
22,108,3,64,229,165
22,108,4,59,196,137
22,108,5,59,190,131
22,108,6,49,178,129
22,109,0,45,171,126
22,109,1,65,212,147
22,109,2,66,239,173
22,109,3,58,202,144
22,109,4,80,211,131
22,109,5,57,173,116
22,109,6,51,188,137
22,110,0,57,211,154
22,110,1,79,237,158
22,110,2,63,214,151
22,110,3,39,209,170
22,110,4,59,201,142
22,110,5,51,175,124
22,110,6,54,185,131
22,111,0,38,210,172
22,111,1,61,235,174
22,111,2,104,319,215
22,111,3,56,193,137
22,111,4,72,242,170
22,111,5,60,202,142
22,111,6,50,206,156
22,112,0,47,209,162
22,112,1,57,210,153
22,112,2,57,200,143
22,112,3,61,213,152
22,112,4,61,203,142
22,112,5,48,188,140
22,112,6,35,189,154
22,113,0,55,186,131
22,113,1,60,203,143
22,113,2,57,201,144
22,113,3,48,190,142
22,113,4,55,190,135
22,113,5,35,155,120
22,113,6,31,147,116
22,114,0,43,169,126
22,114,1,29,134,105
22,114,2,35,166,131
22,114,3,32,128,96
22,114,4,47,169,122
22,114,5,35,143,108
22,114,6,37,139,102
22,115,0,33,138,105
22,115,1,31,148,117
22,115,2,42,170,128
22,115,3,36,152,116
22,115,4,64,180,116
22,115,5,30,146,116
22,115,6,55,166,111
22,116,0,41,130,89
22,116,1,37,159,122
22,116,2,50,153,103
22,116,3,47,162,115
22,116,4,63,161,98
22,116,5,38,138,100
22,116,6,61,162,101
22,117,0,38,139,101
22,117,1,35,145,110
22,117,2,38,145,107
22,117,3,31,138,107
22,117,4,61,160,99
22,117,5,31,131,100
22,117,6,53,154,101
22,118,0,53,155,102
22,118,1,48,136,88
22,118,2,29,110,81
22,118,3,55,149,94
22,118,4,32,115,83
22,118,5,41,121,80
22,118,6,44,130,86
22,119,0,53,138,85
22,119,1,34,128,94
22,119,2,43,123,80
22,119,3,44,146,102
22,119,4,65,169,104
22,119,5,40,119,79
22,119,6,46,127,81
22,120,0,35,139,104
22,120,1,20,120,100
22,120,2,47,156,109
22,120,3,49,165,116
22,120,4,56,156,100
22,120,5,41,138,97
22,120,6,52,158,106
22,121,0,26,140,114
22,121,1,47,151,104
22,121,2,31,151,120
22,121,3,22,131,109
22,121,4,56,148,92
22,121,5,44,126,82
22,121,6,43,138,95
22,122,0,32,141,109
22,122,1,38,136,98
22,122,2,37,139,102
22,122,3,33,143,110
22,122,4,58,165,107
22,122,5,51,156,105
22,122,6,57,164,107
22,123,0,29,124,95
22,123,1,38,123,85
22,123,2,53,173,120
22,123,3,33,126,93
22,123,4,32,122,90
22,123,5,59,131,72
22,123,6,71,165,94
22,124,0,22,123,101
22,124,1,23,107,84
22,124,2,32,139,107
22,124,3,48,123,75
22,124,4,29,109,80
22,124,5,47,110,63
22,124,6,48,130,82
22,125,0,45,123,78
22,125,1,34,107,73
22,125,2,25,105,80
22,125,3,34,114,80
22,125,4,51,137,86
22,125,5,21,108,87
22,125,6,40,113,73
22,126,0,25,108,83
22,126,1,26,122,96
22,126,2,42,128,86
22,126,3,29,110,81
22,126,4,40,131,91
22,126,5,47,146,99
22,126,6,30,133,103
22,127,0,26,101,75
22,127,1,36,106,70
22,127,2,24,100,76
22,127,3,33,117,84
22,127,4,32,135,103
22,127,5,57,148,91
22,127,6,68,144,76
22,128,0,46,118,72
22,128,1,35,101,66
22,128,2,28,119,91
22,128,3,35,97,62
22,128,4,55,129,74
22,128,5,71,141,70
22,128,6,39,121,82
22,129,0,34,105,71
22,129,1,29,113,84
22,129,2,44,147,103
22,129,3,37,124,87
22,129,4,29,129,100
22,129,5,55,140,85
22,129,6,61,149,88
22,130,0,34,124,90
22,130,1,48,121,73
22,130,2,45,119,74
22,130,3,24,88,64
22,130,4,41,116,75
22,130,5,54,128,74
22,130,6,42,110,68
22,131,0,34,103,69
22,131,1,37,99,62
22,131,2,31,114,83
22,131,3,36,117,81
22,131,4,44,121,77
22,131,5,44,117,73
22,131,6,37,113,76
22,132,0,28,105,77
22,132,1,29,110,81
22,132,2,25,100,75
22,132,3,29,103,74
22,132,4,59,142,83
22,132,5,65,156,91
22,132,6,65,136,71
22,133,0,20,86,66
22,133,1,27,102,75
22,133,2,42,106,64
22,133,3,42,115,73
22,133,4,49,112,63
22,133,5,51,145,94
22,133,6,40,98,58
22,134,0,15,79,64
22,134,1,29,90,61
22,134,2,27,101,74
22,134,3,32,88,56
22,134,4,41,110,69
22,134,5,44,114,70
22,134,6,30,93,63
22,135,0,21,81,60
22,135,1,25,98,73
22,135,2,19,75,56
22,135,3,19,68,49
22,135,4,22,82,60
22,135,5,60,133,73
22,135,6,34,77,43
22,136,0,40,125,85
22,136,1,21,83,62
22,136,2,19,87,68
22,136,3,24,91,67
22,136,4,31,101,70
22,136,5,70,124,54
22,136,6,35,93,58
22,137,0,41,102,61
22,137,1,42,130,88
22,137,2,34,113,79
22,137,3,55,111,56
22,137,4,64,130,66
22,137,5,49,123,74
22,137,6,43,105,62
22,138,0,19,89,70
22,138,1,23,92,69
22,138,2,39,109,70
22,138,3,57,139,82
22,138,4,28,96,68
22,138,5,30,99,69
22,138,6,46,117,71
22,139,0,22,92,70
22,139,1,26,90,64
22,139,2,29,107,78
22,139,3,36,103,67
22,139,4,33,92,59
22,139,5,57,116,59
22,139,6,33,99,66
22,140,0,23,72,49
22,140,1,27,89,62
22,140,2,19,80,61
22,140,3,17,76,59
22,140,4,47,104,57
22,140,5,43,101,58
22,140,6,36,100,64
22,141,0,19,79,60
22,141,1,20,86,66
22,141,2,14,61,47
22,141,3,14,76,62
22,141,4,20,78,58
22,141,5,31,96,65
22,141,6,25,81,56
22,142,0,25,80,55
22,142,1,22,78,56
22,142,2,8,61,53
22,142,3,14,68,54
22,142,4,8,71,63
22,142,5,48,118,70
22,142,6,23,77,54
22,143,0,11,64,53
22,143,1,19,70,51
22,143,2,16,71,55
22,143,3,21,77,56
22,143,4,16,77,61
22,143,5,21,71,50
22,143,6,22,71,49
23,0,0,71,406,335
23,0,1,67,394,327
23,0,2,102,449,347
23,0,3,41,378,337
23,0,4,22,471,449
23,0,5,33,439,406
23,0,6,100,549,449
23,1,0,64,344,280
23,1,1,49,347,298
23,1,2,89,421,332
23,1,3,86,407,321
23,1,4,39,608,569
23,1,5,51,396,345
23,1,6,108,507,399
23,2,0,95,354,259
23,2,1,52,326,274
23,2,2,63,351,288
23,2,3,85,388,303
23,2,4,310,887,577
23,2,5,70,417,347
23,2,6,75,419,344
23,3,0,85,345,260
23,3,1,61,343,282
23,3,2,53,302,249
23,3,3,61,337,276
23,3,4,1025,1634,609
23,3,5,29,373,344
23,3,6,88,418,330
23,4,0,67,302,235
23,4,1,34,261,227
23,4,2,41,301,260
23,4,3,46,312,266
23,4,4,1224,1751,527
23,4,5,75,366,291
23,4,6,124,476,352
23,5,0,66,303,237
23,5,1,60,298,238
23,5,2,43,280,237
23,5,3,74,283,209
23,5,4,1188,1732,544
23,5,5,63,391,328
23,5,6,151,486,335
23,6,0,42,258,216
23,6,1,65,294,229
23,6,2,79,311,232
23,6,3,56,301,245
23,6,4,963,1488,525
23,6,5,62,366,304
23,6,6,146,416,270
23,7,0,54,247,193
23,7,1,53,263,210
23,7,2,47,255,208
23,7,3,59,268,209
23,7,4,768,1239,471
23,7,5,49,302,253
23,7,6,103,362,259
23,8,0,54,248,194
23,8,1,47,251,204
23,8,2,27,229,202
23,8,3,74,302,228
23,8,4,572,1026,454
23,8,5,36,309,273
23,8,6,58,309,251
23,9,0,37,193,156
23,9,1,50,232,182
23,9,2,25,215,190
23,9,3,67,266,199
23,9,4,306,767,461
23,9,5,43,289,246
23,9,6,83,327,244
23,10,0,38,183,145
23,10,1,25,195,170
23,10,2,24,213,189
23,10,3,39,245,206
23,10,4,127,515,388
23,10,5,25,250,225
23,10,6,103,323,220
23,11,0,30,164,134
23,11,1,24,192,168
23,11,2,21,186,165
23,11,3,18,182,164
23,11,4,67,385,318
23,11,5,34,248,214
23,11,6,83,272,189
23,12,0,19,165,146
23,12,1,24,174,150
23,12,2,16,201,185
23,12,3,24,171,147
23,12,4,93,398,305
23,12,5,34,218,184
23,12,6,57,233,176
23,13,0,44,173,129
23,13,1,22,161,139
23,13,2,11,166,155
23,13,3,42,167,125
23,13,4,113,368,255
23,13,5,66,266,200
23,13,6,82,269,187
23,14,0,23,139,116
23,14,1,17,157,140
23,14,2,21,165,144
23,14,3,33,165,132
23,14,4,143,376,233
23,14,5,49,216,167
23,14,6,49,226,177
23,15,0,15,121,106
23,15,1,21,161,140
23,15,2,10,140,130
23,15,3,19,131,112
23,15,4,150,337,187
23,15,5,72,245,173
23,15,6,43,211,168
23,16,0,22,152,130
23,16,1,14,117,103
23,16,2,11,125,114
23,16,3,26,148,122
23,16,4,140,308,168
23,16,5,36,196,160
23,16,6,33,182,149
23,17,0,24,127,103
23,17,1,21,122,101
23,17,2,20,131,111
23,17,3,33,143,110
23,17,4,154,301,147
23,17,5,29,157,128
23,17,6,46,167,121
23,18,0,19,98,79
23,18,1,25,146,121
23,18,2,15,128,113
23,18,3,16,116,100
23,18,4,134,304,170
23,18,5,48,177,129
23,18,6,30,166,136
23,19,0,14,95,81
23,19,1,7,96,89
23,19,2,15,121,106
23,19,3,20,122,102
23,19,4,112,239,127
23,19,5,33,147,114
23,19,6,27,153,126
23,20,0,14,109,95
23,20,1,9,83,74
23,20,2,16,106,90
23,20,3,7,85,78
23,20,4,67,159,92
23,20,5,13,124,111
23,20,6,33,133,100
23,21,0,9,75,66
23,21,1,7,88,81
23,21,2,10,75,65
23,21,3,1,89,88
23,21,4,45,132,87
23,21,5,36,163,127
23,21,6,41,156,115
23,22,0,7,59,52
23,22,1,15,89,74
23,22,2,15,86,71
23,22,3,5,77,72
23,22,4,58,149,91
23,22,5,39,126,87
23,22,6,34,107,73
23,23,0,5,66,61
23,23,1,13,79,66
23,23,2,11,86,75
23,23,3,19,106,87
23,23,4,64,152,88
23,23,5,23,116,93
23,23,6,14,100,86
23,24,0,7,73,66
23,24,1,15,73,58
23,24,2,27,100,73
23,24,3,7,67,60
23,24,4,81,160,79
23,24,5,19,88,69
23,24,6,18,100,82
23,25,0,18,72,54
23,25,1,23,76,53
23,25,2,24,93,69
23,25,3,8,64,56
23,25,4,101,171,70
23,25,5,19,96,77
23,25,6,34,109,75
23,26,0,14,77,63
23,26,1,9,65,56
23,26,2,15,88,73
23,26,3,15,80,65
23,26,4,79,170,91
23,26,5,15,89,74
23,26,6,19,86,67
23,27,0,17,91,74
23,27,1,16,73,57
23,27,2,12,70,58
23,27,3,19,85,66
23,27,4,78,140,62
23,27,5,37,100,63
23,27,6,28,86,58
23,28,0,31,81,50
23,28,1,17,77,60
23,28,2,15,77,62
23,28,3,17,71,54
23,28,4,92,162,70
23,28,5,17,92,75
23,28,6,33,93,60
23,29,0,23,76,53
23,29,1,17,71,54
23,29,2,12,52,40
23,29,3,15,66,51
23,29,4,73,122,49
23,29,5,22,82,60
23,29,6,28,84,56
23,30,0,33,86,53
23,30,1,14,63,49
23,30,2,11,68,57
23,30,3,12,61,49
23,30,4,95,146,51
23,30,5,15,68,53
23,30,6,24,92,68
23,31,0,18,59,41
23,31,1,14,66,52
23,31,2,10,66,56
23,31,3,14,57,43
23,31,4,101,163,62
23,31,5,27,76,49
23,31,6,35,80,45
23,32,0,28,86,58
23,32,1,13,87,74
23,32,2,21,89,68
23,32,3,18,65,47
23,32,4,139,194,55
23,32,5,19,73,54
23,32,6,29,82,53
23,33,0,43,83,40
23,33,1,32,88,56
23,33,2,22,75,53
23,33,3,17,59,42
23,33,4,123,171,48
23,33,5,24,80,56
23,33,6,14,62,48
23,34,0,40,85,45
23,34,1,45,109,64
23,34,2,33,76,43
23,34,3,24,73,49
23,34,4,145,202,57
23,34,5,26,83,57
23,34,6,23,78,55
23,35,0,45,95,50
23,35,1,38,102,64
23,35,2,16,68,52
23,35,3,21,66,45
23,35,4,128,168,40
23,35,5,37,89,52
23,35,6,38,102,64
23,36,0,87,167,80
23,36,1,45,102,57
23,36,2,51,122,71
23,36,3,54,113,59
23,36,4,167,221,54
23,36,5,69,138,69
23,36,6,52,111,59
23,37,0,103,172,69
23,37,1,52,117,65
23,37,2,53,116,63
23,37,3,51,119,68
23,37,4,214,276,62
23,37,5,77,147,70
23,37,6,52,119,67
23,38,0,94,168,74
23,38,1,76,151,75
23,38,2,63,144,81
23,38,3,51,137,86
23,38,4,243,313,70
23,38,5,58,131,73
23,38,6,57,153,96
23,39,0,12,320,308
23,39,1,12,281,269
23,39,2,6,266,260
23,39,3,18,277,259
23,39,4,256,467,211
23,39,5,22,194,172
23,39,6,30,163,133
23,40,0,14,346,332
23,40,1,17,351,334
23,40,2,12,337,325
23,40,3,7,319,312
23,40,4,232,489,257
23,40,5,22,177,155
23,40,6,26,173,147
23,41,0,28,483,455
23,41,1,16,458,442
23,41,2,20,460,440
23,41,3,8,418,410
23,41,4,238,579,341
23,41,5,25,209,184
23,41,6,41,220,179
23,42,0,189,815,626
23,42,1,13,605,592
23,42,2,15,666,651
23,42,3,28,624,596
23,42,4,220,692,472
23,42,5,27,291,264
23,42,6,42,278,236
23,43,0,423,1139,716
23,43,1,69,836,767
23,43,2,37,821,784
23,43,3,45,818,773
23,43,4,273,845,572
23,43,5,39,355,316
23,43,6,62,345,283
23,44,0,1133,1834,701
23,44,1,266,1160,894
23,44,2,201,1151,950
23,44,3,217,1090,873
23,44,4,287,970,683
23,44,5,59,488,429
23,44,6,64,329,265
23,45,0,1351,2019,668
23,45,1,776,1635,859
23,45,2,706,1640,934
23,45,3,480,1393,913
23,45,4,373,1069,696
23,45,5,51,522,471
23,45,6,80,465,385
23,46,0,1386,2016,630
23,46,1,1019,1862,843
23,46,2,1278,2172,894
23,46,3,410,1407,997
23,46,4,622,1337,715
23,46,5,87,609,522
23,46,6,80,454,374
23,47,0,1515,2157,642
23,47,1,1516,2311,795
23,47,2,1510,2279,769
23,47,3,577,1516,939
23,47,4,768,1487,719
23,47,5,143,775,632
23,47,6,156,627,471
23,48,0,1583,2270,687
23,48,1,1788,2593,805
23,48,2,1421,2239,818
23,48,3,681,1645,964
23,48,4,826,1548,722
23,48,5,201,820,619
23,48,6,124,563,439
23,49,0,1507,2221,714
23,49,1,1746,2613,867
23,49,2,1320,2232,912
23,49,3,623,1608,985
23,49,4,645,1437,792
23,49,5,233,913,680
23,49,6,120,662,542
23,50,0,1293,2097,804
23,50,1,1613,2568,955
23,50,2,1039,2106,1067
23,50,3,515,1642,1127
23,50,4,567,1422,855
23,50,5,162,821,659
23,50,6,72,710,638
23,51,0,1145,2022,877
23,51,1,1349,2330,981
23,51,2,965,2018,1053
23,51,3,433,1538,1105
23,51,4,466,1307,841
23,51,5,160,902,742
23,51,6,102,702,600
23,52,0,977,1874,897
23,52,1,877,1895,1018
23,52,2,581,1664,1083
23,52,3,290,1435,1145
23,52,4,364,1319,955
23,52,5,122,830,708
23,52,6,109,778,669
23,53,0,544,1577,1033
23,53,1,445,1460,1015
23,53,2,284,1398,1114
23,53,3,125,1181,1056
23,53,4,181,1028,847
23,53,5,32,695,663
23,53,6,29,655,626
23,54,0,197,1291,1094
23,54,1,138,1291,1153
23,54,2,74,1182,1108
23,54,3,73,1078,1005
23,54,4,58,854,796
23,54,5,28,721,693
23,54,6,26,604,578
23,55,0,180,1164,984
23,55,1,100,1169,1069
23,55,2,72,1116,1044
23,55,3,97,1191,1094
23,55,4,66,971,905
23,55,5,27,748,721
23,55,6,15,591,576
23,56,0,120,1113,993
23,56,1,143,1067,924
23,56,2,82,1102,1020
23,56,3,50,999,949
23,56,4,75,893,818
23,56,5,46,854,808
23,56,6,24,623,599
23,57,0,162,977,815
23,57,1,326,1186,860
23,57,2,174,1055,881
23,57,3,99,972,873
23,57,4,185,906,721
23,57,5,90,868,778
23,57,6,34,729,695
23,58,0,188,1002,814
23,58,1,277,1015,738
23,58,2,319,1172,853
23,58,3,146,1008,862
23,58,4,333,1065,732
23,58,5,120,827,707
23,58,6,47,717,670
23,59,0,140,905,765
23,59,1,225,1043,818
23,59,2,288,1102,814
23,59,3,170,963,793
23,59,4,237,957,720
23,59,5,59,790,731
23,59,6,34,704,670
23,60,0,72,771,699
23,60,1,131,895,764
23,60,2,301,1033,732
23,60,3,147,947,800
23,60,4,222,898,676
23,60,5,51,788,737
23,60,6,36,671,635
23,61,0,66,798,732
23,61,1,96,821,725
23,61,2,211,947,736
23,61,3,145,888,743
23,61,4,277,907,630
23,61,5,35,801,766
23,61,6,16,713,697
23,62,0,38,738,700
23,62,1,84,775,691
23,62,2,240,1013,773
23,62,3,143,930,787
23,62,4,255,953,698
23,62,5,55,817,762
23,62,6,33,689,656
23,63,0,52,811,759
23,63,1,115,801,686
23,63,2,242,953,711
23,63,3,119,831,712
23,63,4,225,945,720
23,63,5,40,739,699
23,63,6,21,678,657
23,64,0,51,738,687
23,64,1,105,764,659
23,64,2,230,939,709
23,64,3,112,801,689
23,64,4,219,870,651
23,64,5,57,804,747
23,64,6,58,782,724
23,65,0,46,714,668
23,65,1,56,758,702
23,65,2,238,989,751
23,65,3,78,771,693
23,65,4,214,861,647
23,65,5,61,770,709
23,65,6,49,765,716
23,66,0,28,712,684
23,66,1,46,714,668
23,66,2,309,1009,700
23,66,3,76,761,685
23,66,4,221,841,620
23,66,5,50,797,747
23,66,6,29,750,721
23,67,0,12,663,651
23,67,1,39,702,663
23,67,2,272,909,637
23,67,3,54,688,634
23,67,4,272,916,644
23,67,5,52,754,702
23,67,6,67,797,730
23,68,0,26,671,645
23,68,1,48,722,674
23,68,2,296,944,648
23,68,3,62,750,688
23,68,4,292,891,599
23,68,5,43,770,727
23,68,6,93,835,742
23,69,0,28,749,721
23,69,1,88,761,673
23,69,2,321,978,657
23,69,3,49,769,720
23,69,4,296,993,697
23,69,5,69,863,794
23,69,6,106,866,760
23,70,0,38,718,680
23,70,1,91,719,628
23,70,2,230,897,667
23,70,3,58,786,728
23,70,4,322,970,648
23,70,5,72,870,798
23,70,6,75,859,784
23,71,0,36,703,667
23,71,1,173,768,595
23,71,2,162,828,666
23,71,3,30,687,657
23,71,4,286,902,616
23,71,5,63,782,719
23,71,6,65,873,808
23,72,0,46,743,697
23,72,1,79,741,662
23,72,2,152,873,721
23,72,3,35,805,770
23,72,4,318,967,649
23,72,5,49,868,819
23,72,6,72,923,851
23,73,0,52,669,617
23,73,1,109,764,655
23,73,2,78,855,777
23,73,3,42,735,693
23,73,4,253,900,647
23,73,5,91,904,813
23,73,6,51,853,802
23,74,0,40,729,689
23,74,1,188,849,661
23,74,2,41,759,718
23,74,3,35,721,686
23,74,4,255,893,638
23,74,5,100,897,797
23,74,6,48,894,846
23,75,0,56,795,739
23,75,1,144,762,618
23,75,2,51,797,746
23,75,3,34,747,713
23,75,4,256,952,696
23,75,5,103,920,817
23,75,6,90,988,898
23,76,0,49,834,785
23,76,1,123,832,709
23,76,2,102,809,707
23,76,3,41,782,741
23,76,4,220,897,677
23,76,5,181,1050,869
23,76,6,77,987,910
23,77,0,51,775,724
23,77,1,106,801,695
23,77,2,88,822,734
23,77,3,43,808,765
23,77,4,292,976,684
23,77,5,176,1081,905
23,77,6,54,917,863
23,78,0,90,826,736
23,78,1,184,919,735
23,78,2,92,880,788
23,78,3,47,849,802
23,78,4,248,973,725
23,78,5,192,1064,872
23,78,6,98,975,877
23,79,0,130,908,778
23,79,1,179,952,773
23,79,2,186,967,781
23,79,3,124,925,801
23,79,4,252,923,671
23,79,5,229,1200,971
23,79,6,99,1029,930
23,80,0,233,995,762
23,80,1,227,1027,800
23,80,2,227,1018,791
23,80,3,110,941,831
23,80,4,276,1011,735
23,80,5,271,1216,945
23,80,6,108,1062,954
23,81,0,246,1052,806
23,81,1,185,887,702
23,81,2,280,1127,847
23,81,3,142,931,789
23,81,4,340,1038,698
23,81,5,266,1182,916
23,81,6,151,1128,977
23,82,0,193,955,762
23,82,1,163,885,722
23,82,2,230,943,713
23,82,3,158,928,770
23,82,4,347,1068,721
23,82,5,271,1226,955
23,82,6,202,1194,992
23,83,0,165,868,703
23,83,1,157,886,729
23,83,2,307,1035,728
23,83,3,153,935,782
23,83,4,305,1021,716
23,83,5,281,1185,904
23,83,6,107,1047,940
23,84,0,134,954,820
23,84,1,170,980,810
23,84,2,267,1050,783
23,84,3,115,889,774
23,84,4,299,975,676
23,84,5,238,1143,905
23,84,6,79,1045,966
23,85,0,191,949,758
23,85,1,179,916,737
23,85,2,303,1039,736
23,85,3,125,900,775
23,85,4,366,1139,773
23,85,5,180,1037,857
23,85,6,99,1044,945
23,86,0,169,911,742
23,86,1,135,913,778
23,86,2,310,1019,709
23,86,3,109,807,698
23,86,4,320,1085,765
23,86,5,221,1097,876
23,86,6,71,964,893
23,87,0,211,1018,807
23,87,1,121,904,783
23,87,2,186,1027,841
23,87,3,91,857,766
23,87,4,290,1064,774
23,87,5,166,1078,912
23,87,6,111,1063,952
23,88,0,186,994,808
23,88,1,136,931,795
23,88,2,227,955,728
23,88,3,120,905,785
23,88,4,309,1066,757
23,88,5,86,1006,920
23,88,6,127,1093,966
23,89,0,237,1004,767
23,89,1,139,917,778
23,89,2,213,1013,800
23,89,3,109,837,728
23,89,4,354,1062,708
23,89,5,101,935,834
23,89,6,58,991,933
23,90,0,329,1128,799
23,90,1,158,908,750
23,90,2,249,1030,781
23,90,3,95,905,810
23,90,4,377,1127,750
23,90,5,74,876,802
23,90,6,59,957,898
23,91,0,482,1241,759
23,91,1,281,1057,776
23,91,2,415,1193,778
23,91,3,129,951,822
23,91,4,388,1088,700
23,91,5,72,919,847
23,91,6,116,1030,914
23,92,0,552,1282,730
23,92,1,423,1114,691
23,92,2,456,1231,775
23,92,3,155,932,777
23,92,4,410,1108,698
23,92,5,56,858,802
23,92,6,167,1099,932
23,93,0,81,1030,949
23,93,1,179,1015,836
23,93,2,209,1057,848
23,93,3,37,952,915
23,93,4,36,948,912
23,93,5,37,880,843
23,93,6,126,1082,956
23,94,0,53,813,760
23,94,1,154,882,728
23,94,2,218,967,749
23,94,3,27,800,773
23,94,4,30,857,827
23,94,5,75,891,816
23,94,6,269,1180,911
23,95,0,90,948,858
23,95,1,188,966,778
23,95,2,191,985,794
23,95,3,51,872,821
23,95,4,34,885,851
23,95,5,141,981,840
23,95,6,448,1406,958
23,96,0,46,954,908
23,96,1,34,876,842
23,96,2,90,1051,961
23,96,3,24,898,874
23,96,4,54,908,854
23,96,5,28,924,896
23,96,6,42,1194,1152
23,97,0,33,896,863
23,97,1,58,947,889
23,97,2,192,1039,847
23,97,3,22,890,868
23,97,4,49,892,843
23,97,5,16,851,835
23,97,6,44,1046,1002
23,98,0,55,984,929
23,98,1,66,960,894
23,98,2,189,1102,913
23,98,3,28,891,863
23,98,4,82,975,893
23,98,5,24,933,909
23,98,6,67,1128,1061
23,99,0,50,1021,971
23,99,1,63,974,911
23,99,2,234,1136,902
23,99,3,38,1011,973
23,99,4,125,1148,1023
23,99,5,23,934,911
23,99,6,80,1194,1114
23,100,0,48,974,926
23,100,1,105,1013,908
23,100,2,251,1241,990
23,100,3,25,982,957
23,100,4,121,1129,1008
23,100,5,25,980,955
23,100,6,57,1084,1027
23,101,0,57,1068,1011
23,101,1,74,1120,1046
23,101,2,262,1307,1045
23,101,3,61,1168,1107
23,101,4,138,1171,1033
23,101,5,31,1110,1079
23,101,6,72,1177,1105
23,102,0,168,1368,1200
23,102,1,129,1333,1204
23,102,2,443,1614,1171
23,102,3,147,1462,1315
23,102,4,219,1363,1144
23,102,5,27,1166,1139
23,102,6,49,1215,1166
23,103,0,221,1377,1156
23,103,1,191,1372,1181
23,103,2,478,1529,1051
23,103,3,153,1288,1135
23,103,4,274,1381,1107
23,103,5,53,1195,1142
23,103,6,56,1208,1152
23,104,0,384,1550,1166
23,104,1,260,1466,1206
23,104,2,546,1648,1102
23,104,3,159,1297,1138
23,104,4,397,1481,1084
23,104,5,31,1134,1103
23,104,6,63,1145,1082
23,105,0,756,1969,1213
23,105,1,573,1849,1276
23,105,2,880,2057,1177
23,105,3,398,1712,1314
23,105,4,543,1682,1139
23,105,5,37,1171,1134
23,105,6,73,1230,1157
23,106,0,699,1792,1093
23,106,1,585,1804,1219
23,106,2,745,1837,1092
23,106,3,286,1502,1216
23,106,4,633,1751,1118
23,106,5,40,1056,1016
23,106,6,52,1171,1119
23,107,0,575,1749,1174
23,107,1,499,1686,1187
23,107,2,709,1748,1039
23,107,3,331,1461,1130
23,107,4,551,1609,1058
23,107,5,25,946,921
23,107,6,34,1056,1022
23,108,0,457,1625,1168
23,108,1,406,1581,1175
23,108,2,785,1830,1045
23,108,3,306,1510,1204
23,108,4,541,1650,1109
23,108,5,26,1009,983
23,108,6,37,1089,1052
23,109,0,309,1431,1122
23,109,1,292,1386,1094
23,109,2,594,1575,981
23,109,3,163,1301,1138
23,109,4,389,1489,1100
23,109,5,27,909,882
23,109,6,20,1031,1011
23,110,0,95,1168,1073
23,110,1,209,1390,1181
23,110,2,465,1536,1071
23,110,3,86,1118,1032
23,110,4,221,1325,1104
23,110,5,20,974,954
23,110,6,24,899,875
23,111,0,26,1065,1039
23,111,1,90,1200,1110
23,111,2,302,1426,1124
23,111,3,47,1080,1033
23,111,4,61,1160,1099
23,111,5,26,1037,1011
23,111,6,17,931,914
23,112,0,33,1029,996
23,112,1,51,1059,1008
23,112,2,219,1300,1081
23,112,3,41,1022,981
23,112,4,43,1164,1121
23,112,5,25,1036,1011
23,112,6,25,991,966
23,113,0,27,1065,1038
23,113,1,31,1073,1042
23,113,2,227,1300,1073
23,113,3,30,1047,1017
23,113,4,27,1054,1027
23,113,5,35,1016,981
23,113,6,29,1006,977
23,114,0,32,1025,993
23,114,1,45,1029,984
23,114,2,277,1287,1010
23,114,3,27,951,924
23,114,4,40,990,950
23,114,5,24,953,929
23,114,6,30,1060,1030
23,115,0,34,980,946
23,115,1,66,990,924
23,115,2,131,1126,995
23,115,3,33,926,893
23,115,4,66,1032,966
23,115,5,20,906,886
23,115,6,43,984,941
23,116,0,41,878,837
23,116,1,55,915,860
23,116,2,81,1081,1000
23,116,3,38,853,815
23,116,4,40,935,895
23,116,5,26,856,830
23,116,6,55,982,927
23,117,0,28,921,893
23,117,1,40,914,874
23,117,2,76,1051,975
23,117,3,36,920,884
23,117,4,35,922,887
23,117,5,37,836,799
23,117,6,63,982,919
23,118,0,29,877,848
23,118,1,47,929,882
23,118,2,65,1009,944
23,118,3,26,817,791
23,118,4,51,884,833
23,118,5,30,906,876
23,118,6,88,1007,919
23,119,0,59,916,857
23,119,1,73,968,895
23,119,2,45,916,871
23,119,3,35,868,833
23,119,4,43,969,926
23,119,5,73,1003,930
23,119,6,237,1126,889
23,120,0,29,913,884
23,120,1,32,926,894
23,120,2,28,991,963
23,120,3,31,958,927
23,120,4,36,988,952
23,120,5,25,920,895
23,120,6,68,1130,1062
23,121,0,37,889,852
23,121,1,31,962,931
23,121,2,44,968,924
23,121,3,25,929,904
23,121,4,41,951,910
23,121,5,22,964,942
23,121,6,68,987,919
23,122,0,30,863,833
23,122,1,45,903,858
23,122,2,42,900,858
23,122,3,31,874,843
23,122,4,54,1014,960
23,122,5,34,980,946
23,122,6,55,1053,998
23,123,0,40,907,867
23,123,1,44,986,942
23,123,2,51,1074,1023
23,123,3,45,967,922
23,123,4,32,995,963
23,123,5,45,1006,961
23,123,6,69,1046,977
23,124,0,48,897,849
23,124,1,55,886,831
23,124,2,46,997,951
23,124,3,27,911,884
23,124,4,72,1021,949
23,124,5,82,1011,929
23,124,6,93,997,904
23,125,0,50,884,834
23,125,1,72,951,879
23,125,2,56,1032,976
23,125,3,56,953,897
23,125,4,97,1144,1047
23,125,5,64,959,895
23,125,6,163,1072,909
23,126,0,59,930,871
23,126,1,78,996,918
23,126,2,33,987,954
23,126,3,65,963,898
23,126,4,104,997,893
23,126,5,73,1015,942
23,126,6,168,1043,875
23,127,0,60,860,800
23,127,1,115,1044,929
23,127,2,70,1056,986
23,127,3,67,936,869
23,127,4,149,1097,948
23,127,5,99,1048,949
23,127,6,113,978,865
23,128,0,44,866,822
23,128,1,130,1078,948
23,128,2,62,983,921
23,128,3,106,954,848
23,128,4,159,1057,898
23,128,5,111,1003,892
23,128,6,141,978,837
23,129,0,60,817,757
23,129,1,124,1039,915
23,129,2,67,1020,953
23,129,3,45,867,822
23,129,4,138,1099,961
23,129,5,119,980,861
23,129,6,119,923,804
23,130,0,61,845,784
23,130,1,181,1011,830
23,130,2,43,911,868
23,130,3,72,882,810
23,130,4,143,1040,897
23,130,5,217,1073,856
23,130,6,113,846,733
23,131,0,55,753,698
23,131,1,122,930,808
23,131,2,50,942,892
23,131,3,54,810,756
23,131,4,178,1129,951
23,131,5,330,1215,885
23,131,6,103,831,728
23,132,0,59,800,741
23,132,1,91,876,785
23,132,2,62,933,871
23,132,3,34,767,733
23,132,4,163,1070,907
23,132,5,379,1202,823
23,132,6,100,839,739
23,133,0,50,705,655
23,133,1,107,784,677
23,133,2,34,774,740
23,133,3,44,745,701
23,133,4,140,920,780
23,133,5,425,1209,784
23,133,6,100,783,683
23,134,0,32,597,565
23,134,1,41,728,687
23,134,2,39,738,699
23,134,3,22,629,607
23,134,4,94,817,723
23,134,5,308,1050,742
23,134,6,61,711,650
23,135,0,20,519,499
23,135,1,34,610,576
23,135,2,25,588,563
23,135,3,26,605,579
23,135,4,64,742,678
23,135,5,232,877,645
23,135,6,48,629,581
23,136,0,15,506,491
23,136,1,18,545,527
23,136,2,13,559,546
23,136,3,21,573,552
23,136,4,43,693,650
23,136,5,94,733,639
23,136,6,95,630,535
23,137,0,18,463,445
23,137,1,18,487,469
23,137,2,23,469,446
23,137,3,18,461,443
23,137,4,25,544,519
23,137,5,56,646,590
23,137,6,58,569,511
23,138,0,15,432,417
23,138,1,13,377,364
23,138,2,12,410,398
23,138,3,17,446,429
23,138,4,30,511,481
23,138,5,42,597,555
23,138,6,104,513,409
23,139,0,13,423,410
23,139,1,13,405,392
23,139,2,16,411,395
23,139,3,16,425,409
23,139,4,27,477,450
23,139,5,42,538,496
23,139,6,105,504,399
23,140,0,16,355,339
23,140,1,29,377,348
23,140,2,17,399,382
23,140,3,12,352,340
23,140,4,21,507,486
23,140,5,48,532,484
23,140,6,47,442,395
23,141,0,33,375,342
23,141,1,23,389,366
23,141,2,17,428,411
23,141,3,30,441,411
23,141,4,31,496,465
23,141,5,34,529,495
23,141,6,44,421,377
23,142,0,26,355,329
23,142,1,24,382,358
23,142,2,21,404,383
23,142,3,28,332,304
23,142,4,36,452,416
23,142,5,40,466,426
23,142,6,60,373,313
23,143,0,53,336,283
23,143,1,21,344,323
23,143,2,27,339,312
23,143,3,44,393,349
23,143,4,29,408,379
23,143,5,45,426,381
23,143,6,42,353,311
24,0,0,6,100,94
24,0,1,4,74,70
24,0,2,6,81,75
24,0,3,4,82,78
24,0,4,16,124,108
24,0,5,4,109,105
24,0,6,11,152,141
24,1,0,8,79,71
24,1,1,11,70,59
24,1,2,4,64,60
24,1,3,7,74,67
24,1,4,7,107,100
24,1,5,4,83,79
24,1,6,7,112,105
24,2,0,6,76,70
24,2,1,9,82,73
24,2,2,3,57,54
24,2,3,2,75,73
24,2,4,9,109,100
24,2,5,2,93,91
24,2,6,4,83,79
24,3,0,10,81,71
24,3,1,2,61,59
24,3,2,4,73,69
24,3,3,5,55,50
24,3,4,4,98,94
24,3,5,3,86,83
24,3,6,4,121,117
24,4,0,6,58,52
24,4,1,0,35,35
24,4,2,3,51,48
24,4,3,5,66,61
24,4,4,1,85,84
24,4,5,7,94,87
24,4,6,10,92,82
24,5,0,1,56,55
24,5,1,5,55,50
24,5,2,3,49,46
24,5,3,4,66,62
24,5,4,2,86,84
24,5,5,4,71,67
24,5,6,5,91,86
24,6,0,6,60,54
24,6,1,7,52,45
24,6,2,3,48,45
24,6,3,3,56,53
24,6,4,4,84,80
24,6,5,4,62,58
24,6,6,10,95,85
24,7,0,6,59,53
24,7,1,0,25,25
24,7,2,4,53,49
24,7,3,2,31,29
24,7,4,3,63,60
24,7,5,3,66,63
24,7,6,4,82,78
24,8,0,5,39,34
24,8,1,0,34,34
24,8,2,0,39,39
24,8,3,3,49,46
24,8,4,2,69,67
24,8,5,4,51,47
24,8,6,6,61,55
24,9,0,3,41,38
24,9,1,4,38,34
24,9,2,4,41,37
24,9,3,5,46,41
24,9,4,2,57,55
24,9,5,3,58,55
24,9,6,6,63,57
24,10,0,1,35,34
24,10,1,4,36,32
24,10,2,6,50,44
24,10,3,3,40,37
24,10,4,6,59,53
24,10,5,0,47,47
24,10,6,3,66,63
24,11,0,4,40,36
24,11,1,4,38,34
24,11,2,4,30,26
24,11,3,3,36,33
24,11,4,3,54,51
24,11,5,4,40,36
24,11,6,0,41,41
24,12,0,2,39,37
24,12,1,5,33,28
24,12,2,2,34,32
24,12,3,8,39,31
24,12,4,1,47,46
24,12,5,2,48,46
24,12,6,4,43,39
24,13,0,4,29,25
24,13,1,5,41,36
24,13,2,8,46,38
24,13,3,10,38,28
24,13,4,2,38,36
24,13,5,7,44,37
24,13,6,9,48,39
24,14,0,2,20,18
24,14,1,4,26,22
24,14,2,4,21,17
24,14,3,9,38,29
24,14,4,4,47,43
24,14,5,4,41,37
24,14,6,8,55,47
24,15,0,3,40,37
24,15,1,7,35,28
24,15,2,1,22,21
24,15,3,2,23,21
24,15,4,10,40,30
24,15,5,4,30,26
24,15,6,0,35,35
24,16,0,2,29,27
24,16,1,6,35,29
24,16,2,0,17,17
24,16,3,6,31,25
24,16,4,4,37,33
24,16,5,3,30,27
24,16,6,5,40,35
24,17,0,9,34,25
24,17,1,1,29,28
24,17,2,7,31,24
24,17,3,6,24,18
24,17,4,5,34,29
24,17,5,3,30,27
24,17,6,1,25,24
24,18,0,3,23,20
24,18,1,0,14,14
24,18,2,6,30,24
24,18,3,3,22,19
24,18,4,5,38,33
24,18,5,4,27,23
24,18,6,4,32,28
24,19,0,2,20,18
24,19,1,2,22,20
24,19,2,12,34,22
24,19,3,0,14,14
24,19,4,9,30,21
24,19,5,8,25,17
24,19,6,3,30,27
24,20,0,0,12,12
24,20,1,0,8,8
24,20,2,1,19,18
24,20,3,3,18,15
24,20,4,1,22,21
24,20,5,6,25,19
24,20,6,5,18,13
24,21,0,1,16,15
24,21,1,1,17,16
24,21,2,3,15,12
24,21,3,0,6,6
24,21,4,4,24,20
24,21,5,1,16,15
24,21,6,4,21,17
24,22,0,3,12,9
24,22,1,0,12,12
24,22,2,0,8,8
24,22,3,1,11,10
24,22,4,5,19,14
24,22,5,3,26,23
24,22,6,1,23,22
24,23,0,1,20,19
24,23,1,1,11,10
24,23,2,0,9,9
24,23,3,4,14,10
24,23,4,16,35,19
24,23,5,3,32,29
24,23,6,2,26,24
24,24,0,1,10,9
24,24,1,3,16,13
24,24,2,0,8,8
24,24,3,1,15,14
24,24,4,16,30,14
24,24,5,3,17,14
24,24,6,1,12,11
24,25,0,0,9,9
24,25,1,2,8,6
24,25,2,1,9,8
24,25,3,1,9,8
24,25,4,12,26,14
24,25,5,0,12,12
24,25,6,1,15,14
24,26,0,1,10,9
24,26,1,0,7,7
24,26,2,3,14,11
24,26,3,2,7,5
24,26,4,3,9,6
24,26,5,5,16,11
24,26,6,2,11,9
24,27,0,2,12,10
24,27,1,5,12,7
24,27,2,2,8,6
24,27,3,2,11,9
24,27,4,11,21,10
24,27,5,3,7,4
24,27,6,4,15,11
24,28,0,2,11,9
24,28,1,17,24,7
24,28,2,4,9,5
24,28,3,1,6,5
24,28,4,6,14,8
24,28,5,2,8,6
24,28,6,8,17,9
24,29,0,6,21,15
24,29,1,13,26,13
24,29,2,3,9,6
24,29,3,4,12,8
24,29,4,1,18,17
24,29,5,3,13,10
24,29,6,5,18,13
24,30,0,2,12,10
24,30,1,8,12,4
24,30,2,0,4,4
24,30,3,4,12,8
24,30,4,6,17,11
24,30,5,3,13,10
24,30,6,8,18,10
24,31,0,14,20,6
24,31,1,2,11,9
24,31,2,6,19,13
24,31,3,8,17,9
24,31,4,14,31,17
24,31,5,5,11,6
24,31,6,3,10,7
24,32,0,9,23,14
24,32,1,19,31,12
24,32,2,10,24,14
24,32,3,10,22,12
24,32,4,20,38,18
24,32,5,5,20,15
24,32,6,4,13,9
24,33,0,2,13,11
24,33,1,20,33,13
24,33,2,7,21,14
24,33,3,9,22,13
24,33,4,41,59,18
24,33,5,11,19,8
24,33,6,3,14,11
24,34,0,12,25,13
24,34,1,16,33,17
24,34,2,4,23,19
24,34,3,7,19,12
24,34,4,43,51,8
24,34,5,10,25,15
24,34,6,3,14,11
24,35,0,25,35,10
24,35,1,8,21,13
24,35,2,8,24,16
24,35,3,10,25,15
24,35,4,35,49,14
24,35,5,9,25,16
24,35,6,5,16,11
24,36,0,35,57,22
24,36,1,19,45,26
24,36,2,14,36,22
24,36,3,13,38,25
24,36,4,41,62,21
24,36,5,13,41,28
24,36,6,17,31,14
24,37,0,26,52,26
24,37,1,24,37,13
24,37,2,12,25,13
24,37,3,18,43,25
24,37,4,48,73,25
24,37,5,7,37,30
24,37,6,13,38,25
24,38,0,31,65,34
24,38,1,29,52,23
24,38,2,20,55,35
24,38,3,28,63,35
24,38,4,59,90,31
24,38,5,7,35,28
24,38,6,20,38,18
24,39,0,12,130,118
24,39,1,3,118,115
24,39,2,1,112,111
24,39,3,4,114,110
24,39,4,42,133,91
24,39,5,4,55,51
24,39,6,11,58,47
24,40,0,9,172,163
24,40,1,9,133,124
24,40,2,5,122,117
24,40,3,2,95,93
24,40,4,63,153,90
24,40,5,8,73,65
24,40,6,9,61,52
24,41,0,9,181,172
24,41,1,7,165,158
24,41,2,8,168,160
24,41,3,9,132,123
24,41,4,67,184,117
24,41,5,9,95,86
24,41,6,9,65,56
24,42,0,15,261,246
24,42,1,6,253,247
24,42,2,8,267,259
24,42,3,5,237,232
24,42,4,121,294,173
24,42,5,18,130,112
24,42,6,16,123,107
24,43,0,18,307,289
24,43,1,8,291,283
24,43,2,6,259,253
24,43,3,12,299,287
24,43,4,90,291,201
24,43,5,16,139,123
24,43,6,17,103,86
24,44,0,96,494,398
24,44,1,16,362,346
24,44,2,10,364,354
24,44,3,54,422,368
24,44,4,81,373,292
24,44,5,28,181,153
24,44,6,39,173,134
24,45,0,234,667,433
24,45,1,59,539,480
24,45,2,102,583,481
24,45,3,198,613,415
24,45,4,118,503,385
24,45,5,16,257,241
24,45,6,77,239,162
24,46,0,569,1045,476
24,46,1,269,871,602
24,46,2,310,916,606
24,46,3,248,828,580
24,46,4,292,708,416
24,46,5,62,365,303
24,46,6,65,252,187
24,47,0,948,1375,427
24,47,1,1000,1562,562
24,47,2,755,1300,545
24,47,3,442,1035,593
24,47,4,594,1036,442
24,47,5,142,445,303
24,47,6,56,259,203
24,48,0,1075,1524,449
24,48,1,1280,1709,429
24,48,2,811,1298,487
24,48,3,482,1020,538
24,48,4,623,1010,387
24,48,5,244,549,305
24,48,6,60,254,194
24,49,0,791,1196,405
24,49,1,769,1253,484
24,49,2,642,1128,486
24,49,3,387,901,514
24,49,4,541,918,377
24,49,5,164,458,294
24,49,6,92,334,242
24,50,0,688,1144,456
24,50,1,662,1177,515
24,50,2,491,1004,513
24,50,3,248,793,545
24,50,4,403,803,400
24,50,5,103,449,346
24,50,6,81,312,231
24,51,0,754,1184,430
24,51,1,752,1207,455
24,51,2,558,1052,494
24,51,3,367,859,492
24,51,4,342,741,399
24,51,5,144,453,309
24,51,6,117,361,244
24,52,0,580,1040,460
24,52,1,541,1042,501
24,52,2,430,916,486
24,52,3,363,807,444
24,52,4,312,699,387
24,52,5,201,500,299
24,52,6,99,366,267
24,53,0,361,839,478
24,53,1,244,735,491
24,53,2,228,749,521
24,53,3,188,716,528
24,53,4,195,646,451
24,53,5,109,458,349
24,53,6,79,339,260
24,54,0,177,695,518
24,54,1,163,702,539
24,54,2,71,549,478
24,54,3,119,673,554
24,54,4,109,509,400
24,54,5,45,349,304
24,54,6,35,283,248
24,55,0,158,632,474
24,55,1,167,618,451
24,55,2,81,545,464
24,55,3,140,614,474
24,55,4,195,546,351
24,55,5,71,345,274
24,55,6,29,304,275
24,56,0,101,471,370
24,56,1,104,480,376
24,56,2,70,473,403
24,56,3,103,532,429
24,56,4,179,483,304
24,56,5,46,324,278
24,56,6,48,293,245
24,57,0,111,404,293
24,57,1,186,499,313
24,57,2,147,434,287
24,57,3,124,456,332
24,57,4,173,424,251
24,57,5,103,350,247
24,57,6,62,335,273
24,58,0,140,396,256
24,58,1,138,417,279
24,58,2,175,454,279
24,58,3,157,449,292
24,58,4,168,410,242
24,58,5,157,403,246
24,58,6,57,298,241
24,59,0,112,336,224
24,59,1,94,350,256
24,59,2,105,359,254
24,59,3,137,385,248
24,59,4,186,386,200
24,59,5,124,378,254
24,59,6,36,273,237
24,60,0,67,288,221
24,60,1,79,301,222
24,60,2,76,313,237
24,60,3,83,294,211
24,60,4,150,375,225
24,60,5,107,364,257
24,60,6,62,331,269
24,61,0,46,272,226
24,61,1,30,243,213
24,61,2,69,253,184
24,61,3,59,277,218
24,61,4,143,368,225
24,61,5,145,393,248
24,61,6,115,337,222
24,62,0,42,226,184
24,62,1,19,198,179
24,62,2,54,264,210
24,62,3,52,266,214
24,62,4,142,337,195
24,62,5,141,379,238
24,62,6,55,289,234
24,63,0,20,189,169
24,63,1,35,207,172
24,63,2,55,246,191
24,63,3,32,223,191
24,63,4,175,354,179
24,63,5,111,337,226
24,63,6,64,296,232
24,64,0,31,205,174
24,64,1,23,198,175
24,64,2,90,264,174
24,64,3,62,290,228
24,64,4,171,343,172
24,64,5,163,421,258
24,64,6,65,269,204
24,65,0,23,196,173
24,65,1,21,174,153
24,65,2,69,240,171
24,65,3,80,286,206
24,65,4,154,327,173
24,65,5,166,379,213
24,65,6,104,324,220
24,66,0,22,192,170
24,66,1,24,197,173
24,66,2,74,233,159
24,66,3,49,235,186
24,66,4,139,300,161
24,66,5,197,415,218
24,66,6,84,311,227
24,67,0,17,186,169
24,67,1,24,162,138
24,67,2,76,232,156
24,67,3,36,213,177
24,67,4,163,320,157
24,67,5,135,350,215
24,67,6,117,324,207
24,68,0,19,192,173
24,68,1,50,229,179
24,68,2,92,239,147
24,68,3,42,200,158
24,68,4,174,349,175
24,68,5,199,401,202
24,68,6,103,336,233
24,69,0,33,211,178
24,69,1,25,191,166
24,69,2,72,239,167
24,69,3,88,276,188
24,69,4,171,329,158
24,69,5,240,448,208
24,69,6,176,395,219
24,70,0,31,191,160
24,70,1,35,196,161
24,70,2,72,238,166
24,70,3,82,274,192
24,70,4,173,333,160
24,70,5,198,437,239
24,70,6,126,369,243
24,71,0,39,228,189
24,71,1,77,240,163
24,71,2,36,217,181
24,71,3,59,239,180
24,71,4,128,317,189
24,71,5,162,399,237
24,71,6,121,374,253
24,72,0,40,218,178
24,72,1,74,245,171
24,72,2,33,240,207
24,72,3,20,203,183
24,72,4,141,304,163
24,72,5,125,363,238
24,72,6,55,337,282
24,73,0,24,224,200
24,73,1,47,201,154
24,73,2,62,268,206
24,73,3,42,241,199
24,73,4,115,302,187
24,73,5,180,428,248
24,73,6,42,340,298
24,74,0,30,208,178
24,74,1,67,261,194
24,74,2,17,207,190
24,74,3,47,223,176
24,74,4,120,293,173
24,74,5,143,399,256
24,74,6,33,300,267
24,75,0,38,228,190
24,75,1,49,213,164
24,75,2,31,237,206
24,75,3,24,234,210
24,75,4,126,328,202
24,75,5,148,402,254
24,75,6,53,357,304
24,76,0,46,279,233
24,76,1,42,248,206
24,76,2,42,220,178
24,76,3,40,247,207
24,76,4,126,329,203
24,76,5,136,376,240
24,76,6,91,403,312
24,77,0,31,218,187
24,77,1,93,283,190
24,77,2,30,235,205
24,77,3,56,258,202
24,77,4,142,333,191
24,77,5,139,386,247
24,77,6,62,376,314
24,78,0,48,258,210
24,78,1,92,289,197
24,78,2,84,300,216
24,78,3,67,290,223
24,78,4,149,341,192
24,78,5,160,404,244
24,78,6,68,381,313
24,79,0,60,265,205
24,79,1,83,275,192
24,79,2,114,294,180
24,79,3,53,262,209
24,79,4,128,336,208
24,79,5,196,445,249
24,79,6,157,464,307
24,80,0,55,247,192
24,80,1,98,274,176
24,80,2,101,306,205
24,80,3,38,234,196
24,80,4,150,326,176
24,80,5,226,473,247
24,80,6,96,401,305
24,81,0,65,259,194
24,81,1,58,252,194
24,81,2,52,242,190
24,81,3,64,267,203
24,81,4,116,329,213
24,81,5,243,501,258
24,81,6,77,384,307
24,82,0,66,254,188
24,82,1,56,224,168
24,82,2,67,256,189
24,82,3,47,243,196
24,82,4,102,290,188
24,82,5,196,428,232
24,82,6,75,373,298
24,83,0,48,217,169
24,83,1,51,216,165
24,83,2,63,230,167
24,83,3,30,240,210
24,83,4,88,261,173
24,83,5,227,494,267
24,83,6,126,394,268
24,84,0,38,194,156
24,84,1,54,249,195
24,84,2,68,233,165
24,84,3,34,192,158
24,84,4,97,291,194
24,84,5,184,469,285
24,84,6,115,411,296
24,85,0,47,235,188
24,85,1,36,213,177
24,85,2,46,219,173
24,85,3,31,187,156
24,85,4,118,295,177
24,85,5,122,382,260
24,85,6,87,352,265
24,86,0,47,229,182
24,86,1,28,206,178
24,86,2,76,263,187
24,86,3,20,217,197
24,86,4,82,278,196
24,86,5,97,368,271
24,86,6,43,319,276
24,87,0,48,224,176
24,87,1,19,206,187
24,87,2,21,190,169
24,87,3,21,211,190
24,87,4,119,281,162
24,87,5,87,356,269
24,87,6,59,347,288
24,88,0,15,192,177
24,88,1,9,182,173
24,88,2,13,182,169
24,88,3,32,201,169
24,88,4,91,273,182
24,88,5,31,281,250
24,88,6,27,295,268
24,89,0,11,183,172
24,89,1,8,192,184
24,89,2,35,227,192
24,89,3,20,189,169
24,89,4,85,272,187
24,89,5,12,256,244
24,89,6,13,258,245
24,90,0,18,186,168
24,90,1,5,157,152
24,90,2,29,222,193
24,90,3,19,186,167
24,90,4,126,333,207
24,90,5,19,262,243
24,90,6,17,294,277
24,91,0,32,201,169
24,91,1,13,190,177
24,91,2,55,234,179
24,91,3,18,178,160
24,91,4,99,260,161
24,91,5,21,259,238
24,91,6,16,275,259
24,92,0,54,234,180
24,92,1,33,186,153
24,92,2,52,246,194
24,92,3,16,200,184
24,92,4,87,289,202
24,92,5,32,275,243
24,92,6,10,267,257
24,93,0,7,165,158
24,93,1,10,204,194
24,93,2,14,198,184
24,93,3,0,172,172
24,93,4,7,229,222
24,93,5,9,228,219
24,93,6,11,279,268
24,94,0,13,181,168
24,94,1,6,174,168
24,94,2,6,198,192
24,94,3,5,213,208
24,94,4,6,189,183
24,94,5,25,277,252
24,94,6,13,250,237
24,95,0,5,187,182
24,95,1,13,177,164
24,95,2,20,206,186
24,95,3,6,201,195
24,95,4,5,252,247
24,95,5,40,283,243
24,95,6,57,346,289
24,96,0,2,179,177
24,96,1,9,195,186
24,96,2,6,189,183
24,96,3,10,221,211
24,96,4,13,250,237
24,96,5,11,275,264
24,96,6,5,294,289
24,97,0,5,159,154
24,97,1,7,220,213
24,97,2,11,226,215
24,97,3,9,194,185
24,97,4,5,201,196
24,97,5,7,248,241
24,97,6,8,275,267
24,98,0,5,193,188
24,98,1,6,191,185
24,98,2,8,232,224
24,98,3,10,221,211
24,98,4,5,245,240
24,98,5,13,271,258
24,98,6,6,249,243
24,99,0,12,204,192
24,99,1,5,182,177
24,99,2,12,221,209
24,99,3,12,212,200
24,99,4,16,252,236
24,99,5,14,283,269
24,99,6,11,304,293
24,100,0,8,205,197
24,100,1,2,215,213
24,100,2,36,250,214
24,100,3,15,247,232
24,100,4,18,246,228
24,100,5,12,267,255
24,100,6,5,294,289
24,101,0,1,213,212
24,101,1,6,251,245
24,101,2,19,262,243
24,101,3,8,213,205
24,101,4,11,253,242
24,101,5,9,288,279
24,101,6,8,310,302
24,102,0,1,245,244
24,102,1,16,293,277
24,102,2,42,307,265
24,102,3,5,256,251
24,102,4,9,292,283
24,102,5,7,292,285
24,102,6,9,303,294
24,103,0,10,230,220
24,103,1,6,241,235
24,103,2,48,317,269
24,103,3,6,261,255
24,103,4,8,275,267
24,103,5,10,298,288
24,103,6,5,299,294
24,104,0,4,253,249
24,104,1,5,263,258
24,104,2,55,302,247
24,104,3,6,251,245
24,104,4,10,306,296
24,104,5,9,304,295
24,104,6,8,297,289
24,105,0,11,251,240
24,105,1,9,274,265
24,105,2,67,337,270
24,105,3,22,312,290
24,105,4,24,340,316
24,105,5,11,311,300
24,105,6,16,293,277
24,106,0,5,239,234
24,106,1,9,267,258
24,106,2,61,348,287
24,106,3,21,301,280
24,106,4,28,324,296
24,106,5,17,291,274
24,106,6,7,323,316
24,107,0,11,241,230
24,107,1,15,287,272
24,107,2,47,335,288
24,107,3,12,258,246
24,107,4,14,293,279
24,107,5,6,292,286
24,107,6,6,271,265
24,108,0,14,290,276
24,108,1,7,253,246
24,108,2,82,359,277
24,108,3,11,276,265
24,108,4,17,337,320
24,108,5,13,335,322
24,108,6,10,289,279
24,109,0,17,246,229
24,109,1,15,267,252
24,109,2,40,308,268
24,109,3,7,262,255
24,109,4,16,279,263
24,109,5,13,298,285
24,109,6,3,267,264
24,110,0,7,224,217
24,110,1,6,257,251
24,110,2,32,334,302
24,110,3,11,243,232
24,110,4,11,280,269
24,110,5,13,308,295
24,110,6,8,246,238
24,111,0,7,254,247
24,111,1,7,270,263
24,111,2,31,307,276
24,111,3,12,226,214
24,111,4,7,265,258
24,111,5,11,289,278
24,111,6,10,274,264
24,112,0,3,229,226
24,112,1,7,244,237
24,112,2,11,271,260
24,112,3,7,229,222
24,112,4,11,264,253
24,112,5,13,280,267
24,112,6,7,268,261
24,113,0,7,247,240
24,113,1,15,248,233
24,113,2,15,271,256
24,113,3,9,253,244
24,113,4,10,223,213
24,113,5,10,289,279
24,113,6,11,264,253
24,114,0,9,246,237
24,114,1,7,220,213
24,114,2,3,248,245
24,114,3,16,243,227
24,114,4,6,231,225
24,114,5,8,272,264
24,114,6,7,261,254
24,115,0,6,201,195
24,115,1,3,191,188
24,115,2,8,276,268
24,115,3,5,196,191
24,115,4,5,243,238
24,115,5,8,278,270
24,115,6,14,242,228
24,116,0,6,198,192
24,116,1,11,219,208
24,116,2,7,230,223
24,116,3,9,215,206
24,116,4,9,258,249
24,116,5,17,280,263
24,116,6,11,257,246
24,117,0,5,186,181
24,117,1,12,222,210
24,117,2,14,241,227
24,117,3,9,215,206
24,117,4,11,238,227
24,117,5,10,253,243
24,117,6,6,223,217
24,118,0,9,201,192
24,118,1,6,207,201
24,118,2,5,222,217
24,118,3,1,227,226
24,118,4,10,245,235
24,118,5,10,219,209
24,118,6,8,221,213
24,119,0,8,207,199
24,119,1,8,189,181
24,119,2,9,233,224
24,119,3,9,203,194
24,119,4,4,210,206
24,119,5,10,222,212
24,119,6,19,275,256
24,120,0,11,274,263
24,120,1,5,220,215
24,120,2,7,251,244
24,120,3,7,251,244
24,120,4,6,242,236
24,120,5,9,280,271
24,120,6,20,258,238
24,121,0,7,209,202
24,121,1,7,190,183
24,121,2,5,257,252
24,121,3,12,192,180
24,121,4,9,256,247
24,121,5,7,215,208
24,121,6,14,232,218
24,122,0,10,223,213
24,122,1,7,225,218
24,122,2,9,253,244
24,122,3,11,218,207
24,122,4,7,216,209
24,122,5,5,259,254
24,122,6,6,241,235
24,123,0,5,202,197
24,123,1,4,203,199
24,123,2,13,285,272
24,123,3,8,216,208
24,123,4,11,279,268
24,123,5,15,264,249
24,123,6,7,228,221
24,124,0,6,218,212
24,124,1,16,234,218
24,124,2,8,233,225
24,124,3,9,207,198
24,124,4,11,250,239
24,124,5,12,273,261
24,124,6,6,236,230
24,125,0,9,192,183
24,125,1,12,206,194
24,125,2,10,249,239
24,125,3,7,222,215
24,125,4,2,263,261
24,125,5,10,275,265
24,125,6,15,252,237
24,126,0,12,232,220
24,126,1,9,229,220
24,126,2,11,266,255
24,126,3,11,209,198
24,126,4,7,262,255
24,126,5,13,263,250
24,126,6,13,229,216
24,127,0,7,194,187
24,127,1,7,263,256
24,127,2,12,252,240
24,127,3,9,233,224
24,127,4,8,280,272
24,127,5,10,257,247
24,127,6,13,240,227
24,128,0,17,232,215
24,128,1,6,201,195
24,128,2,6,224,218
24,128,3,16,208,192
24,128,4,15,258,243
24,128,5,12,254,242
24,128,6,7,218,211
24,129,0,7,185,178
24,129,1,5,169,164
24,129,2,11,214,203
24,129,3,7,190,183
24,129,4,7,231,224
24,129,5,10,238,228
24,129,6,9,225,216
24,130,0,5,167,162
24,130,1,5,158,153
24,130,2,7,215,208
24,130,3,7,189,182
24,130,4,10,245,235
24,130,5,16,258,242
24,130,6,8,184,176
24,131,0,8,190,182
24,131,1,14,195,181
24,131,2,5,163,158
24,131,3,9,208,199
24,131,4,6,236,230
24,131,5,24,308,284
24,131,6,6,197,191
24,132,0,6,199,193
24,132,1,10,177,167
24,132,2,8,210,202
24,132,3,10,207,197
24,132,4,15,223,208
24,132,5,12,256,244
24,132,6,15,214,199
24,133,0,6,146,140
24,133,1,13,180,167
24,133,2,7,167,160
24,133,3,13,163,150
24,133,4,5,202,197
24,133,5,12,232,220
24,133,6,9,182,173
24,134,0,3,119,116
24,134,1,6,137,131
24,134,2,6,154,148
24,134,3,5,131,126
24,134,4,6,191,185
24,134,5,10,216,206
24,134,6,3,143,140
24,135,0,8,125,117
24,135,1,3,116,113
24,135,2,5,141,136
24,135,3,7,111,104
24,135,4,9,163,154
24,135,5,12,206,194
24,135,6,13,150,137
24,136,0,4,102,98
24,136,1,3,127,124
24,136,2,2,142,140
24,136,3,4,116,112
24,136,4,10,165,155
24,136,5,7,155,148
24,136,6,5,138,133
24,137,0,12,110,98
24,137,1,5,119,114
24,137,2,7,146,139
24,137,3,1,137,136
24,137,4,8,153,145
24,137,5,6,141,135
24,137,6,6,141,135
24,138,0,7,92,85
24,138,1,8,112,104
24,138,2,9,116,107
24,138,3,5,121,116
24,138,4,7,140,133
24,138,5,11,137,126
24,138,6,9,132,123
24,139,0,4,88,84
24,139,1,2,100,98
24,139,2,4,117,113
24,139,3,4,121,117
24,139,4,5,128,123
24,139,5,6,133,127
24,139,6,3,108,105
24,140,0,3,111,108
24,140,1,6,92,86
24,140,2,3,89,86
24,140,3,10,111,101
24,140,4,2,126,124
24,140,5,13,169,156
24,140,6,14,133,119
24,141,0,9,83,74
24,141,1,3,81,78
24,141,2,6,101,95
24,141,3,3,80,77
24,141,4,4,118,114
24,141,5,11,164,153
24,141,6,4,106,102
24,142,0,7,72,65
24,142,1,1,76,75
24,142,2,6,93,87
24,142,3,5,93,88
24,142,4,6,134,128
24,142,5,12,141,129
24,142,6,5,112,107
24,143,0,15,99,84
24,143,1,3,71,68
24,143,2,10,92,82
24,143,3,2,88,86
24,143,4,10,114,104
24,143,5,5,139,134
24,143,6,3,76,73
25,0,0,12,61,49
25,0,1,9,47,38
25,0,2,7,60,53
25,0,3,3,60,57
25,0,4,12,68,56
25,0,5,4,61,57
25,0,6,8,76,68
25,1,0,4,42,38
25,1,1,22,63,41
25,1,2,13,65,52
25,1,3,4,50,46
25,1,4,11,58,47
25,1,5,9,69,60
25,1,6,14,86,72
25,2,0,1,30,29
25,2,1,11,53,42
25,2,2,17,52,35
25,2,3,6,46,40
25,2,4,2,49,47
25,2,5,2,45,43
25,2,6,7,55,48
25,3,0,2,43,41
25,3,1,8,45,37
25,3,2,12,59,47
25,3,3,3,38,35
25,3,4,8,59,51
25,3,5,1,54,53
25,3,6,5,63,58
25,4,0,7,36,29
25,4,1,2,35,33
25,4,2,9,44,35
25,4,3,3,42,39
25,4,4,2,47,45
25,4,5,3,45,42
25,4,6,4,50,46
25,5,0,2,39,37
25,5,1,9,37,28
25,5,2,9,40,31
25,5,3,18,50,32
25,5,4,6,41,35
25,5,5,4,44,40
25,5,6,5,45,40
25,6,0,8,44,36
25,6,1,1,31,30
25,6,2,6,39,33
25,6,3,18,50,32
25,6,4,3,38,35
25,6,5,2,32,30
25,6,6,8,45,37
25,7,0,4,38,34
25,7,1,4,29,25
25,7,2,6,45,39
25,7,3,8,32,24
25,7,4,6,53,47
25,7,5,0,17,17
25,7,6,7,45,38
25,8,0,7,22,15
25,8,1,1,26,25
25,8,2,7,28,21
25,8,3,2,20,18
25,8,4,5,26,21
25,8,5,3,24,21
25,8,6,8,30,22
25,9,0,5,20,15
25,9,1,0,17,17
25,9,2,5,24,19
25,9,3,17,36,19
25,9,4,9,41,32
25,9,5,7,39,32
25,9,6,10,37,27
25,10,0,5,20,15
25,10,1,6,25,19
25,10,2,5,23,18
25,10,3,4,19,15
25,10,4,3,25,22
25,10,5,5,29,24
25,10,6,3,27,24
25,11,0,6,19,13
25,11,1,6,24,18
25,11,2,3,22,19
25,11,3,11,25,14
25,11,4,1,23,22
25,11,5,6,28,22
25,11,6,0,15,15
25,12,0,10,27,17
25,12,1,4,23,19
25,12,2,3,11,8
25,12,3,5,19,14
25,12,4,0,16,16
25,12,5,0,17,17
25,12,6,2,19,17
25,13,0,6,20,14
25,13,1,2,11,9
25,13,2,1,20,19
25,13,3,5,17,12
25,13,4,7,27,20
25,13,5,4,25,21
25,13,6,2,27,25
25,14,0,1,10,9
25,14,1,11,23,12
25,14,2,10,20,10
25,14,3,3,8,5
25,14,4,3,9,6
25,14,5,4,24,20
25,14,6,2,17,15
25,15,0,3,11,8
25,15,1,5,14,9
25,15,2,12,20,8
25,15,3,9,15,6
25,15,4,0,7,7
25,15,5,3,14,11
25,15,6,12,27,15
25,16,0,3,9,6
25,16,1,2,5,3
25,16,2,2,10,8
25,16,3,10,21,11
25,16,4,2,10,8
25,16,5,3,12,9
25,16,6,16,28,12
25,17,0,0,5,5
25,17,1,3,13,10
25,17,2,1,10,9
25,17,3,2,12,10
25,17,4,6,15,9
25,17,5,0,6,6
25,17,6,2,11,9
25,18,0,9,12,3
25,18,1,2,15,13
25,18,2,8,16,8
25,18,3,3,12,9
25,18,4,7,20,13
25,18,5,3,17,14
25,18,6,1,11,10
25,19,0,2,7,5
25,19,1,2,6,4
25,19,2,10,13,3
25,19,3,4,11,7
25,19,4,3,10,7
25,19,5,4,12,8
25,19,6,3,8,5
25,20,0,4,5,1
25,20,1,5,12,7
25,20,2,9,15,6
25,20,3,11,19,8
25,20,4,9,11,2
25,20,5,1,7,6
25,20,6,2,9,7
25,21,0,1,4,3
25,21,1,3,6,3
25,21,2,8,11,3
25,21,3,5,8,3
25,21,4,2,8,6
25,21,5,2,9,7
25,21,6,3,7,4
25,22,0,1,3,2
25,22,1,0,1,1
25,22,2,5,5,0
25,22,3,6,9,3
25,22,4,8,11,3
25,22,5,1,5,4
25,22,6,9,14,5
25,23,0,5,6,1
25,23,1,3,6,3
25,23,2,5,10,5
25,23,3,0,3,3
25,23,4,5,10,5
25,23,5,2,11,9
25,23,6,2,4,2
25,24,0,1,3,2
25,24,1,6,8,2
25,24,2,7,8,1
25,24,3,5,6,1
25,24,4,2,7,5
25,24,5,6,9,3
25,24,6,3,5,2
25,25,0,0,1,1
25,25,1,10,12,2
25,25,2,7,10,3
25,25,3,0,3,3
25,25,4,1,5,4
25,25,5,0,3,3
25,25,6,1,4,3
25,26,0,3,5,2
25,26,1,2,5,3
25,26,2,3,7,4
25,26,4,2,11,9
25,26,5,1,4,3
25,26,6,1,4,3
25,27,0,0,1,1
25,27,1,1,1,0
25,27,2,4,7,3
25,27,3,0,1,1
25,27,4,1,4,3
25,27,5,1,6,5
25,27,6,1,2,1
25,28,0,2,4,2
25,28,1,1,1,0
25,28,2,12,16,4
25,28,3,0,2,2
25,28,4,0,2,2
25,28,5,1,2,1
25,28,6,1,2,1
25,29,0,2,7,5
25,29,1,5,9,4
25,29,2,4,10,6
25,29,3,1,1,0
25,29,4,2,4,2
25,29,5,1,4,3
25,29,6,1,2,1
25,30,0,2,2,0
25,30,1,4,7,3
25,30,2,2,6,4
25,30,3,1,5,4
25,30,4,3,9,6
25,30,5,0,2,2
25,30,6,2,6,4
25,31,0,2,4,2
25,31,1,8,9,1
25,31,2,1,5,4
25,31,3,6,9,3
25,31,4,1,3,2
25,31,5,4,6,2
25,31,6,0,2,2
25,32,0,3,7,4
25,32,1,5,7,2
25,32,2,0,4,4
25,32,3,2,3,1
25,32,4,5,6,1
25,32,5,6,6,0
25,32,6,0,3,3
25,33,0,4,7,3
25,33,1,2,5,3
25,33,2,0,1,1
25,33,3,6,8,2
25,33,4,4,6,2
25,33,5,8,13,5
25,33,6,1,1,0
25,34,0,7,9,2
25,34,1,0,2,2
25,34,3,0,3,3
25,34,4,6,9,3
25,34,5,6,10,4
25,34,6,1,4,3
25,35,0,4,12,8
25,35,1,0,4,4
25,35,2,0,3,3
25,35,3,4,8,4
25,35,4,2,8,6
25,35,5,6,11,5
25,35,6,4,7,3
25,36,0,1,7,6
25,36,1,0,7,7
25,36,2,1,10,9
25,36,3,2,6,4
25,36,4,2,8,6
25,36,5,6,10,4
25,36,6,2,7,5
25,37,0,3,13,10
25,37,1,1,9,8
25,37,2,4,9,5
25,37,3,1,6,5
25,37,4,3,12,9
25,37,5,3,6,3
25,37,6,0,3,3
25,38,0,5,19,14
25,38,1,10,21,11
25,38,2,5,13,8
25,38,3,2,8,6
25,38,4,6,19,13
25,38,5,0,5,5
25,38,6,4,9,5
25,39,0,0,33,33
25,39,1,0,24,24
25,39,2,3,25,22
25,39,3,1,24,23
25,39,4,5,26,21
25,39,5,3,22,19
25,39,6,4,16,12
25,40,0,2,44,42
25,40,1,0,24,24
25,40,2,1,29,28
25,40,3,3,18,15
25,40,4,6,34,28
25,40,5,2,20,18
25,40,6,2,24,22
25,41,0,3,52,49
25,41,1,1,38,37
25,41,2,0,39,39
25,41,3,3,56,53
25,41,4,3,34,31
25,41,5,1,20,19
25,41,6,1,22,21
25,42,0,0,78,78
25,42,1,3,57,54
25,42,2,0,49,49
25,42,3,1,56,55
25,42,4,2,46,44
25,42,5,3,27,24
25,42,6,3,34,31
25,43,0,0,102,102
25,43,1,0,81,81
25,43,2,1,73,72
25,43,3,3,81,78
25,43,4,0,56,56
25,43,5,5,45,40
25,43,6,2,27,25
25,44,0,5,99,94
25,44,1,2,76,74
25,44,2,1,104,103
25,44,3,3,92,89
25,44,4,1,80,79
25,44,5,1,56,55
25,44,6,1,32,31
25,45,0,2,148,146
25,45,1,5,118,113
25,45,2,3,157,154
25,45,3,2,154,152
25,45,4,1,97,96
25,45,5,0,69,69
25,45,6,2,52,50
25,46,0,5,174,169
25,46,1,1,174,173
25,46,2,4,177,173
25,46,3,2,165,163
25,46,4,4,133,129
25,46,5,3,84,81
25,46,6,0,55,55
25,47,0,2,183,181
25,47,1,0,144,144
25,47,2,6,180,174
25,47,3,9,215,206
25,47,4,1,134,133
25,47,5,2,90,88
25,47,6,1,73,72
25,48,0,3,226,223
25,48,1,2,230,228
25,48,2,2,230,228
25,48,3,6,238,232
25,48,4,1,166,165
25,48,5,4,99,95
25,48,6,1,92,91
25,49,0,8,298,290
25,49,1,8,313,305
25,49,2,9,319,310
25,49,3,15,339,324
25,49,4,6,209,203
25,49,5,5,144,139
25,49,6,1,96,95
25,50,0,18,319,301
25,50,1,5,305,300
25,50,2,8,311,303
25,50,3,32,334,302
25,50,4,5,224,219
25,50,5,5,130,125
25,50,6,2,112,110
25,51,0,56,342,286
25,51,1,31,338,307
25,51,2,26,346,320
25,51,3,67,378,311
25,51,4,10,269,259
25,51,5,12,176,164
25,51,6,0,143,143
25,52,0,112,337,225
25,52,1,61,309,248
25,52,2,86,300,214
25,52,3,96,318,222
25,52,4,23,214,191
25,52,5,14,124,110
25,52,6,2,126,124
25,53,0,75,249,174
25,53,1,81,270,189
25,53,2,68,253,185
25,53,3,84,269,185
25,53,4,29,212,183
25,53,5,5,104,99
25,53,6,0,103,103
25,54,0,62,238,176
25,54,1,52,227,175
25,54,2,50,233,183
25,54,3,52,258,206
25,54,4,39,198,159
25,54,5,1,98,97
25,54,6,3,96,93
25,55,0,54,197,143
25,55,1,79,231,152
25,55,2,61,247,186
25,55,3,93,274,181
25,55,4,28,162,134
25,55,5,8,109,101
25,55,6,3,97,94
25,56,0,55,193,138
25,56,1,95,226,131
25,56,2,66,213,147
25,56,3,45,202,157
25,56,4,18,137,119
25,56,5,4,111,107
25,56,6,1,79,78
25,57,0,83,178,95
25,57,1,104,210,106
25,57,2,55,172,117
25,57,3,86,197,111
25,57,4,61,179,118
25,57,5,5,117,112
25,57,6,1,80,79
25,58,0,113,209,96
25,58,1,70,182,112
25,58,2,56,166,110
25,58,3,47,156,109
25,58,4,47,149,102
25,58,5,4,106,102
25,58,6,1,82,81
25,59,0,59,157,98
25,59,1,22,118,96
25,59,2,46,156,110
25,59,3,41,157,116
25,59,4,34,117,83
25,59,5,3,104,101
25,59,6,2,82,80
25,60,0,20,112,92
25,60,1,8,93,85
25,60,2,33,128,95
25,60,3,19,121,102
25,60,4,16,106,90
25,60,5,5,93,88
25,60,6,3,93,90
25,61,0,9,80,71
25,61,1,5,81,76
25,61,2,17,120,103
25,61,3,4,97,93
25,61,4,9,86,77
25,61,5,3,102,99
25,61,6,2,94,92
25,62,0,2,80,78
25,62,1,7,104,97
25,62,2,1,92,91
25,62,3,14,107,93
25,62,4,7,100,93
25,62,5,1,113,112
25,62,6,1,93,92
25,63,0,2,92,90
25,63,1,5,101,96
25,63,2,1,81,80
25,63,3,8,101,93
25,63,4,11,92,81
25,63,5,4,109,105
25,63,6,3,112,109
25,64,0,6,78,72
25,64,1,4,82,78
25,64,2,0,85,85
25,64,3,6,99,93
25,64,4,19,105,86
25,64,5,1,89,88
25,64,6,3,108,105
25,65,0,3,95,92
25,65,1,4,76,72
25,65,2,2,82,80
25,65,3,1,59,58
25,65,4,20,113,93
25,65,5,2,102,100
25,65,6,1,97,96
25,66,0,6,74,68
25,66,1,0,83,83
25,66,2,1,75,74
25,66,3,1,65,64
25,66,4,11,85,74
25,66,5,4,99,95
25,66,6,0,83,83
25,67,0,1,76,75
25,67,1,2,76,74
25,67,2,1,83,82
25,67,3,2,82,80
25,67,4,15,106,91
25,67,5,4,107,103
25,67,6,3,85,82
25,68,0,3,93,90
25,68,1,2,82,80
25,68,2,7,92,85
25,68,3,2,87,85
25,68,4,29,103,74
25,68,5,3,89,86
25,68,6,4,103,99
25,69,0,2,86,84
25,69,1,3,95,92
25,69,2,2,87,85
25,69,3,7,88,81
25,69,4,17,83,66
25,69,5,3,105,102
25,69,6,3,106,103
25,70,0,1,75,74
25,70,1,2,68,66
25,70,2,5,88,83
25,70,3,5,93,88
25,70,4,39,114,75
25,70,5,2,103,101
25,70,6,4,91,87
25,71,0,1,71,70
25,71,1,3,101,98
25,71,2,2,75,73
25,71,3,4,83,79
25,71,4,21,97,76
25,71,5,1,110,109
25,71,6,6,112,106
25,72,0,2,99,97
25,72,1,5,101,96
25,72,2,3,95,92
25,72,3,2,96,94
25,72,4,15,87,72
25,72,5,2,87,85
25,72,6,6,102,96
25,73,0,0,62,62
25,73,1,5,83,78
25,73,2,2,85,83
25,73,3,3,91,88
25,73,4,17,97,80
25,73,5,5,103,98
25,73,6,2,86,84
25,74,0,2,72,70
25,74,1,1,77,76
25,74,2,2,80,78
25,74,3,3,94,91
25,74,4,18,97,79
25,74,5,1,113,112
25,74,6,3,103,100
25,75,0,4,81,77
25,75,1,2,113,111
25,75,2,8,77,69
25,75,3,3,95,92
25,75,4,4,85,81
25,75,5,1,99,98
25,75,6,2,110,108
25,76,0,4,89,85
25,76,1,3,97,94
25,76,2,3,100,97
25,76,3,1,102,101
25,76,4,5,85,80
25,76,5,5,108,103
25,76,6,2,117,115
25,77,0,7,86,79
25,77,1,4,66,62
25,77,2,8,103,95
25,77,3,3,104,101
25,77,4,8,92,84
25,77,5,9,122,113
25,77,6,7,114,107
25,78,0,8,92,84
25,78,1,10,119,109
25,78,2,1,87,86
25,78,3,8,95,87
25,78,4,21,95,74
25,78,5,6,129,123
25,78,6,3,121,118
25,79,0,4,101,97
25,79,1,9,108,99
25,79,2,2,97,95
25,79,3,3,104,101
25,79,4,19,97,78
25,79,5,5,116,111
25,79,6,0,97,97
25,80,0,7,90,83
25,80,1,5,93,88
25,80,2,0,74,74
25,80,3,4,101,97
25,80,4,7,93,86
25,80,5,4,126,122
25,80,6,4,118,114
25,81,0,5,92,87
25,81,1,2,86,84
25,81,2,2,87,85
25,81,3,3,89,86
25,81,4,9,88,79
25,81,5,0,100,100
25,81,6,1,105,104
25,82,0,1,73,72
25,82,1,2,89,87
25,82,2,5,91,86
25,82,3,3,90,87
25,82,4,9,119,110
25,82,5,3,98,95
25,82,6,9,137,128
25,83,0,2,98,96
25,83,1,3,68,65
25,83,2,5,101,96
25,83,3,1,98,97
25,83,4,9,92,83
25,83,5,7,93,86
25,83,6,4,123,119
25,84,0,1,96,95
25,84,1,0,68,68
25,84,2,10,80,70
25,84,3,2,84,82
25,84,4,1,89,88
25,84,5,2,117,115
25,84,6,7,120,113
25,85,0,4,77,73
25,85,1,3,80,77
25,85,2,5,90,85
25,85,3,2,76,74
25,85,4,6,106,100
25,85,5,1,93,92
25,85,6,2,107,105
25,86,0,2,80,78
25,86,1,1,90,89
25,86,2,2,91,89
25,86,3,2,83,81
25,86,4,2,90,88
25,86,5,2,106,104
25,86,6,2,107,105
25,87,0,0,72,72
25,87,1,1,94,93
25,87,2,8,122,114
25,87,3,1,111,110
25,87,4,10,100,90
25,87,5,2,106,104
25,87,6,5,134,129
25,88,0,4,100,96
25,88,1,1,103,102
25,88,2,2,104,102
25,88,3,5,96,91
25,88,4,11,102,91
25,88,5,3,101,98
25,88,6,6,128,122
25,89,0,2,72,70
25,89,1,2,87,85
25,89,2,1,107,106
25,89,3,5,84,79
25,89,4,5,89,84
25,89,5,5,103,98
25,89,6,1,115,114
25,90,0,2,82,80
25,90,1,1,92,91
25,90,2,1,97,96
25,90,3,5,94,89
25,90,4,5,86,81
25,90,5,0,105,105
25,90,6,4,135,131
25,91,0,3,83,80
25,91,1,3,79,76
25,91,2,6,92,86
25,91,3,2,94,92
25,91,4,9,98,89
25,91,5,1,106,105
25,91,6,3,131,128
25,92,0,4,97,93
25,92,1,2,92,90
25,92,2,9,105,96
25,92,3,2,78,76
25,92,4,3,96,93
25,92,5,0,105,105
25,92,6,2,116,114
25,93,0,0,107,107
25,93,1,3,119,116
25,93,2,3,103,100
25,93,3,0,96,96
25,93,4,3,99,96
25,93,5,3,120,117
25,93,6,3,136,133
25,94,0,1,98,97
25,94,1,3,107,104
25,94,2,8,114,106
25,94,3,4,110,106
25,94,4,0,99,99
25,94,5,2,102,100
25,94,6,3,135,132
25,95,0,2,87,85
25,95,1,3,118,115
25,95,2,2,102,100
25,95,3,0,98,98
25,95,4,4,100,96
25,95,5,2,106,104
25,95,6,9,145,136
25,96,0,26,122,96
25,96,1,4,113,109
25,96,2,3,127,124
25,96,3,3,121,118
25,96,4,6,97,91
25,96,5,2,127,125
25,96,6,3,135,132
25,97,0,2,110,108
25,97,1,2,114,112
25,97,2,4,125,121
25,97,3,2,120,118
25,97,4,5,97,92
25,97,5,4,137,133
25,97,6,2,135,133
25,98,0,5,132,127
25,98,1,2,119,117
25,98,2,3,131,128
25,98,3,2,108,106
25,98,4,8,114,106
25,98,5,1,129,128
25,98,6,1,145,144
25,99,0,2,134,132
25,99,1,4,117,113
25,99,2,1,119,118
25,99,3,2,135,133
25,99,4,7,123,116
25,99,5,2,138,136
25,99,6,8,153,145
25,100,0,3,123,120
25,100,1,3,115,112
25,100,2,1,118,117
25,100,3,3,125,122
25,100,4,5,120,115
25,100,5,6,132,126
25,100,6,2,128,126
25,101,0,2,130,128
25,101,1,5,120,115
25,101,2,2,138,136
25,101,3,3,167,164
25,101,4,4,141,137
25,101,5,4,140,136
25,101,6,2,150,148
25,102,0,2,155,153
25,102,1,4,143,139
25,102,2,7,165,158
25,102,3,2,162,160
25,102,4,1,155,154
25,102,5,2,139,137
25,102,6,4,143,139
25,103,0,7,111,104
25,103,1,2,109,107
25,103,2,4,139,135
25,103,3,3,149,146
25,103,4,2,139,137
25,103,5,7,138,131
25,103,6,1,150,149
25,104,0,3,122,119
25,104,1,1,126,125
25,104,2,4,140,136
25,104,3,4,128,124
25,104,4,5,157,152
25,104,5,3,160,157
25,104,6,4,165,161
25,105,0,4,135,131
25,105,1,3,127,124
25,105,2,5,145,140
25,105,3,2,132,130
25,105,4,2,159,157
25,105,5,2,124,122
25,105,6,4,130,126
25,106,0,3,121,118
25,106,1,4,132,128
25,106,2,4,113,109
25,106,3,3,127,124
25,106,4,3,131,128
25,106,5,4,106,102
25,106,6,3,126,123
25,107,0,4,133,129
25,107,1,2,128,126
25,107,2,4,142,138
25,107,3,2,132,130
25,107,4,5,116,111
25,107,5,3,121,118
25,107,6,5,142,137
25,108,0,2,129,127
25,108,1,6,137,131
25,108,2,12,171,159
25,108,3,3,150,147
25,108,4,1,118,117
25,108,5,4,135,131
25,108,6,8,129,121
25,109,0,1,140,139
25,109,1,1,166,165
25,109,2,11,145,134
25,109,3,8,148,140
25,109,4,4,145,141
25,109,5,2,146,144
25,109,6,5,139,134
25,110,0,7,155,148
25,110,1,5,160,155
25,110,2,5,197,192
25,110,3,5,164,159
25,110,4,5,176,171
25,110,5,5,179,174
25,110,6,7,186,179
25,111,0,2,136,134
25,111,1,6,128,122
25,111,2,3,142,139
25,111,3,5,154,149
25,111,4,3,149,146
25,111,5,8,149,141
25,111,6,3,157,154
25,112,0,4,106,102
25,112,1,5,149,144
25,112,2,2,140,138
25,112,3,2,134,132
25,112,4,3,138,135
25,112,5,3,137,134
25,112,6,2,127,125
25,113,0,14,147,133
25,113,1,1,109,108
25,113,2,6,143,137
25,113,3,1,123,122
25,113,4,1,133,132
25,113,5,2,128,126
25,113,6,3,123,120
25,114,0,7,113,106
25,114,1,2,113,111
25,114,2,2,100,98
25,114,3,9,130,121
25,114,4,3,122,119
25,114,5,1,114,113
25,114,6,3,118,115
25,115,0,0,89,89
25,115,1,4,112,108
25,115,2,4,122,118
25,115,3,1,116,115
25,115,4,7,119,112
25,115,5,5,110,105
25,115,6,0,114,114
25,116,0,2,97,95
25,116,1,2,105,103
25,116,2,1,105,104
25,116,3,3,105,102
25,116,4,5,97,92
25,116,5,2,110,108
25,116,6,3,116,113
25,117,0,0,78,78
25,117,1,6,102,96
25,117,2,28,137,109
25,117,3,1,101,100
25,117,4,6,115,109
25,117,5,0,90,90
25,117,6,2,122,120
25,118,0,6,78,72
25,118,1,1,71,70
25,118,2,3,95,92
25,118,3,2,98,96
25,118,4,3,104,101
25,118,5,0,109,109
25,118,6,4,101,97
25,119,0,2,94,92
25,119,1,5,99,94
25,119,2,0,125,125
25,119,3,3,112,109
25,119,4,2,107,105
25,119,5,1,104,103
25,119,6,8,90,82
25,120,0,5,81,76
25,120,1,0,103,103
25,120,2,3,127,124
25,120,3,0,99,99
25,120,4,3,103,100
25,120,5,2,104,102
25,120,6,8,112,104
25,121,0,5,91,86
25,121,1,3,84,81
25,121,2,3,112,109
25,121,3,5,114,109
25,121,4,4,82,78
25,121,5,3,91,88
25,121,6,2,86,84
25,122,0,2,92,90
25,122,1,1,111,110
25,122,2,1,113,112
25,122,3,4,101,97
25,122,4,2,94,92
25,122,5,1,92,91
25,122,6,6,98,92
25,123,0,1,104,103
25,123,1,5,98,93
25,123,2,6,101,95
25,123,3,1,95,94
25,123,4,6,135,129
25,123,5,0,93,93
25,123,6,1,91,90
25,124,0,0,86,86
25,124,1,3,107,104
25,124,2,12,124,112
25,124,3,3,106,103
25,124,4,3,105,102
25,124,5,1,89,88
25,124,6,1,94,93
25,125,0,4,101,97
25,125,1,2,113,111
25,125,2,2,117,115
25,125,3,8,99,91
25,125,4,2,97,95
25,125,5,4,100,96
25,125,6,3,95,92
25,126,0,1,91,90
25,126,1,2,115,113
25,126,2,4,120,116
25,126,3,2,112,110
25,126,4,3,112,109
25,126,5,1,98,97
25,126,6,1,102,101
25,127,0,2,83,81
25,127,1,1,91,90
25,127,2,2,99,97
25,127,3,3,103,100
25,127,4,2,82,80
25,127,5,2,91,89
25,127,6,2,95,93
25,128,0,3,88,85
25,128,1,1,80,79
25,128,2,1,76,75
25,128,3,1,85,84
25,128,4,3,80,77
25,128,5,4,96,92
25,128,6,1,82,81
25,129,0,5,68,63
25,129,1,5,76,71
25,129,2,3,92,89
25,129,3,2,73,71
25,129,4,7,113,106
25,129,5,3,92,89
25,129,6,3,66,63
25,130,0,2,61,59
25,130,1,2,65,63
25,130,2,4,100,96
25,130,3,0,72,72
25,130,4,4,87,83
25,130,5,0,79,79
25,130,6,2,75,73
25,131,0,2,75,73
25,131,1,3,81,78
25,131,2,2,97,95
25,131,3,4,82,78
25,131,4,3,83,80
25,131,5,1,82,81
25,131,6,4,58,54
25,132,0,2,58,56
25,132,1,1,67,66
25,132,2,2,81,79
25,132,3,3,98,95
25,132,4,1,75,74
25,132,5,3,77,74
25,132,6,2,75,73
25,133,0,5,84,79
25,133,1,1,75,74
25,133,2,2,81,79
25,133,3,3,60,57
25,133,4,1,52,51
25,133,5,1,86,85
25,133,6,1,54,53
25,134,0,4,47,43
25,134,1,2,58,56
25,134,2,3,76,73
25,134,3,0,66,66
25,134,4,3,70,67
25,134,5,0,72,72
25,134,6,1,78,77
25,135,0,3,69,66
25,135,1,4,78,74
25,135,2,3,75,72
25,135,3,2,81,79
25,135,4,3,71,68
25,135,5,0,88,88
25,135,6,0,73,73
25,136,0,3,58,55
25,136,1,4,62,58
25,136,2,1,48,47
25,136,3,2,66,64
25,136,4,2,70,68
25,136,5,3,74,71
25,136,6,1,69,68
25,137,0,6,61,55
25,137,1,5,49,44
25,137,2,4,81,77
25,137,3,3,63,60
25,137,4,2,62,60
25,137,5,5,60,55
25,137,6,4,79,75
25,138,0,2,50,48
25,138,1,1,57,56
25,138,2,3,73,70
25,138,3,1,70,69
25,138,4,4,55,51
25,138,5,3,84,81
25,138,6,2,60,58
25,139,0,3,48,45
25,139,1,1,69,68
25,139,2,0,52,52
25,139,3,1,58,57
25,139,4,4,71,67
25,139,5,3,71,68
25,139,6,2,63,61
25,140,0,1,52,51
25,140,1,4,51,47
25,140,2,1,64,63
25,140,3,4,80,76
25,140,4,4,61,57
25,140,5,0,61,61
25,140,6,3,48,45
25,141,0,1,61,60
25,141,1,4,59,55
25,141,2,1,59,58
25,141,3,0,56,56
25,141,4,1,69,68
25,141,5,1,63,62
25,141,6,3,65,62
25,142,0,3,48,45
25,142,1,7,65,58
25,142,2,4,60,56
25,142,3,17,80,63
25,142,4,10,77,67
25,142,5,5,66,61
25,142,6,8,61,53
25,143,0,1,35,34
25,143,1,3,57,54
25,143,2,3,60,57
25,143,3,11,65,54
25,143,4,9,56,47
25,143,5,3,61,58
25,143,6,2,56,54
26,0,0,1,15,14
26,0,1,3,16,13
26,0,2,4,19,15
26,0,3,2,14,12
26,0,4,2,19,17
26,0,5,8,32,24
26,0,6,1,11,10
26,1,0,6,17,11
26,1,1,2,15,13
26,1,2,7,20,13
26,1,3,2,16,14
26,1,4,2,16,14
26,1,5,0,13,13
26,1,6,2,13,11
26,2,0,1,14,13
26,2,1,3,14,11
26,2,2,1,12,11
26,2,3,0,7,7
26,2,4,0,12,12
26,2,5,4,19,15
26,2,6,0,7,7
26,3,0,1,7,6
26,3,1,1,5,4
26,3,2,2,11,9
26,3,3,2,11,9
26,3,4,5,17,12
26,3,5,2,17,15
26,3,6,3,17,14
26,4,0,2,10,8
26,4,1,5,11,6
26,4,2,3,8,5
26,4,3,0,11,11
26,4,4,3,14,11
26,4,5,1,10,9
26,4,6,2,11,9
26,5,0,3,8,5
26,5,1,3,15,12
26,5,2,3,9,6
26,5,3,0,9,9
26,5,4,1,13,12
26,5,5,4,8,4
26,5,6,0,4,4
26,6,0,2,10,8
26,6,1,1,6,5
26,6,2,1,4,3
26,6,3,2,8,6
26,6,4,2,8,6
26,6,5,2,12,10
26,6,6,2,6,4
26,7,0,1,5,4
26,7,1,2,7,5
26,7,2,1,8,7
26,7,3,1,9,8
26,7,4,4,9,5
26,7,5,0,7,7
26,7,6,0,3,3
26,8,0,0,3,3
26,8,1,2,3,1
26,8,2,0,6,6
26,8,3,8,13,5
26,8,4,1,13,12
26,8,5,3,8,5
26,8,6,7,15,8
26,9,0,0,4,4
26,9,1,2,7,5
26,9,2,3,10,7
26,9,3,2,9,7
26,9,4,4,11,7
26,9,5,0,2,2
26,9,6,2,4,2
26,10,0,0,4,4
26,10,1,1,2,1
26,10,2,2,5,3
26,10,3,0,8,8
26,10,4,0,8,8
26,10,5,3,9,6
26,10,6,1,9,8
26,11,0,0,2,2
26,11,1,1,6,5
26,11,2,0,2,2
26,11,3,1,9,8
26,11,4,2,12,10
26,11,5,1,8,7
26,11,6,0,5,5
26,12,0,0,4,4
26,12,1,0,3,3
26,12,2,1,4,3
26,12,3,0,1,1
26,12,4,0,14,14
26,12,5,6,11,5
26,12,6,1,6,5
26,13,0,3,5,2
26,13,1,0,1,1
26,13,2,1,4,3
26,13,3,2,5,3
26,13,4,2,5,3
26,13,5,6,8,2
26,13,6,2,9,7
26,14,0,3,3,0
26,14,1,1,3,2
26,14,2,5,7,2
26,14,3,2,5,3
26,14,4,2,3,1
26,14,5,7,10,3
26,14,6,0,4,4
26,15,0,2,4,2
26,15,1,1,2,1
26,15,2,3,7,4
26,15,3,1,4,3
26,15,4,3,4,1
26,15,5,3,7,4
26,15,6,0,7,7
26,16,0,4,6,2
26,16,1,0,3,3
26,16,2,1,3,2
26,16,3,0,1,1
26,16,4,1,5,4
26,16,5,0,3,3
26,16,6,0,4,4
26,17,0,2,5,3
26,17,1,0,1,1
26,17,2,3,4,1
26,17,3,1,2,1
26,17,4,5,10,5
26,17,5,0,1,1
26,17,6,0,2,2
26,18,0,3,4,1
26,18,1,1,4,3
26,18,2,0,1,1
26,18,3,1,1,0
26,18,4,1,4,3
26,18,5,0,1,1
26,18,6,3,4,1
26,19,0,3,4,1
26,19,1,0,1,1
26,19,2,1,2,1
26,19,3,0,1,1
26,19,4,0,3,3
26,19,6,1,3,2
26,20,1,0,3,3
26,20,2,0,1,1
26,20,3,1,1,0
26,20,4,1,1,0
26,20,5,0,2,2
26,21,0,0,3,3
26,21,1,0,1,1
26,21,2,0,3,3
26,21,3,0,1,1
26,21,4,0,2,2
26,21,5,0,1,1
26,21,6,0,2,2
26,22,1,1,2,1
26,22,2,2,3,1
26,22,3,1,1,0
26,22,4,0,1,1
26,22,5,1,3,2
26,22,6,0,1,1
26,23,0,1,4,3
26,23,1,1,2,1
26,23,4,1,2,1
26,23,5,1,3,2
26,23,6,2,6,4
26,24,0,1,2,1
26,24,2,2,4,2
26,24,3,2,2,0
26,24,5,2,4,2
26,24,6,0,2,2
26,25,1,1,2,1
26,25,2,2,3,1
26,25,3,0,2,2
26,25,4,0,1,1
26,25,5,1,3,2
26,26,0,2,2,0
26,26,1,1,3,2
26,26,3,0,1,1
26,26,4,0,2,2
26,26,5,0,1,1
26,27,0,2,3,1
26,27,1,1,1,0
26,27,2,1,2,1
26,27,3,2,2,0
26,27,4,2,4,2
26,27,6,0,1,1
26,28,0,4,4,0
26,28,2,3,3,0
26,28,3,2,2,0
26,28,4,0,2,2
26,28,5,0,1,1
26,28,6,1,1,0
26,29,0,2,2,0
26,29,1,0,1,1
26,29,2,1,2,1
26,29,3,0,2,2
26,29,4,1,2,1
26,29,5,3,3,0
26,30,0,1,2,1
26,30,1,1,1,0
26,30,6,9,10,1
26,31,2,1,1,0
26,31,3,5,6,1
26,31,4,8,9,1
26,31,5,0,3,3
26,31,6,3,3,0
26,32,0,4,4,0
26,32,1,2,2,0
26,32,2,0,1,1
26,32,3,2,4,2
26,32,4,7,9,2
26,32,5,0,3,3
26,32,6,3,5,2
26,33,0,6,8,2
26,33,1,2,4,2
26,33,2,0,1,1
26,33,3,4,8,4
26,33,4,6,11,5
26,33,5,1,4,3
26,34,0,0,1,1
26,34,1,1,1,0
26,34,2,0,1,1
26,34,3,5,5,0
26,34,4,9,12,3
26,34,5,2,4,2
26,34,6,1,3,2
26,35,0,3,6,3
26,35,1,1,1,0
26,35,2,2,5,3
26,35,3,3,3,0
26,35,4,6,6,0
26,35,5,0,2,2
26,35,6,4,7,3
26,36,0,12,13,1
26,36,1,4,7,3
26,36,2,4,6,2
26,36,3,5,7,2
26,36,4,13,20,7
26,36,5,1,5,4
26,37,0,19,21,2
26,37,1,4,6,2
26,37,2,9,9,0
26,37,3,6,6,0
26,37,4,24,28,4
26,37,5,5,8,3
26,37,6,2,3,1
26,38,0,18,19,1
26,38,1,12,19,7
26,38,2,5,8,3
26,38,3,9,11,2
26,38,4,32,39,7
26,38,5,7,9,2
26,38,6,9,11,2
26,39,0,3,17,14
26,39,1,2,19,17
26,39,2,1,16,15
26,39,3,4,24,20
26,39,4,24,46,22
26,39,5,5,13,8
26,39,6,7,13,6
26,40,0,3,23,20
26,40,1,2,26,24
26,40,2,3,27,24
26,40,3,1,30,29
26,40,4,18,37,19
26,40,5,1,20,19
26,40,6,4,7,3
26,41,0,0,39,39
26,41,1,4,33,29
26,41,2,3,35,32
26,41,3,2,28,26
26,41,4,29,60,31
26,41,5,14,32,18
26,41,6,7,17,10
26,42,0,5,55,50
26,42,1,2,57,55
26,42,2,4,58,54
26,42,3,2,64,62
26,42,4,20,62,42
26,42,5,3,26,23
26,42,6,9,33,24
26,43,0,12,89,77
26,43,1,8,83,75
26,43,2,7,84,77
26,43,3,4,76,72
26,43,4,32,109,77
26,43,5,14,41,27
26,43,6,13,35,22
26,44,0,39,131,92
26,44,1,7,95,88
26,44,2,3,78,75
26,44,3,7,99,92
26,44,4,53,116,63
26,44,5,27,71,44
26,44,6,16,48,32
26,45,0,73,188,115
26,45,1,27,139,112
26,45,2,21,133,112
26,45,3,7,120,113
26,45,4,57,127,70
26,45,5,32,84,52
26,45,6,27,70,43
26,46,0,148,277,129
26,46,1,49,188,139
26,46,2,71,224,153
26,46,3,31,164,133
26,46,4,48,172,124
26,46,5,31,87,56
26,46,6,28,65,37
26,47,0,185,318,133
26,47,1,122,271,149
26,47,2,90,251,161
26,47,3,78,255,177
26,47,4,84,202,118
26,47,5,55,117,62
26,47,6,43,90,47
26,48,0,211,353,142
26,48,1,181,345,164
26,48,2,165,321,156
26,48,3,90,251,161
26,48,4,126,229,103
26,48,5,63,134,71
26,48,6,49,104,55
26,49,0,199,333,134
26,49,1,181,343,162
26,49,2,216,384,168
26,49,3,129,306,177
26,49,4,120,261,141
26,49,5,88,165,77
26,49,6,51,104,53
26,50,0,231,409,178
26,50,1,254,455,201
26,50,2,239,443,204
26,50,3,171,374,203
26,50,4,132,287,155
26,50,5,80,169,89
26,50,6,46,119,73
26,51,0,338,543,205
26,51,1,285,543,258
26,51,2,213,459,246
26,51,3,176,429,253
26,51,4,172,351,179
26,51,5,89,198,109
26,51,6,49,124,75
26,52,0,305,555,250
26,52,1,253,517,264
26,52,2,183,461,278
26,52,3,193,470,277
26,52,4,146,356,210
26,52,5,74,170,96
26,52,6,59,143,84
26,53,0,169,409,240
26,53,1,140,398,258
26,53,2,114,377,263
26,53,3,105,365,260
26,53,4,96,305,209
26,53,5,16,122,106
26,53,6,21,98,77
26,54,0,146,404,258
26,54,1,141,432,291
26,54,2,70,393,323
26,54,3,108,400,292
26,54,4,113,323,210
26,54,5,7,107,100
26,54,6,14,95,81
26,55,0,108,362,254
26,55,1,117,394,277
26,55,2,66,340,274
26,55,3,174,498,324
26,55,4,84,304,220
26,55,5,16,90,74
26,55,6,7,70,63
26,56,0,77,316,239
26,56,1,86,401,315
26,56,2,33,275,242
26,56,3,76,356,280
26,56,4,61,266,205
26,56,5,13,125,112
26,56,6,13,86,73
26,57,0,58,242,184
26,57,1,83,276,193
26,57,2,32,238,206
26,57,3,60,291,231
26,57,4,49,219,170
26,57,5,14,102,88
26,57,6,16,107,91
26,58,0,38,200,162
26,58,1,38,229,191
26,58,2,15,208,193
26,58,3,40,226,186
26,58,4,50,190,140
26,58,5,15,91,76
26,58,6,16,103,87
26,59,0,8,114,106
26,59,1,13,145,132
26,59,2,4,118,114
26,59,3,15,146,131
26,59,4,31,152,121
26,59,5,17,102,85
26,59,6,9,82,73
26,60,0,12,106,94
26,60,1,5,112,107
26,60,2,5,90,85
26,60,3,7,118,111
26,60,4,30,112,82
26,60,5,29,124,95
26,60,6,10,72,62
26,61,0,5,92,87
26,61,1,4,76,72
26,61,2,7,84,77
26,61,3,4,89,85
26,61,4,27,97,70
26,61,5,20,99,79
26,61,6,4,79,75
26,62,0,4,67,63
26,62,1,2,74,72
26,62,2,2,67,65
26,62,3,1,69,68
26,62,4,39,112,73
26,62,5,24,116,92
26,62,6,11,71,60
26,63,0,5,73,68
26,63,1,14,78,64
26,63,2,9,100,91
26,63,3,2,71,69
26,63,4,67,121,54
26,63,5,33,110,77
26,63,6,7,82,75
26,64,0,2,63,61
26,64,1,4,77,73
26,64,2,0,56,56
26,64,3,9,58,49
26,64,4,63,118,55
26,64,5,27,119,92
26,64,6,11,76,65
26,65,0,7,61,54
26,65,1,12,76,64
26,65,2,3,52,49
26,65,3,7,68,61
26,65,4,57,120,63
26,65,5,29,100,71
26,65,6,12,95,83
26,66,0,4,62,58
26,66,1,8,58,50
26,66,2,3,56,53
26,66,3,8,64,56
26,66,4,89,140,51
26,66,5,40,132,92
26,66,6,27,113,86
26,67,0,13,60,47
26,67,1,5,56,51
26,67,2,2,68,66
26,67,3,2,55,53
26,67,4,56,121,65
26,67,5,39,116,77
26,67,6,36,124,88
26,68,0,12,74,62
26,68,1,9,67,58
26,68,2,4,55,51
26,68,3,6,63,57
26,68,4,39,105,66
26,68,5,25,100,75
26,68,6,54,141,87
26,69,0,10,80,70
26,69,1,2,73,71
26,69,2,7,73,66
26,69,3,3,54,51
26,69,4,66,119,53
26,69,5,53,128,75
26,69,6,87,164,77
26,70,0,4,79,75
26,70,1,9,83,74
26,70,2,3,68,65
26,70,3,6,83,77
26,70,4,67,131,64
26,70,5,55,138,83
26,70,6,94,183,89
26,71,0,7,73,66
26,71,1,12,85,73
26,71,2,8,89,81
26,71,3,12,105,93
26,71,4,68,155,87
26,71,5,72,148,76
26,71,6,75,164,89
26,72,0,10,81,71
26,72,1,17,95,78
26,72,2,11,93,82
26,72,3,13,110,97
26,72,4,52,133,81
26,72,5,60,146,86
26,72,6,51,147,96
26,73,0,14,114,100
26,73,1,19,98,79
26,73,2,6,98,92
26,73,3,4,68,64
26,73,4,42,120,78
26,73,5,87,166,79
26,73,6,35,139,104
26,74,0,15,90,75
26,74,1,12,94,82
26,74,2,25,121,96
26,74,3,8,81,73
26,74,4,34,96,62
26,74,5,66,162,96
26,74,6,43,135,92
26,75,0,14,81,67
26,75,1,16,91,75
26,75,2,21,103,82
26,75,3,9,79,70
26,75,4,51,114,63
26,75,5,77,173,96
26,75,6,80,181,101
26,76,0,20,97,77
26,76,1,16,103,87
26,76,2,32,109,77
26,76,3,12,98,86
26,76,4,64,138,74
26,76,5,69,164,95
26,76,6,95,169,74
26,77,0,12,76,64
26,77,1,10,74,64
26,77,2,21,122,101
26,77,3,13,91,78
26,77,4,71,143,72
26,77,5,66,157,91
26,77,6,66,173,107
26,78,0,15,98,83
26,78,1,8,89,81
26,78,2,22,113,91
26,78,3,6,95,89
26,78,4,63,117,54
26,78,5,98,192,94
26,78,6,57,167,110
26,79,0,25,114,89
26,79,1,16,99,83
26,79,2,29,121,92
26,79,3,9,82,73
26,79,4,69,143,74
26,79,5,137,238,101
26,79,6,64,166,102
26,80,0,6,80,74
26,80,1,13,88,75
26,80,2,33,124,91
26,80,3,11,97,86
26,80,4,57,133,76
26,80,5,171,254,83
26,80,6,81,181,100
26,81,0,14,67,53
26,81,1,12,107,95
26,81,2,27,97,70
26,81,3,16,89,73
26,81,4,49,108,59
26,81,5,148,225,77
26,81,6,88,186,98
26,82,0,10,77,67
26,82,1,6,90,84
26,82,2,13,88,75
26,82,3,16,90,74
26,82,4,47,113,66
26,82,5,140,220,80
26,82,6,62,149,87
26,83,0,9,83,74
26,83,1,5,62,57
26,83,2,16,86,70
26,83,3,19,78,59
26,83,4,38,90,52
26,83,5,76,154,78
26,83,6,47,134,87
26,84,0,10,73,63
26,84,1,1,49,48
26,84,2,15,83,68
26,84,3,12,80,68
26,84,4,50,111,61
26,84,5,54,154,100
26,84,6,37,124,87
26,85,0,19,68,49
26,85,1,1,64,63
26,85,2,9,68,59
26,85,3,4,75,71
26,85,4,39,89,50
26,85,5,76,165,89
26,85,6,40,125,85
26,86,0,5,62,57
26,86,1,1,53,52
26,86,2,3,58,55
26,86,3,3,57,54
26,86,4,37,100,63
26,86,5,78,170,92
26,86,6,31,133,102
26,87,0,2,60,58
26,87,1,8,62,54
26,87,2,8,64,56
26,87,3,4,74,70
26,87,4,23,67,44
26,87,5,34,135,101
26,87,6,16,99,83
26,88,0,5,56,51
26,88,1,0,51,51
26,88,2,4,61,57
26,88,3,7,62,55
26,88,4,32,93,61
26,88,5,22,101,79
26,88,6,18,101,83
26,89,0,1,49,48
26,89,1,7,53,46
26,89,2,4,50,46
26,89,3,12,74,62
26,89,4,30,76,46
26,89,5,17,106,89
26,89,6,10,72,62
26,90,0,6,56,50
26,90,1,8,66,58
26,90,2,4,70,66
26,90,3,7,69,62
26,90,4,45,103,58
26,90,5,26,126,100
26,90,6,11,97,86
26,91,0,14,79,65
26,91,1,9,63,54
26,91,2,19,76,57
26,91,3,7,52,45
26,91,4,90,146,56
26,91,5,7,80,73
26,91,6,39,123,84
26,92,0,10,78,68
26,92,1,14,61,47
26,92,2,17,69,52
26,92,3,7,88,81
26,92,4,76,139,63
26,92,5,12,98,86
26,92,6,17,110,93
26,93,0,6,75,69
26,93,1,4,81,77
26,93,2,6,63,57
26,93,3,5,70,65
26,93,4,16,90,74
26,93,5,28,97,69
26,93,6,25,128,103
26,94,0,2,56,54
26,94,1,2,65,63
26,94,2,6,78,72
26,94,3,5,81,76
26,94,4,3,83,80
26,94,5,10,86,76
26,94,6,15,90,75
26,95,0,3,68,65
26,95,1,7,84,77
26,95,2,9,68,59
26,95,3,4,59,55
26,95,4,8,85,77
26,95,5,25,94,69
26,95,6,25,99,74
26,96,0,1,72,71
26,96,1,8,95,87
26,96,2,5,81,76
26,96,3,3,64,61
26,96,4,6,93,87
26,96,5,2,92,90
26,96,6,5,112,107
26,97,0,5,71,66
26,97,1,14,117,103
26,97,2,9,80,71
26,97,3,3,64,61
26,97,4,11,111,100
26,97,5,4,93,89
26,97,6,7,75,68
26,98,0,6,63,57
26,98,1,12,105,93
26,98,2,9,88,79
26,98,3,3,71,68
26,98,4,7,86,79
26,98,5,3,87,84
26,98,6,8,105,97
26,99,0,3,50,47
26,99,1,11,107,96
26,99,2,7,63,56
26,99,3,8,69,61
26,99,4,2,72,70
26,99,5,0,75,75
26,99,6,4,78,74
26,100,0,5,66,61
26,100,1,11,84,73
26,100,2,15,115,100
26,100,3,0,67,67
26,100,4,10,83,73
26,100,5,2,94,92
26,100,6,4,100,96
26,101,0,1,63,62
26,101,1,8,86,78
26,101,2,16,107,91
26,101,3,4,99,95
26,101,4,14,88,74
26,101,5,6,106,100
26,101,6,6,92,86
26,102,0,6,119,113
26,102,1,16,147,131
26,102,2,9,118,109
26,102,3,7,126,119
26,102,4,12,134,122
26,102,5,10,135,125
26,102,6,5,105,100
26,103,0,15,109,94
26,103,1,12,113,101
26,103,2,6,93,87
26,103,3,14,134,120
26,103,4,7,111,104
26,103,5,9,114,105
26,103,6,2,125,123
26,104,0,10,102,92
26,104,1,4,116,112
26,104,2,23,142,119
26,104,3,9,128,119
26,104,4,18,156,138
26,104,5,5,110,105
26,104,6,2,106,104
26,105,0,10,172,162
26,105,1,8,177,169
26,105,2,39,203,164
26,105,3,13,213,200
26,105,4,32,192,160
26,105,5,7,142,135
26,105,6,3,103,100
26,106,0,12,135,123
26,106,1,8,165,157
26,106,2,79,225,146
26,106,3,14,157,143
26,106,4,22,180,158
26,106,5,5,155,150
26,106,6,4,105,101
26,107,0,15,196,181
26,107,1,9,184,175
26,107,2,52,223,171
26,107,3,13,188,175
26,107,4,27,217,190
26,107,5,7,140,133
26,107,6,8,120,112
26,108,0,24,316,292
26,108,1,19,291,272
26,108,2,116,402,286
26,108,3,53,337,284
26,108,4,72,308,236
26,108,5,11,151,140
26,108,6,4,116,112
26,109,0,15,311,296
26,109,1,18,266,248
26,109,2,131,371,240
26,109,3,53,327,274
26,109,4,171,386,215
26,109,5,10,130,120
26,109,6,6,108,102
26,110,0,26,300,274
26,110,1,21,285,264
26,110,2,108,331,223
26,110,3,49,295,246
26,110,4,156,346,190
26,110,5,16,145,129
26,110,6,3,105,102
26,111,0,23,292,269
26,111,1,12,259,247
26,111,2,77,327,250
26,111,3,60,310,250
26,111,4,161,354,193
26,111,5,9,107,98
26,111,6,5,91,86
26,112,0,17,264,247
26,112,1,12,222,210
26,112,2,61,310,249
26,112,3,16,245,229
26,112,4,248,432,184
26,112,5,3,105,102
26,112,6,5,111,106
26,113,0,16,247,231
26,113,1,7,234,227
26,113,2,85,325,240
26,113,3,39,274,235
26,113,4,208,386,178
26,113,5,2,93,91
26,113,6,5,101,96
26,114,0,60,287,227
26,114,1,24,239,215
26,114,2,116,335,219
26,114,3,56,257,201
26,114,4,319,460,141
26,114,5,7,84,77
26,114,6,5,94,89
26,115,0,78,307,229
26,115,1,27,225,198
26,115,2,94,315,221
26,115,3,28,228,200
26,115,4,349,503,154
26,115,5,5,86,81
26,115,6,11,87,76
26,116,0,77,297,220
26,116,1,31,228,197
26,116,2,180,358,178
26,116,3,36,244,208
26,116,4,242,370,128
26,116,5,8,93,85
26,116,6,4,78,74
26,117,0,82,265,183
26,117,1,59,247,188
26,117,2,255,463,208
26,117,3,53,227,174
26,117,4,265,402,137
26,117,5,6,71,65
26,117,6,6,72,66
26,118,0,138,335,197
26,118,1,44,215,171
26,118,2,150,349,199
26,118,3,42,238,196
26,118,4,187,309,122
26,118,5,7,65,58
26,118,6,1,77,76
26,119,0,130,322,192
26,119,1,43,205,162
26,119,2,110,316,206
26,119,3,44,245,201
26,119,4,115,257,142
26,119,5,3,58,55
26,119,6,9,76,67
26,120,0,27,264,237
26,120,1,16,213,197
26,120,2,56,298,242
26,120,3,22,243,221
26,120,4,33,200,167
26,120,5,4,55,51
26,120,6,4,77,73
26,121,0,39,254,215
26,121,1,13,204,191
26,121,2,37,245,208
26,121,3,9,187,178
26,121,4,23,194,171
26,121,5,8,62,54
26,121,6,2,61,59
26,122,0,21,222,201
26,122,1,10,198,188
26,122,2,11,192,181
26,122,3,5,220,215
26,122,4,23,151,128
26,122,5,14,78,64
26,122,6,3,59,56
26,123,0,9,177,168
26,123,1,12,211,199
26,123,2,10,189,179
26,123,3,18,229,211
26,123,4,28,151,123
26,123,5,3,59,56
26,123,6,9,70,61
26,124,0,32,182,150
26,124,1,7,158,151
26,124,2,6,164,158
26,124,3,8,149,141
26,124,4,21,106,85
26,124,5,6,50,44
26,124,6,5,54,49
26,125,0,15,149,134
26,125,1,16,147,131
26,125,2,9,142,133
26,125,3,11,125,114
26,125,4,7,111,104
26,125,5,0,59,59
26,125,6,3,56,53
26,126,0,6,136,130
26,126,1,10,140,130
26,126,2,15,140,125
26,126,3,24,147,123
26,126,4,2,94,92
26,126,5,2,46,44
26,126,6,6,53,47
26,127,0,37,161,124
26,127,1,25,149,124
26,127,2,64,178,114
26,127,3,53,185,132
26,127,4,2,87,85
26,127,5,5,63,58
26,127,6,5,49,44
26,128,0,64,155,91
26,128,1,38,136,98
26,128,2,56,166,110
26,128,3,58,198,140
26,128,4,2,81,79
26,128,5,6,60,54
26,128,6,11,56,45
26,129,0,63,149,86
26,129,1,50,158,108
26,129,2,59,154,95
26,129,3,29,125,96
26,129,4,6,69,63
26,129,5,3,48,45
26,129,6,2,64,62
26,130,0,41,138,97
26,130,1,43,137,94
26,130,2,38,131,93
26,130,3,32,131,99
26,130,4,8,64,56
26,130,5,3,46,43
26,130,6,6,57,51
26,131,0,14,93,79
26,131,1,34,112,78
26,131,2,17,104,87
26,131,3,22,100,78
26,131,4,10,75,65
26,131,5,3,61,58
26,131,6,6,76,70
26,132,0,19,105,86
26,132,1,5,89,84
26,132,2,9,114,105
26,132,3,12,97,85
26,132,4,5,79,74
26,132,5,2,46,44
26,132,6,1,84,83
26,133,0,3,64,61
26,133,1,4,78,74
26,133,2,7,92,85
26,133,3,7,87,80
26,133,4,12,85,73
26,133,5,4,54,50
26,133,6,5,63,58
26,134,0,3,61,58
26,134,1,11,71,60
26,134,2,5,81,76
26,134,3,6,70,64
26,134,4,3,64,61
26,134,5,1,41,40
26,134,6,4,50,46
26,135,0,3,50,47
26,135,1,0,52,52
26,135,2,4,71,67
26,135,3,10,70,60
26,135,4,8,72,64
26,135,5,2,45,43
26,135,6,17,51,34
26,136,0,2,45,43
26,136,1,3,45,42
26,136,2,5,43,38
26,136,3,1,50,49
26,136,4,1,46,45
26,136,5,4,40,36
26,136,6,9,54,45
26,137,0,4,38,34
26,137,1,7,60,53
26,137,2,9,57,48
26,137,3,11,72,61
26,137,4,4,49,45
26,137,5,3,26,23
26,137,6,3,38,35
26,138,0,5,51,46
26,138,1,2,41,39
26,138,2,5,46,41
26,138,3,5,47,42
26,138,4,10,35,25
26,138,5,1,32,31
26,138,6,6,26,20
26,139,0,6,40,34
26,139,1,3,42,39
26,139,2,4,29,25
26,139,3,1,30,29
26,139,4,3,27,24
26,139,5,2,23,21
26,139,6,4,21,17
26,140,0,2,20,18
26,140,1,3,28,25
26,140,2,3,23,20
26,140,3,4,33,29
26,140,4,2,17,15
26,140,5,1,22,21
26,140,6,8,32,24
26,141,0,2,28,26
26,141,1,4,32,28
26,141,2,1,25,24
26,141,3,7,41,34
26,141,4,4,46,42
26,141,5,0,26,26
26,141,6,10,32,22
26,142,0,1,21,20
26,142,1,5,23,18
26,142,2,4,21,17
26,142,3,4,28,24
26,142,4,5,22,17
26,142,5,2,14,12
26,142,6,4,19,15
26,143,0,2,17,15
26,143,1,3,22,19
26,143,2,2,21,19
26,143,3,4,20,16
26,143,4,1,16,15
26,143,5,0,13,13
26,143,6,0,16,16
27,0,0,37,173,136
27,0,1,41,149,108
27,0,2,27,160,133
27,0,3,18,131,113
27,0,4,43,187,144
27,0,5,20,160,140
27,0,6,17,161,144
27,1,0,34,166,132
27,1,1,36,140,104
27,1,2,32,157,125
27,1,3,25,138,113
27,1,4,23,179,156
27,1,5,23,167,144
27,1,6,17,158,141
27,2,0,26,119,93
27,2,1,11,93,82
27,2,2,23,117,94
27,2,3,15,120,105
27,2,4,9,152,143
27,2,5,16,153,137
27,2,6,28,134,106
27,3,0,20,88,68
27,3,1,6,103,97
27,3,2,27,131,104
27,3,3,5,93,88
27,3,4,12,194,182
27,3,5,9,116,107
27,3,6,31,162,131
27,4,0,14,120,106
27,4,1,15,101,86
27,4,2,5,100,95
27,4,3,10,103,93
27,4,4,18,172,154
27,4,5,17,121,104
27,4,6,21,129,108
27,5,0,20,106,86
27,5,1,11,81,70
27,5,2,15,94,79
27,5,3,15,103,88
27,5,4,9,133,124
27,5,5,12,92,80
27,5,6,10,96,86
27,6,0,21,98,77
27,6,1,11,88,77
27,6,2,12,95,83
27,6,3,8,91,83
27,6,4,7,113,106
27,6,5,5,85,80
27,6,6,10,113,103
27,7,0,6,48,42
27,7,1,16,68,52
27,7,2,11,75,64
27,7,3,5,78,73
27,7,4,10,118,108
27,7,5,3,81,78
27,7,6,7,99,92
27,8,0,6,51,45
27,8,1,9,85,76
27,8,2,7,52,45
27,8,3,7,68,61
27,8,4,11,103,92
27,8,5,6,87,81
27,8,6,9,91,82
27,9,0,13,81,68
27,9,1,16,74,58
27,9,2,7,74,67
27,9,3,9,81,72
27,9,4,4,75,71
27,9,5,6,82,76
27,9,6,10,101,91
27,10,0,19,64,45
27,10,1,5,51,46
27,10,2,2,49,47
27,10,3,13,81,68
27,10,4,3,66,63
27,10,5,9,77,68
27,10,6,15,85,70
27,11,0,26,65,39
27,11,1,9,50,41
27,11,2,4,56,52
27,11,3,10,59,49
27,11,4,14,69,55
27,11,5,3,57,54
27,11,6,7,58,51
27,12,0,11,45,34
27,12,1,13,67,54
27,12,2,11,59,48
27,12,3,14,76,62
27,12,4,8,88,80
27,12,5,5,59,54
27,12,6,7,68,61
27,13,0,20,58,38
27,13,1,12,50,38
27,13,2,3,29,26
27,13,3,6,55,49
27,13,4,6,51,45
27,13,5,11,56,45
27,13,6,4,63,59
27,14,0,12,47,35
27,14,1,13,52,39
27,14,2,6,50,44
27,14,3,7,38,31
27,14,4,3,46,43
27,14,5,19,71,52
27,14,6,10,59,49
27,15,0,3,28,25
27,15,1,14,53,39
27,15,2,16,53,37
27,15,3,3,45,42
27,15,4,6,53,47
27,15,5,10,47,37
27,15,6,3,48,45
27,16,0,3,30,27
27,16,1,8,40,32
27,16,2,7,45,38
27,16,3,10,47,37
27,16,4,6,42,36
27,16,5,9,46,37
27,16,6,4,35,31
27,17,0,12,33,21
27,17,1,4,38,34
27,17,2,13,42,29
27,17,3,12,42,30
27,17,4,9,50,41
27,17,5,4,30,26
27,17,6,13,60,47
27,18,0,17,39,22
27,18,1,3,21,18
27,18,2,6,39,33
27,18,3,14,49,35
27,18,4,10,49,39
27,18,5,12,37,25
27,18,6,8,41,33
27,19,0,6,23,17
27,19,1,8,26,18
27,19,2,5,27,22
27,19,3,3,21,18
27,19,4,13,43,30
27,19,5,14,40,26
27,19,6,7,36,29
27,20,0,3,18,15
27,20,1,6,27,21
27,20,2,6,24,18
27,20,3,8,26,18
27,20,4,13,44,31
27,20,5,12,33,21
27,20,6,8,32,24
27,21,0,2,19,17
27,21,1,4,19,15
27,21,2,16,35,19
27,21,3,4,28,24
27,21,4,17,45,28
27,21,5,20,37,17
27,21,6,6,23,17
27,22,0,6,16,10
27,22,1,5,24,19
27,22,2,13,26,13
27,22,3,0,11,11
27,22,4,3,24,21
27,22,5,7,28,21
27,22,6,6,17,11
27,23,0,5,10,5
27,23,1,3,19,16
27,23,2,5,25,20
27,23,3,2,17,15
27,23,4,7,19,12
27,23,5,12,32,20
27,23,6,6,19,13
27,24,0,13,34,21
27,24,1,1,10,9
27,24,2,3,12,9
27,24,3,2,15,13
27,24,4,6,27,21
27,24,5,8,19,11
27,24,6,9,23,14
27,25,0,13,21,8
27,25,1,4,15,11
27,25,2,4,18,14
27,25,3,3,11,8
27,25,4,20,30,10
27,25,5,9,25,16
27,25,6,5,18,13
27,26,0,5,21,16
27,26,1,9,16,7
27,26,2,7,18,11
27,26,3,0,12,12
27,26,4,12,19,7
27,26,5,5,21,16
27,26,6,7,18,11
27,27,0,3,10,7
27,27,1,5,19,14
27,27,2,6,19,13
27,27,3,4,12,8
27,27,4,8,18,10
27,27,5,6,17,11
27,27,6,3,12,9
27,28,0,8,19,11
27,28,1,2,13,11
27,28,2,11,20,9
27,28,3,2,11,9
27,28,4,9,23,14
27,28,5,5,14,9
27,28,6,6,12,6
27,29,0,6,9,3
27,29,1,1,8,7
27,29,2,1,11,10
27,29,3,4,9,5
27,29,4,25,33,8
27,29,5,6,12,6
27,29,6,3,9,6
27,30,0,2,9,7
27,30,1,4,12,8
27,30,2,2,12,10
27,30,3,6,10,4
27,30,4,20,27,7
27,30,5,10,13,3
27,30,6,8,21,13
27,31,0,0,6,6
27,31,1,1,14,13
27,31,2,7,17,10
27,31,3,2,8,6
27,31,4,3,5,2
27,31,5,6,12,6
27,31,6,7,15,8
27,32,0,1,5,4
27,32,1,2,11,9
27,32,2,0,5,5
27,32,3,5,8,3
27,32,4,3,7,4
27,32,5,4,11,7
27,32,6,4,12,8
27,33,0,3,8,5
27,33,1,6,13,7
27,33,2,4,14,10
27,33,3,2,8,6
27,33,4,6,18,12
27,33,5,3,10,7
27,33,6,6,14,8
27,34,0,6,11,5
27,34,1,2,11,9
27,34,2,9,20,11
27,34,3,7,11,4
27,34,4,4,14,10
27,34,5,7,14,7
27,34,6,3,11,8
27,35,0,3,15,12
27,35,1,3,8,5
27,35,2,7,12,5
27,35,3,4,11,7
27,35,4,6,13,7
27,35,5,5,11,6
27,35,6,8,15,7
27,36,0,11,19,8
27,36,1,5,16,11
27,36,2,10,24,14
27,36,3,10,16,6
27,36,4,1,11,10
27,36,5,4,14,10
27,36,6,7,18,11
27,37,0,9,27,18
27,37,1,4,16,12
27,37,2,7,23,16
27,37,3,7,21,14
27,37,4,12,21,9
27,37,5,4,14,10
27,37,6,6,12,6
27,38,0,12,29,17
27,38,1,9,28,19
27,38,2,4,28,24
27,38,3,13,32,19
27,38,4,17,34,17
27,38,5,6,14,8
27,38,6,7,22,15
27,39,0,24,66,42
27,39,1,11,52,41
27,39,2,18,57,39
27,39,3,12,46,34
27,39,4,11,35,24
27,39,5,10,31,21
27,39,6,11,33,22
27,40,0,32,90,58
27,40,1,15,64,49
27,40,2,29,73,44
27,40,3,17,45,28
27,40,4,14,44,30
27,40,5,5,27,22
27,40,6,9,21,12
27,41,0,36,115,79
27,41,1,32,100,68
27,41,2,26,110,84
27,41,3,15,63,48
27,41,4,18,56,38
27,41,5,7,36,29
27,41,6,16,41,25
27,42,0,56,172,116
27,42,1,50,158,108
27,42,2,40,139,99
27,42,3,24,122,98
27,42,4,21,91,70
27,42,5,19,60,41
27,42,6,15,52,37
27,43,0,56,220,164
27,43,1,31,164,133
27,43,2,67,229,162
27,43,3,46,166,120
27,43,4,27,136,109
27,43,5,25,65,40
27,43,6,17,72,55
27,44,0,57,285,228
27,44,1,44,245,201
27,44,2,61,283,222
27,44,3,50,249,199
27,44,4,37,158,121
27,44,5,21,111,90
27,44,6,21,106,85
27,45,0,58,345,287
27,45,1,41,316,275
27,45,2,68,365,297
27,45,3,63,325,262
27,45,4,37,215,178
27,45,5,13,121,108
27,45,6,26,123,97
27,46,0,53,367,314
27,46,1,23,288,265
27,46,2,47,333,286
27,46,3,48,315,267
27,46,4,22,217,195
27,46,5,26,152,126
27,46,6,24,123,99
27,47,0,42,349,307
27,47,1,27,275,248
27,47,2,44,352,308
27,47,3,33,325,292
27,47,4,32,216,184
27,47,5,15,148,133
27,47,6,20,157,137
27,48,0,54,435,381
27,48,1,34,402,368
27,48,2,51,432,381
27,48,3,46,433,387
27,48,4,23,274,251
27,48,5,18,151,133
27,48,6,27,172,145
27,49,0,63,459,396
27,49,1,35,417,382
27,49,2,58,475,417
27,49,3,65,485,420
27,49,4,20,295,275
27,49,5,31,201,170
27,49,6,30,191,161
27,50,0,52,392,340
27,50,1,39,336,297
27,50,2,59,377,318
27,50,3,61,385,324
27,50,4,30,270,240
27,50,5,39,212,173
27,50,6,25,158,133
27,51,0,61,390,329
27,51,1,48,347,299
27,51,2,47,377,330
27,51,3,50,320,270
27,51,4,31,237,206
27,51,5,34,207,173
27,51,6,32,194,162
27,52,0,39,356,317
27,52,1,46,362,316
27,52,2,27,347,320
27,52,3,45,374,329
27,52,4,28,266,238
27,52,5,24,229,205
27,52,6,31,197,166
27,53,0,28,260,232
27,53,1,28,244,216
27,53,2,27,239,212
27,53,3,30,243,213
27,53,4,25,201,176
27,53,5,34,181,147
27,53,6,33,188,155
27,54,0,26,203,177
27,54,1,41,221,180
27,54,2,18,194,176
27,54,3,25,221,196
27,54,4,28,168,140
27,54,5,45,178,133
27,54,6,23,162,139
27,55,0,37,168,131
27,55,1,34,210,176
27,55,2,21,197,176
27,55,3,36,227,191
27,55,4,37,180,143
27,55,5,38,178,140
27,55,6,31,168,137
27,56,0,25,175,150
27,56,1,30,185,155
27,56,2,14,161,147
27,56,3,22,177,155
27,56,4,20,137,117
27,56,5,29,157,128
27,56,6,24,152,128
27,57,0,34,162,128
27,57,1,19,152,133
27,57,2,20,146,126
27,57,3,24,178,154
27,57,4,38,168,130
27,57,5,40,141,101
27,57,6,31,146,115
27,58,0,23,154,131
27,58,1,27,154,127
27,58,2,28,179,151
27,58,3,12,134,122
27,58,4,30,154,124
27,58,5,24,151,127
27,58,6,29,162,133
27,59,0,17,134,117
27,59,1,15,128,113
27,59,2,38,149,111
27,59,3,29,163,134
27,59,4,23,138,115
27,59,5,26,137,111
27,59,6,32,165,133
27,60,0,18,133,115
27,60,1,17,126,109
27,60,2,20,145,125
27,60,3,22,140,118
27,60,4,31,137,106
27,60,5,33,146,113
27,60,6,43,167,124
27,61,0,15,115,100
27,61,1,25,127,102
27,61,2,21,150,129
27,61,3,19,134,115
27,61,4,31,134,103
27,61,5,37,161,124
27,61,6,35,156,121
27,62,0,28,125,97
27,62,1,18,126,108
27,62,2,27,124,97
27,62,3,30,148,118
27,62,4,31,158,127
27,62,5,46,192,146
27,62,6,29,166,137
27,63,0,38,170,132
27,63,1,27,128,101
27,63,2,17,134,117
27,63,3,17,145,128
27,63,4,16,129,113
27,63,5,42,159,117
27,63,6,25,145,120
27,64,0,13,137,124
27,64,1,31,139,108
27,64,2,17,134,117
27,64,3,13,130,117
27,64,4,19,159,140
27,64,5,28,154,126
27,64,6,42,178,136
27,65,0,10,122,112
27,65,1,25,158,133
27,65,2,16,137,121
27,65,3,19,130,111
27,65,4,55,194,139
27,65,5,27,168,141
27,65,6,23,169,146
27,66,0,20,140,120
27,66,1,12,111,99
27,66,2,32,151,119
27,66,3,20,140,120
27,66,4,40,180,140
27,66,5,33,169,136
27,66,6,26,150,124
27,67,0,23,141,118
27,67,1,27,142,115
27,67,2,22,133,111
27,67,3,23,137,114
27,67,4,32,143,111
27,67,5,39,179,140
27,67,6,31,164,133
27,68,0,21,147,126
27,68,1,31,179,148
27,68,2,24,144,120
27,68,3,28,169,141
27,68,4,30,159,129
27,68,5,30,168,138
27,68,6,41,195,154
27,69,0,25,172,147
27,69,1,18,139,121
27,69,2,31,194,163
27,69,3,27,175,148
27,69,4,27,147,120
27,69,5,40,195,155
27,69,6,35,201,166
27,70,0,37,184,147
27,70,1,34,183,149
27,70,2,19,176,157
27,70,3,24,206,182
27,70,4,31,167,136
27,70,5,42,218,176
27,70,6,32,197,165
27,71,0,30,177,147
27,71,1,45,178,133
27,71,2,18,147,129
27,71,3,25,180,155
27,71,4,33,182,149
27,71,5,28,174,146
27,71,6,37,188,151
27,72,0,43,178,135
27,72,1,27,160,133
27,72,2,34,184,150
27,72,3,35,177,142
27,72,4,29,150,121
27,72,5,25,189,164
27,72,6,41,205,164
27,73,0,24,173,149
27,73,1,36,180,144
27,73,2,29,168,139
27,73,3,37,167,130
27,73,4,27,165,138
27,73,5,24,170,146
27,73,6,29,221,192
27,74,0,19,176,157
27,74,1,24,160,136
27,74,2,26,142,116
27,74,3,26,164,138
27,74,4,45,194,149
27,74,5,29,190,161
27,74,6,45,249,204
27,75,0,44,170,126
27,75,1,28,175,147
27,75,2,25,168,143
27,75,3,35,169,134
27,75,4,57,205,148
27,75,5,41,204,163
27,75,6,24,223,199
27,76,0,14,174,160
27,76,1,31,188,157
27,76,2,20,161,141
27,76,3,35,201,166
27,76,4,44,223,179
27,76,5,64,217,153
27,76,6,35,196,161
27,77,0,32,183,151
27,77,1,25,176,151
27,77,2,27,161,134
27,77,3,19,163,144
27,77,4,39,185,146
27,77,5,38,205,167
27,77,6,30,193,163
27,78,0,21,183,162
27,78,1,19,167,148
27,78,2,31,178,147
27,78,3,21,179,158
27,78,4,32,201,169
27,78,5,40,190,150
27,78,6,47,216,169
27,79,0,22,170,148
27,79,1,31,188,157
27,79,2,42,224,182
27,79,3,26,215,189
27,79,4,20,183,163
27,79,5,49,219,170
27,79,6,37,220,183
27,80,0,30,192,162
27,80,1,21,187,166
27,80,2,36,202,166
27,80,3,36,206,170
27,80,4,36,191,155
27,80,5,28,207,179
27,80,6,41,240,199
27,81,0,40,185,145
27,81,1,17,182,165
27,81,2,27,206,179
27,81,3,39,184,145
27,81,4,28,208,180
27,81,5,39,233,194
27,81,6,41,213,172
27,82,0,36,191,155
27,82,1,19,167,148
27,82,2,28,197,169
27,82,3,28,184,156
27,82,4,35,225,190
27,82,5,35,225,190
27,82,6,40,202,162
27,83,0,24,197,173
27,83,1,7,156,149
27,83,2,29,213,184
27,83,3,31,190,159
27,83,4,34,217,183
27,83,5,28,198,170
27,83,6,45,224,179
27,84,0,21,160,139
27,84,1,22,180,158
27,84,2,24,166,142
27,84,3,29,170,141
27,84,4,36,190,154
27,84,5,33,208,175
27,84,6,45,241,196
27,85,0,26,175,149
27,85,1,22,159,137
27,85,2,25,176,151
27,85,3,35,163,128
27,85,4,43,254,211
27,85,5,45,201,156
27,85,6,37,227,190
27,86,0,31,162,131
27,86,1,29,175,146
27,86,2,24,186,162
27,86,3,25,170,145
27,86,4,37,205,168
27,86,5,32,201,169
27,86,6,43,223,180
27,87,0,28,174,146
27,87,1,38,194,156
27,87,2,26,199,173
27,87,3,30,185,155
27,87,4,29,190,161
27,87,5,24,186,162
27,87,6,36,236,200
27,88,0,24,177,153
27,88,1,38,214,176
27,88,2,22,204,182
27,88,3,36,207,171
27,88,4,29,204,175
27,88,5,29,168,139
27,88,6,41,261,220
27,89,0,22,191,169
27,89,1,36,199,163
27,89,2,21,175,154
27,89,3,23,183,160
27,89,4,28,201,173
27,89,5,28,188,160
27,89,6,40,234,194
27,90,0,20,166,146
27,90,1,20,173,153
27,90,2,22,181,159
27,90,3,13,150,137
27,90,4,24,195,171
27,90,5,26,191,165
27,90,6,29,230,201
27,91,0,17,185,168
27,91,1,31,166,135
27,91,2,30,220,190
27,91,3,26,205,179
27,91,4,44,231,187
27,91,5,26,199,173
27,91,6,41,239,198
27,92,0,25,191,166
27,92,1,18,195,177
27,92,2,40,212,172
27,92,3,17,188,171
27,92,4,52,242,190
27,92,5,25,173,148
27,92,6,52,257,205
27,93,0,21,206,185
27,93,1,30,222,192
27,93,2,24,237,213
27,93,3,26,217,191
27,93,4,44,251,207
27,93,5,38,186,148
27,93,6,41,269,228
27,94,0,32,227,195
27,94,1,36,237,201
27,94,2,21,214,193
27,94,3,33,203,170
27,94,4,32,275,243
27,94,5,64,266,202
27,94,6,31,274,243
27,95,0,27,196,169
27,95,1,27,184,157
27,95,2,26,219,193
27,95,3,26,211,185
27,95,4,48,253,205
27,95,5,31,222,191
27,95,6,30,239,209
27,96,0,29,201,172
27,96,1,27,212,185
27,96,2,32,242,210
27,96,3,25,230,205
27,96,4,41,240,199
27,96,5,43,228,185
27,96,6,38,287,249
27,97,0,34,233,199
27,97,1,36,224,188
27,97,2,23,252,229
27,97,3,25,224,199
27,97,4,34,257,223
27,97,5,32,249,217
27,97,6,51,344,293
27,98,0,23,243,220
27,98,1,23,258,235
27,98,2,41,266,225
27,98,3,28,269,241
27,98,4,29,263,234
27,98,5,18,242,224
27,98,6,51,308,257
27,99,0,38,274,236
27,99,1,48,272,224
27,99,2,43,296,253
27,99,3,28,285,257
27,99,4,52,286,234
27,99,5,39,295,256
27,99,6,40,370,330
27,100,0,20,257,237
27,100,1,27,261,234
27,100,2,49,338,289
27,100,3,34,271,237
27,100,4,47,290,243
27,100,5,43,326,283
27,100,6,39,340,301
27,101,0,25,286,261
27,101,1,24,266,242
27,101,2,39,347,308
27,101,3,30,336,306
27,101,4,68,355,287
27,101,5,45,316,271
27,101,6,36,344,308
27,102,0,37,403,366
27,102,1,27,395,368
27,102,2,71,482,411
27,102,3,34,437,403
27,102,4,41,402,361
27,102,5,44,346,302
27,102,6,43,356,313
27,103,0,28,341,313
27,103,1,34,370,336
27,103,2,88,450,362
27,103,3,31,403,372
27,103,4,52,402,350
27,103,5,30,317,287
27,103,6,36,326,290
27,104,0,36,370,334
27,104,1,39,340,301
27,104,2,95,423,328
27,104,3,37,391,354
27,104,4,49,386,337
27,104,5,43,323,280
27,104,6,47,395,348
27,105,0,38,319,281
27,105,1,19,320,301
27,105,2,33,370,337
27,105,3,32,339,307
27,105,4,43,340,297
27,105,5,38,321,283
27,105,6,36,314,278
27,106,0,17,301,284
27,106,1,25,278,253
27,106,2,36,319,283
27,106,3,23,271,248
27,106,4,65,373,308
27,106,5,32,265,233
27,106,6,25,277,252
27,107,0,20,215,195
27,107,1,21,254,233
27,107,2,30,294,264
27,107,3,11,248,237
27,107,4,31,251,220
27,107,5,30,206,176
27,107,6,33,242,209
27,108,0,15,219,204
27,108,1,14,247,233
27,108,2,18,277,259
27,108,3,32,288,256
27,108,4,30,257,227
27,108,5,35,236,201
27,108,6,22,234,212
27,109,0,9,229,220
27,109,1,33,270,237
27,109,2,27,277,250
27,109,3,39,268,229
27,109,4,16,249,233
27,109,5,11,210,199
27,109,6,16,214,198
27,110,0,16,259,243
27,110,1,8,246,238
27,110,2,16,255,239
27,110,3,18,279,261
27,110,4,22,253,231
27,110,5,24,266,242
27,110,6,19,280,261
27,111,0,19,274,255
27,111,1,15,268,253
27,111,2,24,284,260
27,111,3,18,263,245
27,111,4,27,334,307
27,111,5,20,279,259
27,111,6,21,295,274
27,112,0,11,263,252
27,112,1,14,289,275
27,112,2,26,308,282
27,112,3,34,271,237
27,112,4,24,295,271
27,112,5,19,272,253
27,112,6,21,245,224
27,113,0,17,278,261
27,113,1,23,284,261
27,113,2,17,299,282
27,113,3,22,271,249
27,113,4,12,251,239
27,113,5,11,246,235
27,113,6,25,272,247
27,114,0,4,201,197
27,114,1,22,259,237
27,114,2,17,276,259
27,114,3,16,229,213
27,114,4,9,219,210
27,114,5,10,248,238
27,114,6,17,238,221
27,115,0,16,199,183
27,115,1,20,196,176
27,115,2,18,244,226
27,115,3,20,231,211
27,115,4,26,225,199
27,115,5,22,244,222
27,115,6,32,246,214
27,116,0,19,201,182
27,116,1,26,228,202
27,116,2,17,210,193
27,116,3,16,219,203
27,116,4,34,228,194
27,116,5,26,217,191
27,116,6,27,234,207
27,117,0,11,180,169
27,117,1,22,239,217
27,117,2,23,226,203
27,117,3,21,224,203
27,117,4,21,232,211
27,117,5,19,215,196
27,117,6,22,238,216
27,118,0,16,185,169
27,118,1,20,212,192
27,118,2,13,235,222
27,118,3,19,229,210
27,118,4,22,243,221
27,118,5,10,212,202
27,118,6,22,215,193
27,119,0,17,214,197
27,119,1,27,206,179
27,119,2,13,230,217
27,119,3,9,196,187
27,119,4,25,233,208
27,119,5,34,226,192
27,119,6,25,215,190
27,120,0,11,204,193
27,120,1,29,244,215
27,120,2,23,277,254
27,120,3,25,264,239
27,120,4,25,258,233
27,120,5,19,218,199
27,120,6,42,264,222
27,121,0,23,211,188
27,121,1,17,243,226
27,121,2,12,230,218
27,121,3,30,218,188
27,121,4,12,233,221
27,121,5,19,233,214
27,121,6,28,223,195
27,122,0,16,213,197
27,122,1,18,224,206
27,122,2,18,231,213
27,122,3,25,229,204
27,122,4,19,223,204
27,122,5,13,203,190
27,122,6,28,221,193
27,123,0,18,206,188
27,123,1,40,247,207
27,123,2,8,228,220
27,123,3,11,198,187
27,123,4,22,275,253
27,123,5,16,187,171
27,123,6,32,232,200
27,124,0,15,181,166
27,124,1,16,213,197
27,124,2,12,225,213
27,124,3,9,176,167
27,124,4,15,219,204
27,124,5,20,234,214
27,124,6,24,256,232
27,125,0,15,185,170
27,125,1,22,230,208
27,125,2,15,233,218
27,125,3,12,224,212
27,125,4,36,286,250
27,125,5,14,195,181
27,125,6,11,209,198
27,126,0,15,175,160
27,126,1,18,218,200
27,126,2,12,223,211
27,126,3,28,229,201
27,126,4,25,235,210
27,126,5,26,235,209
27,126,6,8,202,194
27,127,0,18,197,179
27,127,1,21,208,187
27,127,2,23,203,180
27,127,3,15,199,184
27,127,4,15,233,218
27,127,5,39,250,211
27,127,6,15,191,176
27,128,0,19,192,173
27,128,1,8,198,190
27,128,2,17,234,217
27,128,3,18,210,192
27,128,4,23,229,206
27,128,5,26,221,195
27,128,6,6,187,181
27,129,0,16,236,220
27,129,1,14,231,217
27,129,2,16,241,225
27,129,3,7,204,197
27,129,4,11,222,211
27,129,5,21,237,216
27,129,6,12,225,213
27,130,0,23,199,176
27,130,1,7,160,153
27,130,2,12,231,219
27,130,3,17,208,191
27,130,4,17,214,197
27,130,5,21,226,205
27,130,6,10,203,193
27,131,0,11,178,167
27,131,1,10,146,136
27,131,2,10,172,162
27,131,3,12,167,155
27,131,4,15,192,177
27,131,5,30,235,205
27,131,6,7,177,170
27,132,0,15,152,137
27,132,1,12,187,175
27,132,2,18,179,161
27,132,3,9,162,153
27,132,4,14,209,195
27,132,5,10,245,235
27,132,6,18,151,133
27,133,0,5,134,129
27,133,1,7,146,139
27,133,2,11,157,146
27,133,3,15,149,134
27,133,4,15,171,156
27,133,5,24,193,169
27,133,6,8,130,122
27,134,0,5,121,116
27,134,1,8,139,131
27,134,2,3,143,140
27,134,3,7,142,135
27,134,4,15,168,153
27,134,5,18,200,182
27,134,6,13,127,114
27,135,0,4,122,118
27,135,1,4,158,154
27,135,2,12,165,153
27,135,3,13,140,127
27,135,4,5,153,148
27,135,5,13,167,154
27,135,6,13,159,146
27,136,0,4,131,127
27,136,1,6,137,131
27,136,2,7,134,127
27,136,3,9,152,143
27,136,4,8,150,142
27,136,5,2,155,153
27,136,6,5,123,118
27,137,0,7,132,125
27,137,1,8,108,100
27,137,2,4,139,135
27,137,3,9,120,111
27,137,4,8,130,122
27,137,5,5,141,136
27,137,6,2,139,137
27,138,0,14,147,133
27,138,1,6,102,96
27,138,2,5,125,120
27,138,3,6,135,129
27,138,4,4,124,120
27,138,5,8,160,152
27,138,6,10,131,121
27,139,0,8,111,103
27,139,1,7,108,101
27,139,2,7,113,106
27,139,3,6,117,111
27,139,4,6,137,131
27,139,5,8,153,145
27,139,6,5,110,105
27,140,0,3,122,119
27,140,1,8,116,108
27,140,2,9,133,124
27,140,3,11,158,147
27,140,4,3,132,129
27,140,5,8,165,157
27,140,6,7,123,116
27,141,0,16,127,111
27,141,1,9,111,102
27,141,2,2,126,124
27,141,3,23,151,128
27,141,4,14,143,129
27,141,5,30,164,134
27,141,6,10,129,119
27,142,0,31,142,111
27,142,1,3,100,97
27,142,2,8,113,105
27,142,3,21,144,123
27,142,4,2,152,150
27,142,5,17,151,134
27,142,6,15,141,126
27,143,0,34,130,96
27,143,1,11,155,144
27,143,2,3,125,122
27,143,3,17,133,116
27,143,4,11,128,117
27,143,5,23,179,156
27,143,6,36,162,126
28,0,0,21,128,107
28,0,1,34,169,135
28,0,2,20,154,134
28,0,3,25,165,140
28,0,4,7,203,196
28,0,5,16,208,192
28,0,6,9,155,146
28,1,0,17,111,94
28,1,1,51,137,86
28,1,2,31,151,120
28,1,3,36,155,119
28,1,4,12,206,194
28,1,5,20,189,169
28,1,6,15,154,139
28,2,0,35,158,123
28,2,1,45,158,113
28,2,2,11,118,107
28,2,3,25,139,114
28,2,4,15,197,182
28,2,5,18,136,118
28,2,6,14,160,146
28,3,0,33,126,93
28,3,1,29,128,99
28,3,2,18,123,105
28,3,3,25,134,109
28,3,4,12,195,183
28,3,5,12,158,146
28,3,6,8,144,136
28,4,0,9,108,99
28,4,1,27,129,102
28,4,2,27,114,87
28,4,3,15,106,91
28,4,4,2,154,152
28,4,5,11,135,124
28,4,6,15,137,122
28,5,0,10,85,75
28,5,1,24,110,86
28,5,2,11,85,74
28,5,3,20,98,78
28,5,4,10,142,132
28,5,5,12,119,107
28,5,6,6,133,127
28,6,0,10,95,85
28,6,1,23,104,81
28,6,2,7,83,76
28,6,3,3,64,61
28,6,4,9,180,171
28,6,5,13,125,112
28,6,6,10,116,106
28,7,0,17,86,69
28,7,1,24,89,65
28,7,2,18,93,75
28,7,3,10,97,87
28,7,4,8,141,133
28,7,5,9,102,93
28,7,6,21,147,126
28,8,0,14,67,53
28,8,1,24,91,67
28,8,2,20,82,62
28,8,3,6,84,78
28,8,4,7,140,133
28,8,5,21,127,106
28,8,6,32,110,78
28,9,0,16,84,68
28,9,1,15,54,39
28,9,2,12,54,42
28,9,3,10,68,58
28,9,4,11,120,109
28,9,5,11,92,81
28,9,6,13,110,97
28,10,0,18,56,38
28,10,1,9,61,52
28,10,2,2,55,53
28,10,3,7,47,40
28,10,4,5,105,100
28,10,5,10,91,81
28,10,6,10,101,91
28,11,0,8,52,44
28,11,1,17,52,35
28,11,2,12,66,54
28,11,3,9,53,44
28,11,4,9,111,102
28,11,5,16,95,79
28,11,6,18,101,83
28,12,0,17,53,36
28,12,1,11,54,43
28,12,2,10,49,39
28,12,3,9,45,36
28,12,4,13,90,77
28,12,5,17,90,73
28,12,6,4,62,58
28,13,0,7,42,35
28,13,1,11,47,36
28,13,2,4,40,36
28,13,3,22,43,21
28,13,4,5,83,78
28,13,5,97,170,73
28,13,6,18,74,56
28,14,0,5,30,25
28,14,1,9,46,37
28,14,2,14,44,30
28,14,3,8,37,29
28,14,4,6,62,56
28,14,5,71,130,59
28,14,6,7,57,50
28,15,0,1,21,20
28,15,1,7,29,22
28,15,2,6,34,28
28,15,3,4,38,34
28,15,4,12,75,63
28,15,5,37,84,47
28,15,6,18,67,49
28,16,0,5,28,23
28,16,1,9,29,20
28,16,2,9,38,29
28,16,3,9,45,36
28,16,4,8,48,40
28,16,5,14,38,24
28,16,6,5,46,41
28,17,0,15,37,22
28,17,1,4,20,16
28,17,2,4,23,19
28,17,3,10,39,29
28,17,4,15,65,50
28,17,5,8,34,26
28,17,6,3,39,36
28,18,0,7,26,19
28,18,1,6,32,26
28,18,2,9,35,26
28,18,3,8,39,31
28,18,4,16,56,40
28,18,5,9,29,20
28,18,6,5,37,32
28,19,0,3,15,12
28,19,1,5,35,30
28,19,2,3,22,19
28,19,3,4,15,11
28,19,4,5,36,31
28,19,5,11,33,22
28,19,6,4,37,33
28,20,0,0,8,8
28,20,1,1,17,16
28,20,2,1,12,11
28,20,3,3,31,28
28,20,4,8,33,25
28,20,5,6,31,25
28,20,6,10,34,24
28,21,0,6,20,14
28,21,1,1,19,18
28,21,2,2,18,16
28,21,3,3,14,11
28,21,4,9,35,26
28,21,5,4,23,19
28,21,6,9,32,23
28,22,0,5,22,17
28,22,1,6,22,16
28,22,2,3,14,11
28,22,3,10,25,15
28,22,4,8,24,16
28,22,5,5,22,17
28,22,6,4,28,24
28,23,0,3,15,12
28,23,1,10,24,14
28,23,2,1,11,10
28,23,3,4,12,8
28,23,4,15,44,29
28,23,5,6,29,23
28,23,6,7,27,20
28,24,0,3,9,6
28,24,1,2,11,9
28,24,2,0,9,9
28,24,3,3,20,17
28,24,4,4,17,13
28,24,5,2,14,12
28,24,6,3,20,17
28,25,0,3,20,17
28,25,1,2,10,8
28,25,2,1,19,18
28,25,3,1,19,18
28,25,4,19,41,22
28,25,5,4,28,24
28,25,6,3,20,17
28,26,0,2,13,11
28,26,1,0,17,17
28,26,2,3,20,17
28,26,3,4,14,10
28,26,4,39,51,12
28,26,5,3,20,17
28,26,6,3,17,14
28,27,0,4,15,11
28,27,1,5,20,15
28,27,2,3,21,18
28,27,3,4,18,14
28,27,4,25,39,14
28,27,5,3,17,14
28,27,6,3,25,22
28,28,0,4,11,7
28,28,1,3,18,15
28,28,2,2,11,9
28,28,3,1,11,10
28,28,4,23,41,18
28,28,5,2,18,16
28,28,6,3,18,15
28,29,0,3,11,8
28,29,1,1,9,8
28,29,2,3,16,13
28,29,3,10,25,15
28,29,4,21,43,22
28,29,5,4,20,16
28,29,6,5,16,11
28,30,0,16,34,18
28,30,1,2,13,11
28,30,2,4,17,13
28,30,3,6,26,20
28,30,4,26,36,10
28,30,5,8,19,11
28,30,6,3,26,23
28,31,0,9,30,21
28,31,1,2,20,18
28,31,2,4,19,15
28,31,3,6,15,9
28,31,4,38,54,16
28,31,5,12,31,19
28,31,6,3,23,20
28,32,0,11,28,17
28,32,1,9,29,20
28,32,2,6,24,18
28,32,3,4,20,16
28,32,4,29,43,14
28,32,5,4,23,19
28,32,6,3,15,12
28,33,0,10,25,15
28,33,1,8,29,21
28,33,2,11,36,25
28,33,3,8,20,12
28,33,4,27,42,15
28,33,5,4,16,12
28,33,6,13,30,17
28,34,0,17,39,22
28,34,1,15,35,20
28,34,2,12,34,22
28,34,3,14,33,19
28,34,4,51,75,24
28,34,5,9,36,27
28,34,6,5,28,23
28,35,0,9,35,26
28,35,1,19,46,27
28,35,2,8,29,21
28,35,3,6,30,24
28,35,4,59,77,18
28,35,5,7,33,26
28,35,6,3,28,25
28,36,0,23,49,26
28,36,1,11,43,32
28,36,2,16,45,29
28,36,3,19,40,21
28,36,4,67,96,29
28,36,5,8,36,28
28,36,6,12,38,26
28,37,0,38,57,19
28,37,1,20,41,21
28,37,2,43,73,30
28,37,3,17,42,25
28,37,4,79,108,29
28,37,5,16,37,21
28,37,6,19,46,27
28,38,0,36,81,45
28,38,1,27,66,39
28,38,2,26,67,41
28,38,3,27,63,36
28,38,4,53,101,48
28,38,5,20,59,39
28,38,6,13,41,28
28,39,0,8,159,151
28,39,1,3,95,92
28,39,2,0,96,96
28,39,3,5,100,95
28,39,4,48,136,88
28,39,5,13,72,59
28,39,6,9,73,64
28,40,0,5,152,147
28,40,1,2,131,129
28,40,2,7,118,111
28,40,3,7,110,103
28,40,4,84,177,93
28,40,5,8,68,60
28,40,6,4,54,50
28,41,0,6,174,168
28,41,1,3,166,163
28,41,2,2,197,195
28,41,3,4,169,165
28,41,4,30,183,153
28,41,5,7,100,93
28,41,6,13,80,67
28,42,0,12,338,326
28,42,1,6,270,264
28,42,2,6,308,302
28,42,3,6,274,268
28,42,4,24,277,253
28,42,5,8,161,153
28,42,6,27,141,114
28,43,0,36,555,519
28,43,1,14,387,373
28,43,2,9,404,395
28,43,3,10,407,397
28,43,4,17,377,360
28,43,5,19,180,161
28,43,6,15,166,151
28,44,0,76,696,620
28,44,1,19,584,565
28,44,2,16,655,639
28,44,3,18,617,599
28,44,4,20,472,452
28,44,5,21,256,235
28,44,6,28,217,189
28,45,0,91,895,804
28,45,1,25,730,705
28,45,2,38,814,776
28,45,3,36,785,749
28,45,4,18,560,542
28,45,5,22,339,317
28,45,6,40,300,260
28,46,0,171,1175,1004
28,46,1,41,996,955
28,46,2,56,1055,999
28,46,3,71,1125,1054
28,46,4,22,708,686
28,46,5,26,428,402
28,46,6,30,291,261
28,47,0,672,1913,1241
28,47,1,103,1410,1307
28,47,2,67,1358,1291
28,47,3,288,1607,1319
28,47,4,66,1023,957
28,47,5,18,424,406
28,47,6,25,367,342
28,48,0,2052,3312,1260
28,48,1,995,2392,1397
28,48,2,1025,2467,1442
28,48,3,547,2105,1558
28,48,4,414,1567,1153
28,48,5,18,511,493
28,48,6,12,393,381
28,49,0,2415,3670,1255
28,49,1,1869,3240,1371
28,49,2,1712,3122,1410
28,49,3,964,2504,1540
28,49,4,762,1881,1119
28,49,5,11,530,519
28,49,6,8,409,401
28,50,0,1874,3301,1427
28,50,1,1680,3163,1483
28,50,2,1183,2718,1535
28,50,3,554,2131,1577
28,50,4,394,1494,1100
28,50,5,22,631,609
28,50,6,7,420,413
28,51,0,2459,3911,1452
28,51,1,2280,3841,1561
28,51,2,1562,3149,1587
28,51,3,869,2600,1731
28,51,4,724,1914,1190
28,51,5,24,741,717
28,51,6,19,522,503
28,52,0,2398,3907,1509
28,52,1,2086,3665,1579
28,52,2,1452,3050,1598
28,52,3,862,2525,1663
28,52,4,691,1847,1156
28,52,5,44,741,697
28,52,6,22,546,524
28,53,0,1271,2928,1657
28,53,1,1029,2749,1720
28,53,2,439,2129,1690
28,53,3,177,1861,1684
28,53,4,135,1361,1226
28,53,5,18,554,536
28,53,6,8,445,437
28,54,0,638,2284,1646
28,54,1,83,1693,1610
28,54,2,40,1675,1635
28,54,3,42,1705,1663
28,54,4,33,1168,1135
28,54,5,21,598,577
28,54,6,10,464,454
28,55,0,510,2071,1561
28,55,1,46,1591,1545
28,55,2,24,1508,1484
28,55,3,28,1468,1440
28,55,4,27,1166,1139
28,55,5,8,583,575
28,55,6,8,485,477
28,56,0,79,1136,1057
28,56,1,12,985,973
28,56,2,23,989,966
28,56,3,23,1057,1034
28,56,4,14,819,805
28,56,5,15,609,594
28,56,6,15,436,421
28,57,0,13,821,808
28,57,1,13,733,720
28,57,2,10,817,807
28,57,3,22,895,873
28,57,4,24,681,657
28,57,5,10,542,532
28,57,6,8,424,416
28,58,0,16,675,659
28,58,1,13,691,678
28,58,2,8,706,698
28,58,3,13,760,747
28,58,4,18,599,581
28,58,5,12,595,583
28,58,6,15,469,454
28,59,0,5,518,513
28,59,1,16,592,576
28,59,2,6,552,546
28,59,3,13,590,577
28,59,4,10,517,507
28,59,5,14,528,514
28,59,6,8,420,412
28,60,0,11,472,461
28,60,1,6,441,435
28,60,2,10,481,471
28,60,3,16,539,523
28,60,4,23,487,464
28,60,5,10,498,488
28,60,6,8,398,390
28,61,0,11,409,398
28,61,1,14,443,429
28,61,2,11,453,442
28,61,3,15,472,457
28,61,4,36,477,441
28,61,5,12,472,460
28,61,6,8,424,416
28,62,0,8,409,401
28,62,1,9,441,432
28,62,2,7,444,437
28,62,3,13,433,420
28,62,4,47,438,391
28,62,5,19,485,466
28,62,6,10,418,408
28,63,0,12,440,428
28,63,1,6,391,385
28,63,2,13,366,353
28,63,3,3,445,442
28,63,4,27,439,412
28,63,5,13,462,449
28,63,6,5,442,437
28,64,0,7,405,398
28,64,1,9,366,357
28,64,2,12,396,384
28,64,3,13,428,415
28,64,4,42,441,399
28,64,5,13,479,466
28,64,6,16,435,419
28,65,0,7,369,362
28,65,1,6,386,380
28,65,2,8,380,372
28,65,3,12,366,354
28,65,4,36,441,405
28,65,5,11,432,421
28,65,6,14,390,376
28,66,0,8,383,375
28,66,1,10,382,372
28,66,2,8,397,389
28,66,3,13,397,384
28,66,4,31,425,394
28,66,5,11,421,410
28,66,6,20,479,459
28,67,0,10,356,346
28,67,1,10,418,408
28,67,2,5,371,366
28,67,3,12,397,385
28,67,4,42,435,393
28,67,5,11,462,451
28,67,6,30,485,455
28,68,0,13,409,396
28,68,1,18,430,412
28,68,2,13,415,402
28,68,3,9,428,419
28,68,4,39,448,409
28,68,5,13,474,461
28,68,6,21,481,460
28,69,0,11,442,431
28,69,1,13,403,390
28,69,2,14,438,424
28,69,3,7,427,420
28,69,4,67,525,458
28,69,5,23,488,465
28,69,6,38,510,472
28,70,0,12,408,396
28,70,1,11,406,395
28,70,2,19,469,450
28,70,3,21,443,422
28,70,4,82,485,403
28,70,5,21,469,448
28,70,6,27,473,446
28,71,0,12,393,381
28,71,1,10,406,396
28,71,2,15,412,397
28,71,3,11,393,382
28,71,4,39,452,413
28,71,5,25,490,465
28,71,6,13,476,463
28,72,0,12,460,448
28,72,1,21,421,400
28,72,2,7,392,385
28,72,3,12,405,393
28,72,4,66,501,435
28,72,5,21,448,427
28,72,6,19,505,486
28,73,0,6,387,381
28,73,1,12,446,434
28,73,2,12,403,391
28,73,3,7,415,408
28,73,4,46,448,402
28,73,5,12,497,485
28,73,6,13,470,457
28,74,0,15,432,417
28,74,1,14,391,377
28,74,2,12,388,376
28,74,3,6,386,380
28,74,4,31,411,380
28,74,5,20,534,514
28,74,6,13,522,509
28,75,0,13,394,381
28,75,1,12,462,450
28,75,2,4,407,403
28,75,3,16,430,414
28,75,4,39,441,402
28,75,5,15,497,482
28,75,6,8,531,523
28,76,0,11,446,435
28,76,1,7,450,443
28,76,2,14,494,480
28,76,3,8,443,435
28,76,4,39,472,433
28,76,5,8,483,475
28,76,6,19,537,518
28,77,0,14,462,448
28,77,1,13,456,443
28,77,2,10,461,451
28,77,3,7,472,465
28,77,4,81,553,472
28,77,5,19,512,493
28,77,6,9,536,527
28,78,0,18,501,483
28,78,1,21,501,480
28,78,2,25,521,496
28,78,3,17,473,456
28,78,4,42,511,469
28,78,5,29,607,578
28,78,6,8,561,553
28,79,0,24,504,480
28,79,1,21,510,489
28,79,2,17,494,477
28,79,3,9,449,440
28,79,4,74,567,493
28,79,5,29,575,546
28,79,6,9,581,572
28,80,0,14,490,476
28,80,1,19,521,502
28,80,2,20,524,504
28,80,3,14,511,497
28,80,4,72,552,480
28,80,5,43,603,560
28,80,6,16,558,542
28,81,0,13,498,485
28,81,1,21,474,453
28,81,2,14,501,487
28,81,3,17,500,483
28,81,4,42,506,464
28,81,5,35,616,581
28,81,6,30,647,617
28,82,0,15,468,453
28,82,1,29,531,502
28,82,2,15,517,502
28,82,3,13,491,478
28,82,4,99,595,496
28,82,5,34,608,574
28,82,6,18,654,636
28,83,0,23,445,422
28,83,1,31,470,439
28,83,2,14,438,424
28,83,3,16,490,474
28,83,4,128,526,398
28,83,5,23,533,510
28,83,6,17,605,588
28,84,0,18,420,402
28,84,1,29,460,431
28,84,2,16,442,426
28,84,3,12,430,418
28,84,4,99,529,430
28,84,5,15,533,518
28,84,6,14,597,583
28,85,0,21,431,410
28,85,1,13,422,409
28,85,2,13,424,411
28,85,3,17,410,393
28,85,4,110,581,471
28,85,5,15,552,537
28,85,6,20,591,571
28,86,0,33,436,403
28,86,1,28,391,363
28,86,2,20,405,385
28,86,3,15,450,435
28,86,4,73,508,435
28,86,5,13,544,531
28,86,6,7,544,537
28,87,0,10,417,407
28,87,1,8,438,430
28,87,2,11,375,364
28,87,3,18,427,409
28,87,4,112,521,409
28,87,5,21,500,479
28,87,6,17,562,545
28,88,0,17,404,387
28,88,1,18,415,397
28,88,2,12,414,402
28,88,3,11,426,415
28,88,4,49,458,409
28,88,5,15,500,485
28,88,6,18,585,567
28,89,0,20,425,405
28,89,1,21,396,375
28,89,2,18,371,353
28,89,3,15,391,376
28,89,4,81,510,429
28,89,5,15,474,459
28,89,6,12,568,556
28,90,0,18,451,433
28,90,1,17,429,412
28,90,2,26,460,434
28,90,3,17,427,410
28,90,4,44,471,427
28,90,5,13,498,485
28,90,6,18,592,574
28,91,0,39,431,392
28,91,1,29,447,418
28,91,2,33,474,441
28,91,3,44,405,361
28,91,4,43,468,425
28,91,5,13,488,475
28,91,6,43,648,605
28,92,0,55,507,452
28,92,1,39,466,427
28,92,2,27,439,412
28,92,3,53,466,413
28,92,4,50,490,440
28,92,5,22,511,489
28,92,6,32,568,536
28,93,0,19,509,490
28,93,1,16,497,481
28,93,2,18,477,459
28,93,3,16,484,468
28,93,4,11,443,432
28,93,5,20,515,495
28,93,6,20,577,557
28,94,0,17,455,438
28,94,1,11,418,407
28,94,2,15,450,435
28,94,3,18,435,417
28,94,4,12,505,493
28,94,5,28,523,495
28,94,6,33,584,551
28,95,0,25,456,431
28,95,1,20,449,429
28,95,2,13,460,447
28,95,3,11,438,427
28,95,4,17,463,446
28,95,5,25,522,497
28,95,6,32,643,611
28,96,0,18,539,521
28,96,1,22,534,512
28,96,2,19,535,516
28,96,3,8,438,430
28,96,4,22,460,438
28,96,5,10,530,520
28,96,6,17,657,640
28,97,0,14,478,464
28,97,1,12,501,489
28,97,2,19,508,489
28,97,3,7,434,427
28,97,4,17,447,430
28,97,5,7,481,474
28,97,6,21,646,625
28,98,0,11,464,453
28,98,1,21,524,503
28,98,2,32,493,461
28,98,3,8,456,448
28,98,4,17,496,479
28,98,5,15,511,496
28,98,6,19,642,623
28,99,0,12,513,501
28,99,1,15,514,499
28,99,2,21,555,534
28,99,3,6,486,480
28,99,4,13,515,502
28,99,5,14,564,550
28,99,6,12,638,626
28,100,0,12,482,470
28,100,1,11,510,499
28,100,2,29,534,505
28,100,3,19,508,489
28,100,4,28,518,490
28,100,5,14,559,545
28,100,6,18,647,629
28,101,0,19,581,562
28,101,1,33,593,560
28,101,2,34,578,544
28,101,3,26,585,559
28,101,4,31,582,551
28,101,5,25,573,548
28,101,6,20,642,622
28,102,0,31,803,772
28,102,1,57,872,815
28,102,2,54,899,845
28,102,3,71,968,897
28,102,4,46,755,709
28,102,5,41,706,665
28,102,6,28,696,668
28,103,0,56,711,655
28,103,1,72,767,695
28,103,2,57,801,744
28,103,3,61,787,726
28,103,4,52,721,669
28,103,5,38,655,617
28,103,6,23,695,672
28,104,0,56,758,702
28,104,1,78,743,665
28,104,2,49,691,642
28,104,3,37,784,747
28,104,4,62,682,620
28,104,5,29,682,653
28,104,6,27,680,653
28,105,0,66,1006,940
28,105,1,114,1085,971
28,105,2,285,1203,918
28,105,3,96,1109,1013
28,105,4,74,849,775
28,105,5,34,694,660
28,105,6,22,756,734
28,106,0,57,921,864
28,106,1,70,976,906
28,106,2,280,1018,738
28,106,3,143,966,823
28,106,4,67,853,786
28,106,5,35,674,639
28,106,6,14,712,698
28,107,0,53,789,736
28,107,1,33,823,790
28,107,2,271,1050,779
28,107,3,107,907,800
28,107,4,85,826,741
28,107,5,14,628,614
28,107,6,11,646,635
28,108,0,68,1058,990
28,108,1,62,984,922
28,108,2,383,1279,896
28,108,3,158,1167,1009
28,108,4,67,937,870
28,108,5,5,660,655
28,108,6,14,691,677
28,109,0,63,896,833
28,109,1,86,965,879
28,109,2,350,1188,838
28,109,3,127,942,815
28,109,4,70,831,761
28,109,5,7,624,617
28,109,6,17,615,598
28,110,0,33,791,758
28,110,1,64,922,858
28,110,2,270,1058,788
28,110,3,71,877,806
28,110,4,50,755,705
28,110,5,16,590,574
28,110,6,17,637,620
28,111,0,24,702,678
28,111,1,41,732,691
28,111,2,171,949,778
28,111,3,31,708,677
28,111,4,29,735,706
28,111,5,17,599,582
28,111,6,11,580,569
28,112,0,14,659,645
28,112,1,19,681,662
28,112,2,99,811,712
28,112,3,13,650,637
28,112,4,37,701,664
28,112,5,11,583,572
28,112,6,21,581,560
28,113,0,18,652,634
28,113,1,10,567,557
28,113,2,42,755,713
28,113,3,21,669,648
28,113,4,20,617,597
28,113,5,11,528,517
28,113,6,19,595,576
28,114,0,18,623,605
28,114,1,17,599,582
28,114,2,58,691,633
28,114,3,19,590,571
28,114,4,19,599,580
28,114,5,12,558,546
28,114,6,12,602,590
28,115,0,19,571,552
28,115,1,19,639,620
28,115,2,43,677,634
28,115,3,25,558,533
28,115,4,14,567,553
28,115,5,22,521,499
28,115,6,16,552,536
28,116,0,7,598,591
28,116,1,13,594,581
28,116,2,40,647,607
28,116,3,24,587,563
28,116,4,13,549,536
28,116,5,12,558,546
28,116,6,23,625,602
28,117,0,12,611,599
28,117,1,30,607,577
28,117,2,35,629,594
28,117,3,16,602,586
28,117,4,18,637,619
28,117,5,28,565,537
28,117,6,29,589,560
28,118,0,23,609,586
28,118,1,19,664,645
28,118,2,22,673,651
28,118,3,17,622,605
28,118,4,24,593,569
28,118,5,23,556,533
28,118,6,31,690,659
28,119,0,25,673,648
28,119,1,23,601,578
28,119,2,26,675,649
28,119,3,17,630,613
28,119,4,38,687,649
28,119,5,18,567,549
28,119,6,36,646,610
28,120,0,20,678,658
28,120,1,19,721,702
28,120,2,23,728,705
28,120,3,24,780,756
28,120,4,16,653,637
28,120,5,17,596,579
28,120,6,21,699,678
28,121,0,28,687,659
28,121,1,27,736,709
28,121,2,27,755,728
28,121,3,29,750,721
28,121,4,26,701,675
28,121,5,19,665,646
28,121,6,24,740,716
28,122,0,27,735,708
28,122,1,25,786,761
28,122,2,29,749,720
28,122,3,25,698,673
28,122,4,27,734,707
28,122,5,18,645,627
28,122,6,21,702,681
28,123,0,33,693,660
28,123,1,33,802,769
28,123,2,40,796,756
28,123,3,38,716,678
28,123,4,28,728,700
28,123,5,27,669,642
28,123,6,25,678,653
28,124,0,47,710,663
28,124,1,54,776,722
28,124,2,35,777,742
28,124,3,25,713,688
28,124,4,41,769,728
28,124,5,23,630,607
28,124,6,21,649,628
28,125,0,35,681,646
28,125,1,41,755,714
28,125,2,41,842,801
28,125,3,39,778,739
28,125,4,119,876,757
28,125,5,26,645,619
28,125,6,21,669,648
28,126,0,60,785,725
28,126,1,143,877,734
28,126,2,89,976,887
28,126,3,65,876,811
28,126,4,138,904,766
28,126,5,26,718,692
28,126,6,31,743,712
28,127,0,169,875,706
28,127,1,147,912,765
28,127,2,41,774,733
28,127,3,117,801,684
28,127,4,165,891,726
28,127,5,31,659,628
28,127,6,31,667,636
28,128,0,98,756,658
28,128,1,141,843,702
28,128,2,90,832,742
28,128,3,78,731,653
28,128,4,121,871,750
28,128,5,25,676,651
28,128,6,21,663,642
28,129,0,84,726,642
28,129,1,141,791,650
28,129,2,60,752,692
28,129,3,40,663,623
28,129,4,100,921,821
28,129,5,14,600,586
28,129,6,38,695,657
28,130,0,112,658,546
28,130,1,29,648,619
28,130,2,27,711,684
28,130,3,39,653,614
28,130,4,82,739,657
28,130,5,29,675,646
28,130,6,25,525,500
28,131,0,14,510,496
28,131,1,30,543,513
28,131,2,18,578,560
28,131,3,32,639,607
28,131,4,81,751,670
28,131,5,194,807,613
28,131,6,18,502,484
28,132,0,20,591,571
28,132,1,33,575,542
28,132,2,26,569,543
28,132,3,35,581,546
28,132,4,45,647,602
28,132,5,302,908,606
28,132,6,11,477,466
28,133,0,17,487,470
28,133,1,18,461,443
28,133,2,19,514,495
28,133,3,15,453,438
28,133,4,23,554,531
28,133,5,240,748,508
28,133,6,10,439,429
28,134,0,11,398,387
28,134,1,10,410,400
28,134,2,15,450,435
28,134,3,12,393,381
28,134,4,14,515,501
28,134,5,172,652,480
28,134,6,14,415,401
28,135,0,4,305,301
28,135,1,7,361,354
28,135,2,6,402,396
28,135,3,17,374,357
28,135,4,16,431,415
28,135,5,72,542,470
28,135,6,5,413,408
28,136,0,13,317,304
28,136,1,11,278,267
28,136,2,13,359,346
28,136,3,15,320,305
28,136,4,13,440,427
28,136,5,18,404,386
28,136,6,10,342,332
28,137,0,3,311,308
28,137,1,6,310,304
28,137,2,21,339,318
28,137,3,13,338,325
28,137,4,12,389,377
28,137,5,23,373,350
28,137,6,18,358,340
28,138,0,16,276,260
28,138,1,9,291,282
28,138,2,17,321,304
28,138,3,14,274,260
28,138,4,15,332,317
28,138,5,37,385,348
28,138,6,94,434,340
28,139,0,13,219,206
28,139,1,19,235,216
28,139,2,12,255,243
28,139,3,20,298,278
28,139,4,8,312,304
28,139,5,36,357,321
28,139,6,46,306,260
28,140,0,8,193,185
28,140,1,35,262,227
28,140,2,14,205,191
28,140,3,18,236,218
28,140,4,23,302,279
28,140,5,14,274,260
28,140,6,71,290,219
28,141,0,11,193,182
28,141,1,12,195,183
28,141,2,15,200,185
28,141,3,22,215,193
28,141,4,12,268,256
28,141,5,12,247,235
28,141,6,53,237,184
28,142,0,26,182,156
28,142,1,26,204,178
28,142,2,18,196,178
28,142,3,15,197,182
28,142,4,29,274,245
28,142,5,18,210,192
28,142,6,23,163,140
28,143,0,28,156,128
28,143,1,15,177,162
28,143,2,12,164,152
28,143,3,22,163,141
28,143,4,22,194,172
28,143,5,12,191,179
28,143,6,12,121,109
29,0,0,7,29,22
29,0,1,4,18,14
29,0,2,7,30,23
29,0,3,5,27,22
29,0,4,2,23,21
29,0,5,2,27,25
29,0,6,3,32,29
29,1,0,11,29,18
29,1,1,9,22,13
29,1,2,5,25,20
29,1,3,3,16,13
29,1,4,2,29,27
29,1,5,1,26,25
29,1,6,4,24,20
29,2,0,6,23,17
29,2,1,2,21,19
29,2,2,6,23,17
29,2,3,2,17,15
29,2,4,9,27,18
29,2,5,4,29,25
29,2,6,4,26,22
29,3,0,11,25,14
29,3,1,2,21,19
29,3,2,6,25,19
29,3,3,1,17,16
29,3,4,3,25,22
29,3,5,7,21,14
29,3,6,1,12,11
29,4,0,8,22,14
29,4,1,4,16,12
29,4,2,3,17,14
29,4,3,1,12,11
29,4,4,9,33,24
29,4,5,4,27,23
29,4,6,5,24,19
29,5,0,14,30,16
29,5,1,4,19,15
29,5,2,2,11,9
29,5,3,5,19,14
29,5,4,3,20,17
29,5,5,4,16,12
29,5,6,1,20,19
29,6,0,6,25,19
29,6,1,10,17,7
29,6,2,2,9,7
29,6,3,4,11,7
29,6,4,3,18,15
29,6,5,3,16,13
29,6,6,3,18,15
29,7,0,5,17,12
29,7,1,0,12,12
29,7,2,3,13,10
29,7,3,0,10,10
29,7,4,0,9,9
29,7,5,2,9,7
29,7,6,4,14,10
29,8,0,2,11,9
29,8,1,1,12,11
29,8,2,0,11,11
29,8,3,5,18,13
29,8,4,0,17,17
29,8,5,3,15,12
29,8,6,3,9,6
29,9,0,3,8,5
29,9,1,3,7,4
29,9,2,2,11,9
29,9,3,2,13,11
29,9,4,1,18,17
29,9,5,3,14,11
29,9,6,1,14,13
29,10,0,0,9,9
29,10,1,1,6,5
29,10,2,3,13,10
29,10,3,1,14,13
29,10,4,3,13,10
29,10,5,2,11,9
29,10,6,3,12,9
29,11,0,0,5,5
29,11,1,0,6,6
29,11,2,2,6,4
29,11,3,2,13,11
29,11,4,2,17,15
29,11,5,2,10,8
29,11,6,4,10,6
29,12,0,6,13,7
29,12,1,0,5,5
29,12,2,2,11,9
29,12,3,2,5,3
29,12,4,2,19,17
29,12,5,0,8,8
29,12,6,3,10,7
29,13,0,1,8,7
29,13,1,2,7,5
29,13,2,0,1,1
29,13,3,1,11,10
29,13,4,1,11,10
29,13,5,2,8,6
29,13,6,0,7,7
29,14,0,3,8,5
29,14,1,1,12,11
29,14,2,0,9,9
29,14,3,0,5,5
29,14,4,5,15,10
29,14,5,0,8,8
29,14,6,3,13,10
29,15,0,3,8,5
29,15,1,1,8,7
29,15,2,0,5,5
29,15,3,1,11,10
29,15,4,5,12,7
29,15,5,0,7,7
29,15,6,1,7,6
29,16,0,5,9,4
29,16,1,3,9,6
29,16,2,6,10,4
29,16,3,4,9,5
29,16,4,5,15,10
29,16,5,0,11,11
29,16,6,1,4,3
29,17,0,0,4,4
29,17,1,0,2,2
29,17,2,5,11,6
29,17,3,2,3,1
29,17,4,2,4,2
29,17,5,2,6,4
29,17,6,0,8,8
29,18,0,4,6,2
29,18,1,3,4,1
29,18,2,3,7,4
29,18,3,0,4,4
29,18,4,1,6,5
29,18,5,2,7,5
29,18,6,4,12,8
29,19,0,2,7,5
29,19,1,1,4,3
29,19,2,2,4,2
29,19,3,0,2,2
29,19,4,2,6,4
29,19,5,3,8,5
29,19,6,1,7,6
29,20,1,2,5,3
29,20,2,1,1,0
29,20,3,1,2,1
29,20,4,3,16,13
29,20,5,0,5,5
29,20,6,6,13,7
29,21,0,2,5,3
29,21,1,3,9,6
29,21,2,2,5,3
29,21,3,1,4,3
29,21,4,4,6,2
29,21,5,2,4,2
29,21,6,0,3,3
29,22,0,6,7,1
29,22,1,2,3,1
29,22,2,2,5,3
29,22,3,2,6,4
29,22,4,4,6,2
29,22,5,1,2,1
29,22,6,1,4,3
29,23,0,4,5,1
29,23,1,2,3,1
29,23,2,0,3,3
29,23,3,0,1,1
29,23,4,1,7,6
29,23,5,4,6,2
29,23,6,6,8,2
29,24,0,3,6,3
29,24,1,3,7,4
29,24,2,0,2,2
29,24,3,2,5,3
29,24,4,0,4,4
29,24,5,0,3,3
29,24,6,0,5,5
29,25,0,4,5,1
29,25,1,3,5,2
29,25,2,3,6,3
29,25,3,1,1,0
29,25,5,0,4,4
29,25,6,0,3,3
29,26,0,3,5,2
29,26,1,1,4,3
29,26,2,3,5,2
29,26,4,3,3,0
29,26,5,0,3,3
29,26,6,0,3,3
29,27,0,3,7,4
29,27,1,0,3,3
29,27,2,0,2,2
29,27,3,0,3,3
29,27,4,0,3,3
29,27,5,2,3,1
29,27,6,2,3,1
29,28,0,0,1,1
29,28,1,6,8,2
29,28,2,3,5,2
29,28,3,2,5,3
29,28,4,2,6,4
29,28,5,5,10,5
29,28,6,1,4,3
29,29,0,3,9,6
29,29,1,3,6,3
29,29,2,1,3,2
29,29,3,2,8,6
29,29,4,0,4,4
29,29,5,4,10,6
29,29,6,0,2,2
29,30,0,3,5,2
29,30,1,1,4,3
29,30,2,0,4,4
29,30,3,4,6,2
29,30,4,1,5,4
29,30,5,1,4,3
29,30,6,4,8,4
29,31,0,3,8,5
29,31,1,2,6,4
29,31,2,3,7,4
29,31,3,5,12,7
29,31,4,3,8,5
29,31,5,3,5,2
29,31,6,2,4,2
29,32,0,5,9,4
29,32,1,4,12,8
29,32,2,2,5,3
29,32,3,6,10,4
29,32,4,2,6,4
29,32,5,10,13,3
29,32,6,1,7,6
29,33,0,4,7,3
29,33,1,1,4,3
29,33,2,9,16,7
29,33,3,2,7,5
29,33,4,8,11,3
29,33,5,3,7,4
29,33,6,4,8,4
29,34,0,5,16,11
29,34,1,3,9,6
29,34,2,9,17,8
29,34,3,1,5,4
29,34,4,11,15,4
29,34,5,3,9,6
29,34,6,3,5,2
29,35,0,13,19,6
29,35,1,9,16,7
29,35,2,9,15,6
29,35,3,7,17,10
29,35,4,15,20,5
29,35,5,5,14,9
29,35,6,8,11,3
29,36,0,10,20,10
29,36,1,9,16,7
29,36,2,11,26,15
29,36,3,14,27,13
29,36,4,12,22,10
29,36,5,4,9,5
29,36,6,13,22,9
29,37,0,12,27,15
29,37,1,11,22,11
29,37,2,13,23,10
29,37,3,9,19,10
29,37,4,25,36,11
29,37,5,7,15,8
29,37,6,6,13,7
29,38,0,18,36,18
29,38,1,11,28,17
29,38,2,9,30,21
29,38,3,8,24,16
29,38,4,26,37,11
29,38,5,4,11,7
29,38,6,10,26,16
29,39,0,2,50,48
29,39,1,1,47,46
29,39,2,2,41,39
29,39,3,5,51,46
29,39,4,8,47,39
29,39,5,3,22,19
29,39,6,9,35,26
29,40,0,3,48,45
29,40,1,1,44,43
29,40,2,0,47,47
29,40,3,2,45,43
29,40,4,4,42,38
29,40,5,1,30,29
29,40,6,2,18,16
29,41,0,0,69,69
29,41,1,4,64,60
29,41,2,3,81,78
29,41,3,3,54,51
29,41,4,9,61,52
29,41,5,3,43,40
29,41,6,6,37,31
29,42,0,3,105,102
29,42,1,2,107,105
29,42,2,3,109,106
29,42,3,3,108,105
29,42,4,7,87,80
29,42,5,1,56,55
29,42,6,5,57,52
29,43,0,14,168,154
29,43,1,3,128,125
29,43,2,2,129,127
29,43,3,2,116,114
29,43,4,11,104,93
29,43,5,5,79,74
29,43,6,11,67,56
29,44,0,12,152,140
29,44,1,5,129,124
29,44,2,4,122,118
29,44,3,1,129,128
29,44,4,10,125,115
29,44,5,5,75,70
29,44,6,19,82,63
29,45,0,41,226,185
29,45,1,11,177,166
29,45,2,4,159,155
29,45,3,18,180,162
29,45,4,7,137,130
29,45,5,4,113,109
29,45,6,10,100,90
29,46,0,46,195,149
29,46,1,8,163,155
29,46,2,5,157,152
29,46,3,21,162,141
29,46,4,47,170,123
29,46,5,2,92,90
29,46,6,2,56,54
29,47,0,78,251,173
29,47,1,13,166,153
29,47,2,22,195,173
29,47,3,30,208,178
29,47,4,29,163,134
29,47,5,8,110,102
29,47,6,12,93,81
29,48,0,191,342,151
29,48,1,71,239,168
29,48,2,68,227,159
29,48,3,56,246,190
29,48,4,32,165,133
29,48,5,14,124,110
29,48,6,17,105,88
29,49,0,184,310,126
29,49,1,54,186,132
29,49,2,102,254,152
29,49,3,32,188,156
29,49,4,36,176,140
29,49,5,30,133,103
29,49,6,13,90,77
29,50,0,99,236,137
29,50,1,51,188,137
29,50,2,61,189,128
29,50,3,28,171,143
29,50,4,47,180,133
29,50,5,31,146,115
29,50,6,25,113,88
29,51,0,114,253,139
29,51,1,68,196,128
29,51,2,61,184,123
29,51,3,33,164,131
29,51,4,29,136,107
29,51,5,27,134,107
29,51,6,13,84,71
29,52,0,91,223,132
29,52,1,78,211,133
29,52,2,31,154,123
29,52,3,32,150,118
29,52,4,40,129,89
29,52,5,17,114,97
29,52,6,10,95,85
29,53,0,44,181,137
29,53,1,25,128,103
29,53,2,21,136,115
29,53,3,8,119,111
29,53,4,12,133,121
29,53,5,4,75,71
29,53,6,13,83,70
29,54,0,24,155,131
29,54,1,8,117,109
29,54,2,6,110,104
29,54,3,20,134,114
29,54,4,8,103,95
29,54,5,5,79,74
29,54,6,9,93,84
29,55,0,12,101,89
29,55,1,10,107,97
29,55,2,2,91,89
29,55,3,15,113,98
29,55,4,5,106,101
29,55,5,5,84,79
29,55,6,2,79,77
29,56,0,12,107,95
29,56,1,17,93,76
29,56,2,2,84,82
29,56,3,10,96,86
29,56,4,6,81,75
29,56,5,2,79,77
29,56,6,2,80,78
29,57,0,18,82,64
29,57,1,11,90,79
29,57,2,22,85,63
29,57,3,27,117,90
29,57,4,18,102,84
29,57,5,3,96,93
29,57,6,5,70,65
29,58,0,19,91,72
29,58,1,17,89,72
29,58,2,25,108,83
29,58,3,10,80,70
29,58,4,33,108,75
29,58,5,2,64,62
29,58,6,10,80,70
29,59,0,29,86,57
29,59,1,16,96,80
29,59,2,20,81,61
29,59,3,17,106,89
29,59,4,32,108,76
29,59,5,5,77,72
29,59,6,5,83,78
29,60,0,10,76,66
29,60,1,6,78,72
29,60,2,22,99,77
29,60,3,19,92,73
29,60,4,40,105,65
29,60,5,4,98,94
29,60,6,16,105,89
29,61,0,14,76,62
29,61,1,9,70,61
29,61,2,18,78,60
29,61,3,8,73,65
29,61,4,41,116,75
29,61,5,9,90,81
29,61,6,7,79,72
29,62,0,13,89,76
29,62,1,9,72,63
29,62,2,13,84,71
29,62,3,23,85,62
29,62,4,32,100,68
29,62,5,1,84,83
29,62,6,4,101,97
29,63,0,13,71,58
29,63,1,9,71,62
29,63,2,20,52,32
29,63,3,30,87,57
29,63,4,30,116,86
29,63,5,3,77,74
29,63,6,13,85,72
29,64,0,16,75,59
29,64,1,17,71,54
29,64,2,13,87,74
29,64,3,21,82,61
29,64,4,19,98,79
29,64,5,9,94,85
29,64,6,6,93,87
29,65,0,31,98,67
29,65,1,19,70,51
29,65,2,9,72,63
29,65,3,34,94,60
29,65,4,17,69,52
29,65,5,7,68,61
29,65,6,12,78,66
29,66,0,23,85,62
29,66,1,25,62,37
29,66,2,25,76,51
29,66,3,13,66,53
29,66,4,28,87,59
29,66,5,6,70,64
29,66,6,5,85,80
29,67,0,18,60,42
29,67,1,17,67,50
29,67,2,15,62,47
29,67,3,8,62,54
29,67,4,22,70,48
29,67,5,7,71,64
29,67,6,8,79,71
29,68,0,7,57,50
29,68,1,11,74,63
29,68,2,21,88,67
29,68,3,11,58,47
29,68,4,21,86,65
29,68,5,13,84,71
29,68,6,4,73,69
29,69,0,8,48,40
29,69,1,11,64,53
29,69,2,19,86,67
29,69,3,13,63,50
29,69,4,30,104,74
29,69,5,9,93,84
29,69,6,5,78,73
29,70,0,3,54,51
29,70,1,14,62,48
29,70,2,5,63,58
29,70,3,13,67,54
29,70,4,30,90,60
29,70,5,9,86,77
29,70,6,5,78,73
29,71,0,7,59,52
29,71,1,10,68,58
29,71,2,7,79,72
29,71,3,11,75,64
29,71,4,24,82,58
29,71,5,2,62,60
29,71,6,4,80,76
29,72,0,4,62,58
29,72,1,11,64,53
29,72,2,2,54,52
29,72,3,16,64,48
29,72,4,35,105,70
29,72,5,5,80,75
29,72,6,8,103,95
29,73,0,9,96,87
29,73,1,6,68,62
29,73,2,11,85,74
29,73,3,6,94,88
29,73,4,14,98,84
29,73,5,6,75,69
29,73,6,4,114,110
29,74,0,6,73,67
29,74,1,10,69,59
29,74,2,10,76,66
29,74,3,29,106,77
29,74,4,12,97,85
29,74,5,21,112,91
29,74,6,3,99,96
29,75,0,7,89,82
29,75,1,17,99,82
29,75,2,4,76,72
29,75,3,22,110,88
29,75,4,25,99,74
29,75,5,15,85,70
29,75,6,7,112,105
29,76,0,9,81,72
29,76,1,27,90,63
29,76,2,11,72,61
29,76,3,12,89,77
29,76,4,14,98,84
29,76,5,8,86,78
29,76,6,9,97,88
29,77,0,12,76,64
29,77,1,5,58,53
29,77,2,16,86,70
29,77,3,15,81,66
29,77,4,17,89,72
29,77,5,9,93,84
29,77,6,10,115,105
29,78,0,16,78,62
29,78,1,10,89,79
29,78,2,13,86,73
29,78,3,9,65,56
29,78,4,20,93,73
29,78,5,6,102,96
29,78,6,10,102,92
29,79,0,26,106,80
29,79,1,15,80,65
29,79,2,11,83,72
29,79,3,4,74,70
29,79,4,13,86,73
29,79,5,10,85,75
29,79,6,2,92,90
29,80,0,26,105,79
29,80,1,16,83,67
29,80,2,27,100,73
29,80,3,8,78,70
29,80,4,25,79,54
29,80,5,17,107,90
29,80,6,6,106,100
29,81,0,15,91,76
29,81,1,10,77,67
29,81,2,22,83,61
29,81,3,13,85,72
29,81,4,18,78,60
29,81,5,14,98,84
29,81,6,5,95,90
29,82,0,15,80,65
29,82,1,10,85,75
29,82,2,17,85,68
29,82,3,13,81,68
29,82,4,24,99,75
29,82,5,8,77,69
29,82,6,5,85,80
29,83,0,11,75,64
29,83,1,15,68,53
29,83,2,5,65,60
29,83,3,15,87,72
29,83,4,23,101,78
29,83,5,3,92,89
29,83,6,3,82,79
29,84,0,8,73,65
29,84,1,6,70,64
29,84,2,13,81,68
29,84,3,12,67,55
29,84,4,27,92,65
29,84,5,2,78,76
29,84,6,6,78,72
29,85,0,6,61,55
29,85,1,15,87,72
29,85,2,6,51,45
29,85,3,6,52,46
29,85,4,30,84,54
29,85,5,7,86,79
29,85,6,3,77,74
29,86,0,3,56,53
29,86,1,10,67,57
29,86,2,5,54,49
29,86,3,10,56,46
29,86,4,19,78,59
29,86,5,6,77,71
29,86,6,2,79,77
29,87,0,4,55,51
29,87,1,6,72,66
29,87,2,4,76,72
29,87,3,9,47,38
29,87,4,19,86,67
29,87,5,10,87,77
29,87,6,5,67,62
29,88,0,8,73,65
29,88,1,4,59,55
29,88,2,3,72,69
29,88,3,12,73,61
29,88,4,17,94,77
29,88,5,3,71,68
29,88,6,5,81,76
29,89,0,3,60,57
29,89,1,0,48,48
29,89,2,10,76,66
29,89,3,4,60,56
29,89,4,6,61,55
29,89,5,3,61,58
29,89,6,4,78,74
29,90,0,16,75,59
29,90,1,2,56,54
29,90,2,9,69,60
29,90,3,4,46,42
29,90,4,16,78,62
29,90,5,2,56,54
29,90,6,2,78,76
29,91,0,7,56,49
29,91,1,6,70,64
29,91,2,3,52,49
29,91,3,6,54,48
29,91,4,5,72,67
29,91,5,7,65,58
29,91,6,6,92,86
29,92,0,6,58,52
29,92,1,7,59,52
29,92,2,4,50,46
29,92,3,7,58,51
29,92,4,11,71,60
29,92,5,2,54,52
29,92,6,4,85,81
29,93,0,3,64,61
29,93,1,2,55,53
29,93,2,5,66,61
29,93,3,1,56,55
29,93,4,1,62,61
29,93,5,2,58,56
29,93,6,4,67,63
29,94,0,1,46,45
29,94,1,3,55,52
29,94,2,3,54,51
29,94,3,2,50,48
29,94,4,5,71,66
29,94,5,2,54,52
29,94,6,2,69,67
29,95,0,2,54,52
29,95,1,1,54,53
29,95,2,5,61,56
29,95,3,3,65,62
29,95,4,5,59,54
29,95,5,2,63,61
29,95,6,9,71,62
29,96,0,5,62,57
29,96,1,2,67,65
29,96,2,4,62,58
29,96,3,2,53,51
29,96,4,2,50,48
29,96,5,6,60,54
29,96,6,6,89,83
29,97,0,2,44,42
29,97,1,0,48,48
29,97,2,9,64,55
29,97,3,2,67,65
29,97,4,4,72,68
29,97,5,1,58,57
29,97,6,1,89,88
29,98,0,4,74,70
29,98,1,2,71,69
29,98,2,2,52,50
29,98,3,8,73,65
29,98,4,1,66,65
29,98,5,4,75,71
29,98,6,1,73,72
29,99,0,1,68,67
29,99,1,2,60,58
29,99,2,1,59,58
29,99,3,3,53,50
29,99,4,1,67,66
29,99,5,3,56,53
29,99,6,4,68,64
29,100,0,1,61,60
29,100,1,3,76,73
29,100,2,1,69,68
29,100,3,7,61,54
29,100,4,3,82,79
29,100,5,3,62,59
29,100,6,2,85,83
29,101,0,2,88,86
29,101,1,3,72,69
29,101,2,8,70,62
29,101,3,12,82,70
29,101,4,2,68,66
29,101,5,3,65,62
29,101,6,1,65,64
29,102,0,2,71,69
29,102,1,1,88,87
29,102,2,14,88,74
29,102,3,7,92,85
29,102,4,7,83,76
29,102,5,6,91,85
29,102,6,3,87,84
29,103,0,6,78,72
29,103,1,6,75,69
29,103,2,18,100,82
29,103,3,7,85,78
29,103,4,2,80,78
29,103,5,4,88,84
29,103,6,2,81,79
29,104,0,7,78,71
29,104,1,8,89,81
29,104,2,4,77,73
29,104,3,11,104,93
29,104,4,8,101,93
29,104,5,6,102,96
29,104,6,2,70,68
29,105,0,16,115,99
29,105,1,2,105,103
29,105,2,14,106,92
29,105,3,12,111,99
29,105,4,13,122,109
29,105,5,9,112,103
29,105,6,5,74,69
29,106,0,14,117,103
29,106,1,2,101,99
29,106,2,24,130,106
29,106,3,10,108,98
29,106,4,13,111,98
29,106,5,13,110,97
29,106,6,5,87,82
29,107,0,13,102,89
29,107,1,4,104,100
29,107,2,27,121,94
29,107,3,9,93,84
29,107,4,7,93,86
29,107,5,14,97,83
29,107,6,2,89,87
29,108,0,6,87,81
29,108,1,8,119,111
29,108,2,29,141,112
29,108,3,9,115,106
29,108,4,11,126,115
29,108,5,4,106,102
29,108,6,2,98,96
29,109,0,4,95,91
29,109,1,6,84,78
29,109,2,39,134,95
29,109,3,8,96,88
29,109,4,4,97,93
29,109,5,5,93,88
29,109,6,2,91,89
29,110,0,10,90,80
29,110,1,4,81,77
29,110,2,26,122,96
29,110,3,3,82,79
29,110,4,11,116,105
29,110,5,2,82,80
29,110,6,4,111,107
29,111,0,5,81,76
29,111,1,3,87,84
29,111,2,6,92,86
29,111,3,1,92,91
29,111,4,8,90,82
29,111,5,4,84,80
29,111,6,2,81,79
29,112,0,0,61,61
29,112,1,2,91,89
29,112,2,3,80,77
29,112,3,5,82,77
29,112,4,0,74,74
29,112,5,5,84,79
29,112,6,6,94,88
29,113,0,2,66,64
29,113,1,3,85,82
29,113,2,7,85,78
29,113,3,3,83,80
29,113,4,2,72,70
29,113,5,7,93,86
29,113,6,6,96,90
29,114,0,10,73,63
29,114,1,2,70,68
29,114,2,2,77,75
29,114,3,6,64,58
29,114,4,7,98,91
29,114,5,9,89,80
29,114,6,5,88,83
29,115,0,4,66,62
29,115,1,0,52,52
29,115,2,3,66,63
29,115,3,3,61,58
29,115,4,8,76,68
29,115,5,4,91,87
29,115,6,9,93,84
29,116,0,1,73,72
29,116,1,3,59,56
29,116,2,4,77,73
29,116,3,3,57,54
29,116,4,7,79,72
29,116,5,8,84,76
29,116,6,16,94,78
29,117,0,2,45,43
29,117,1,3,62,59
29,117,2,3,79,76
29,117,3,1,65,64
29,117,4,3,97,94
29,117,5,6,71,65
29,117,6,6,68,62
29,118,0,1,61,60
29,118,1,3,70,67
29,118,2,1,76,75
29,118,3,5,75,70
29,118,4,6,87,81
29,118,5,6,81,75
29,118,6,2,67,65
29,119,0,6,67,61
29,119,1,3,71,68
29,119,2,2,65,63
29,119,3,3,58,55
29,119,4,3,82,79
29,119,5,12,88,76
29,119,6,11,88,77
29,120,0,3,88,85
29,120,1,7,89,82
29,120,2,3,82,79
29,120,3,5,84,79
29,120,4,5,81,76
29,120,5,1,83,82
29,120,6,3,60,57
29,121,0,3,68,65
29,121,1,1,63,62
29,121,2,3,58,55
29,121,3,7,77,70
29,121,4,3,83,80
29,121,5,1,66,65
29,121,6,3,63,60
29,122,0,1,61,60
29,122,1,6,66,60
29,122,2,6,77,71
29,122,3,2,62,60
29,122,4,7,100,93
29,122,5,5,81,76
29,122,6,3,71,68
29,123,0,1,76,75
29,123,1,2,70,68
29,123,2,3,64,61
29,123,3,5,82,77
29,123,4,4,76,72
29,123,5,6,79,73
29,123,6,6,77,71
29,124,0,2,62,60
29,124,1,7,83,76
29,124,2,3,67,64
29,124,3,2,48,46
29,124,4,5,73,68
29,124,5,10,85,75
29,124,6,4,63,59
29,125,0,3,50,47
29,125,1,6,70,64
29,125,2,8,62,54
29,125,3,2,61,59
29,125,4,7,73,66
29,125,5,9,91,82
29,125,6,5,69,64
29,126,0,2,74,72
29,126,1,4,66,62
29,126,2,4,75,71
29,126,3,6,65,59
29,126,4,2,65,63
29,126,5,1,56,55
29,126,6,2,77,75
29,127,0,6,67,61
29,127,1,8,58,50
29,127,2,3,58,55
29,127,3,6,57,51
29,127,4,5,67,62
29,127,5,8,82,74
29,127,6,4,59,55
29,128,0,4,58,54
29,128,1,16,79,63
29,128,2,3,57,54
29,128,3,0,56,56
29,128,4,4,86,82
29,128,5,7,49,42
29,128,6,7,71,64
29,129,0,4,46,42
29,129,1,8,67,59
29,129,2,3,60,57
29,129,3,10,74,64
29,129,4,3,68,65
29,129,5,10,72,62
29,129,6,3,60,57
29,130,0,5,44,39
29,130,1,7,47,40
29,130,2,4,70,66
29,130,3,2,51,49
29,130,4,5,67,62
29,130,5,4,67,63
29,130,6,2,56,54
29,131,0,2,57,55
29,131,1,4,46,42
29,131,2,8,69,61
29,131,3,4,53,49
29,131,4,3,60,57
29,131,5,5,64,59
29,131,6,8,61,53
29,132,0,3,50,47
29,132,1,5,72,67
29,132,2,3,51,48
29,132,3,6,77,71
29,132,4,7,71,64
29,132,5,5,73,68
29,132,6,8,70,62
29,133,0,3,52,49
29,133,1,0,46,46
29,133,2,4,53,49
29,133,3,6,56,50
29,133,4,1,56,55
29,133,5,3,56,53
29,133,6,1,53,52
29,134,0,1,32,31
29,134,1,4,50,46
29,134,2,2,43,41
29,134,3,1,45,44
29,134,4,1,60,59
29,134,5,2,55,53
29,134,6,8,51,43
29,135,0,8,45,37
29,135,1,2,42,40
29,135,2,1,41,40
29,135,3,2,41,39
29,135,4,3,70,67
29,135,5,6,58,52
29,135,6,2,43,41
29,136,0,5,49,44
29,136,1,1,35,34
29,136,2,3,47,44
29,136,3,3,34,31
29,136,4,2,42,40
29,136,5,9,71,62
29,136,6,3,42,39
29,137,0,3,33,30
29,137,1,3,35,32
29,137,2,1,37,36
29,137,3,3,32,29
29,137,4,12,69,57
29,137,5,4,43,39
29,137,6,5,42,37
29,138,0,4,34,30
29,138,1,2,33,31
29,138,2,6,44,38
29,138,3,1,25,24
29,138,4,6,37,31
29,138,5,5,34,29
29,138,6,1,38,37
29,139,0,9,46,37
29,139,1,5,32,27
29,139,2,1,35,34
29,139,3,3,22,19
29,139,4,3,47,44
29,139,5,5,42,37
29,139,6,2,33,31
29,140,0,0,13,13
29,140,1,3,27,24
29,140,2,4,26,22
29,140,3,6,36,30
29,140,4,7,38,31
29,140,5,3,36,33
29,140,6,6,39,33
29,141,0,7,30,23
29,141,1,2,26,24
29,141,2,4,26,22
29,141,3,2,25,23
29,141,4,5,32,27
29,141,5,4,26,22
29,141,6,7,30,23
29,142,0,5,32,27
29,142,1,7,35,28
29,142,2,4,35,31
29,142,3,4,31,27
29,142,4,5,32,27
29,142,5,5,31,26
29,142,6,4,35,31
29,143,0,3,25,22
29,143,1,10,35,25
29,143,2,4,38,34
29,143,3,4,25,21
29,143,4,4,30,26
29,143,5,1,27,26
29,143,6,5,31,26
30,0,1,0,1,1
30,0,2,1,1,0
30,0,4,0,1,1
30,0,5,1,2,1
30,0,6,4,5,1
30,1,0,4,4,0
30,1,1,0,2,2
30,1,2,1,3,2
30,1,3,0,1,1
30,1,4,4,4,0
30,1,5,5,7,2
30,1,6,0,1,1
30,2,0,3,4,1
30,2,1,1,1,0
30,2,2,0,1,1
30,2,3,0,1,1
30,2,4,2,6,4
30,2,5,1,2,1
30,2,6,0,1,1
30,3,0,0,4,4
30,3,1,3,3,0
30,3,3,2,2,0
30,3,4,0,2,2
30,3,5,0,1,1
30,3,6,1,1,0
30,4,0,2,4,2
30,4,1,2,3,1
30,4,3,2,3,1
30,4,6,0,1,1
30,5,1,2,2,0
30,5,4,1,4,3
30,6,0,4,4,0
30,6,1,2,2,0
30,6,4,0,1,1
30,6,6,1,2,1
30,7,0,2,3,1
30,7,1,0,1,1
30,7,3,4,5,1
30,7,6,0,1,1
30,8,3,0,1,1
30,8,4,0,1,1
30,9,4,0,1,1
30,9,6,0,1,1
30,10,6,7,7,0
30,11,4,2,3,1
30,11,6,1,1,0
30,12,4,0,3,3
30,13,5,0,1,1
30,14,0,1,1,0
30,14,3,1,1,0
30,15,6,0,1,1
30,16,2,1,1,0
30,16,4,1,1,0
30,17,1,2,2,0
30,18,1,2,2,0
30,18,4,0,1,1
30,19,2,1,1,0
30,19,4,1,1,0
30,20,4,2,2,0
30,21,1,1,1,0
30,21,4,1,1,0
30,21,5,2,2,0
30,22,5,2,2,0
30,29,4,1,1,0
30,31,3,1,1,0
30,34,6,0,1,1
30,35,0,1,1,0
30,36,0,1,1,0
30,36,1,1,2,1
30,36,3,1,1,0
30,37,0,2,2,0
30,37,3,1,1,0
30,37,4,2,3,1
30,37,6,3,3,0
30,38,0,1,2,1
30,38,1,2,3,1
30,38,3,2,2,0
30,38,5,1,1,0
30,38,6,3,4,1
30,39,0,0,6,6
30,39,1,0,6,6
30,39,2,0,2,2
30,39,3,1,4,3
30,39,5,4,5,1
30,39,6,1,2,1
30,40,0,0,9,9
30,40,1,1,8,7
30,40,2,0,6,6
30,40,3,0,3,3
30,40,4,4,7,3
30,40,5,0,3,3
30,40,6,2,3,1
30,41,0,0,10,10
30,41,1,0,6,6
30,41,2,0,11,11
30,41,3,0,6,6
30,41,4,1,5,4
30,41,5,0,4,4
30,41,6,1,5,4
30,42,0,0,9,9
30,42,1,0,14,14
30,42,2,5,17,12
30,42,3,1,13,12
30,42,4,0,4,4
30,42,5,0,1,1
30,42,6,0,2,2
30,43,0,2,11,9
30,43,1,2,14,12
30,43,2,0,10,10
30,43,3,0,7,7
30,43,4,2,15,13
30,43,5,0,3,3
30,44,0,2,16,14
30,44,1,0,4,4
30,44,2,2,11,9
30,44,3,0,15,15
30,44,4,1,16,15
30,44,5,0,1,1
30,44,6,4,12,8
30,45,0,1,14,13
30,45,1,3,15,12
30,45,2,2,13,11
30,45,3,6,18,12
30,45,4,2,9,7
30,45,5,0,7,7
30,45,6,1,1,0
30,46,0,1,16,15
30,46,1,0,8,8
30,46,2,1,16,15
30,46,3,3,18,15
30,46,4,1,13,12
30,46,5,1,7,6
30,46,6,0,7,7
30,47,0,0,9,9
30,47,1,2,19,17
30,47,2,0,10,10
30,47,3,0,12,12
30,47,4,2,8,6
30,47,5,1,9,8
30,47,6,2,10,8
30,48,0,0,7,7
30,48,1,2,14,12
30,48,2,2,11,9
30,48,3,0,6,6
30,48,4,0,14,14
30,48,5,0,10,10
30,48,6,0,7,7
30,49,0,0,6,6
30,49,1,1,7,6
30,49,2,1,9,8
30,49,3,3,21,18
30,49,4,0,8,8
30,49,5,1,11,10
30,49,6,2,7,5
30,50,0,0,17,17
30,50,1,0,15,15
30,50,2,0,12,12
30,50,3,3,17,14
30,50,4,0,10,10
30,50,5,1,9,8
30,50,6,0,8,8
30,51,0,3,11,8
30,51,1,0,5,5
30,51,2,0,13,13
30,51,3,1,11,10
30,51,4,2,13,11
30,51,5,3,15,12
30,51,6,6,13,7
30,52,0,2,8,6
30,52,1,1,12,11
30,52,2,2,12,10
30,52,3,2,7,5
30,52,4,4,13,9
30,52,5,0,8,8
30,52,6,1,7,6
30,53,0,7,14,7
30,53,1,3,8,5
30,53,2,2,9,7
30,53,3,5,12,7
30,53,4,1,13,12
30,53,5,3,10,7
30,53,6,2,14,12
30,54,0,1,11,10
30,54,1,2,6,4
30,54,2,5,10,5
30,54,3,4,15,11
30,54,4,1,7,6
30,54,5,3,16,13
30,54,6,9,17,8
30,55,0,1,7,6
30,55,1,1,6,5
30,55,2,3,11,8
30,55,3,5,17,12
30,55,4,1,8,7
30,55,5,1,10,9
30,55,6,1,8,7
30,56,0,4,10,6
30,56,1,1,8,7
30,56,2,4,8,4
30,56,3,3,9,6
30,56,4,0,8,8
30,56,5,1,10,9
30,56,6,1,6,5
30,57,0,3,10,7
30,57,1,1,3,2
30,57,2,3,8,5
30,57,3,2,7,5
30,57,4,3,10,7
30,57,5,3,8,5
30,57,6,2,15,13
30,58,0,1,3,2
30,58,1,1,6,5
30,58,2,7,15,8
30,58,3,1,5,4
30,58,4,3,11,8
30,58,5,1,13,12
30,58,6,5,6,1
30,59,0,1,5,4
30,59,1,0,2,2
30,59,2,3,6,3
30,59,3,1,11,10
30,59,4,4,9,5
30,59,5,1,6,5
30,59,6,0,5,5
30,60,0,0,7,7
30,60,1,2,7,5
30,60,2,3,5,2
30,60,3,2,5,3
30,60,4,7,10,3
30,60,5,2,7,5
30,60,6,1,12,11
30,61,0,2,8,6
30,61,1,2,9,7
30,61,2,1,7,6
30,61,3,2,6,4
30,61,4,5,9,4
30,61,5,0,6,6
30,61,6,11,18,7
30,62,0,1,2,1
30,62,1,0,3,3
30,62,2,4,10,6
30,62,3,1,1,0
30,62,4,9,15,6
30,62,5,3,7,4
30,62,6,3,15,12
30,63,0,2,4,2
30,63,1,1,9,8
30,63,2,3,6,3
30,63,3,6,11,5
30,63,4,4,8,4
30,63,5,5,12,7
30,63,6,0,12,12
30,64,0,5,9,4
30,64,1,1,9,8
30,64,2,9,13,4
30,64,3,3,11,8
30,64,4,4,10,6
30,64,5,9,14,5
30,64,6,3,7,4
30,65,0,4,8,4
30,65,1,9,12,3
30,65,2,1,7,6
30,65,3,1,7,6
30,65,4,0,4,4
30,65,5,3,10,7
30,65,6,8,16,8
30,66,0,0,7,7
30,66,1,2,8,6
30,66,2,3,3,0
30,66,3,0,1,1
30,66,4,4,10,6
30,66,5,4,8,4
30,66,6,4,10,6
30,67,0,4,8,4
30,67,1,1,3,2
30,67,2,6,9,3
30,67,3,0,6,6
30,67,4,5,9,4
30,67,5,4,9,5
30,67,6,1,9,8
30,68,0,2,5,3
30,68,1,0,3,3
30,68,2,8,14,6
30,68,3,0,4,4
30,68,4,2,9,7
30,68,5,7,19,12
30,68,6,2,9,7
30,69,0,7,10,3
30,69,1,1,6,5
30,69,2,8,11,3
30,69,3,1,3,2
30,69,4,3,12,9
30,69,5,6,12,6
30,69,6,0,7,7
30,70,0,6,8,2
30,70,1,1,8,7
30,70,2,6,6,0
30,70,3,3,10,7
30,70,4,4,9,5
30,70,5,7,11,4
30,70,6,1,5,4
30,71,0,0,1,1
30,71,1,0,2,2
30,71,2,2,9,7
30,71,3,0,7,7
30,71,4,0,7,7
30,71,5,0,8,8
30,71,6,1,5,4
30,72,0,0,4,4
30,72,1,2,8,6
30,72,2,1,3,2
30,72,3,2,8,6
30,72,4,2,8,6
30,72,5,5,15,10
30,72,6,3,9,6
30,73,0,2,5,3
30,73,1,1,2,1
30,73,2,2,8,6
30,73,3,0,3,3
30,73,4,1,8,7
30,73,5,3,14,11
30,73,6,1,12,11
30,74,0,3,10,7
30,74,1,1,6,5
30,74,2,4,8,4
30,74,3,2,8,6
30,74,4,4,14,10
30,74,5,2,10,8
30,74,6,2,7,5
30,75,0,10,16,6
30,75,1,4,10,6
30,75,2,1,12,11
30,75,3,3,8,5
30,75,4,2,13,11
30,75,5,1,15,14
30,75,6,0,8,8
30,76,0,1,4,3
30,76,1,5,10,5
30,76,2,2,8,6
30,76,3,1,4,3
30,76,4,4,12,8
30,76,5,1,13,12
30,76,6,0,6,6
30,77,0,2,10,8
30,77,1,2,6,4
30,77,2,6,11,5
30,77,3,4,10,6
30,77,4,3,10,7
30,77,5,4,16,12
30,77,6,4,8,4
30,78,0,1,6,5
30,78,1,4,13,9
30,78,2,0,6,6
30,78,3,18,26,8
30,78,4,2,9,7
30,78,5,2,8,6
30,78,6,4,14,10
30,79,0,1,9,8
30,79,1,1,8,7
30,79,2,4,10,6
30,79,3,4,9,5
30,79,4,0,5,5
30,79,5,0,8,8
30,79,6,4,17,13
30,80,0,1,5,4
30,80,1,2,8,6
30,80,2,8,17,9
30,80,3,1,9,8
30,80,4,4,10,6
30,80,5,1,10,9
30,80,6,1,9,8
30,81,0,0,8,8
30,81,1,8,16,8
30,81,2,3,8,5
30,81,3,2,5,3
30,81,4,1,9,8
30,81,5,6,14,8
30,81,6,2,7,5
30,82,0,0,3,3
30,82,1,0,1,1
30,82,2,0,5,5
30,82,3,2,6,4
30,82,4,5,10,5
30,82,5,1,14,13
30,82,6,2,8,6
30,83,0,1,6,5
30,83,1,0,3,3
30,83,2,1,5,4
30,83,3,1,7,6
30,83,4,1,7,6
30,83,5,0,3,3
30,83,6,6,12,6
30,84,0,3,6,3
30,84,1,2,6,4
30,84,2,2,6,4
30,84,3,7,11,4
30,84,4,0,11,11
30,84,5,0,4,4
30,84,6,2,8,6
30,85,0,1,7,6
30,85,1,4,9,5
30,85,2,3,3,0
30,85,3,3,7,4
30,85,4,3,6,3
30,85,5,0,5,5
30,85,6,0,10,10
30,86,0,1,4,3
30,86,1,5,10,5
30,86,2,1,9,8
30,86,3,2,11,9
30,86,4,4,9,5
30,86,5,1,8,7
30,86,6,5,9,4
30,87,0,1,6,5
30,87,1,4,6,2
30,87,2,3,8,5
30,87,3,0,5,5
30,87,4,4,10,6
30,87,5,1,8,7
30,87,6,0,11,11
30,88,0,0,8,8
30,88,1,8,13,5
30,88,2,0,8,8
30,88,3,0,7,7
30,88,4,4,8,4
30,88,5,4,12,8
30,88,6,0,3,3
30,89,0,0,4,4
30,89,1,1,4,3
30,89,2,2,4,2
30,89,3,2,8,6
30,89,4,4,12,8
30,89,5,4,11,7
30,89,6,5,11,6
30,90,0,1,8,7
30,90,1,0,4,4
30,90,2,1,3,2
30,90,3,4,9,5
30,90,4,4,12,8
30,90,5,1,12,11
30,90,6,1,10,9
30,91,0,2,7,5
30,91,1,0,4,4
30,91,2,0,4,4
30,91,3,1,8,7
30,91,4,1,8,7
30,91,5,1,5,4
30,91,6,1,10,9
30,92,0,4,8,4
30,92,1,1,9,8
30,92,2,1,6,5
30,92,3,1,7,6
30,92,4,0,8,8
30,92,5,1,5,4
30,92,6,4,16,12
30,93,0,0,2,2
30,93,1,4,11,7
30,93,2,0,4,4
30,93,3,0,4,4
30,93,4,1,7,6
30,93,5,0,8,8
30,93,6,1,7,6
30,94,0,1,15,14
30,94,1,0,5,5
30,94,2,0,7,7
30,94,3,0,8,8
30,94,4,3,9,6
30,94,5,0,6,6
30,94,6,1,11,10
30,95,0,0,9,9
30,95,1,0,4,4
30,95,2,2,8,6
30,95,3,1,9,8
30,95,4,0,10,10
30,95,5,6,20,14
30,95,6,1,9,8
30,96,0,0,4,4
30,96,1,0,9,9
30,96,2,1,11,10
30,96,3,0,8,8
30,96,4,0,9,9
30,96,5,0,11,11
30,96,6,1,18,17
30,97,0,1,11,10
30,97,1,0,13,13
30,97,2,4,15,11
30,97,3,0,10,10
30,97,4,1,8,7
30,97,5,0,12,12
30,97,6,2,14,12
30,98,0,1,7,6
30,98,1,0,4,4
30,98,2,2,19,17
30,98,3,0,16,16
30,98,4,1,9,8
30,98,5,0,10,10
30,98,6,2,15,13
30,99,0,0,6,6
30,99,1,0,10,10
30,99,2,0,8,8
30,99,3,1,8,7
30,99,4,0,14,14
30,99,5,4,9,5
30,99,6,1,11,10
30,100,0,2,11,9
30,100,1,2,7,5
30,100,2,0,5,5
30,100,3,2,12,10
30,100,4,0,13,13
30,100,5,1,9,8
30,100,6,3,17,14
30,101,0,2,6,4
30,101,1,0,9,9
30,101,2,0,9,9
30,101,3,0,9,9
30,101,4,0,13,13
30,101,5,1,7,6
30,101,6,1,8,7
30,102,0,1,9,8
30,102,1,0,12,12
30,102,2,1,9,8
30,102,3,2,9,7
30,102,4,1,16,15
30,102,5,2,14,12
30,102,6,1,9,8
30,103,0,0,10,10
30,103,1,0,8,8
30,103,2,4,20,16
30,103,3,0,5,5
30,103,4,3,14,11
30,103,5,0,9,9
30,103,6,1,13,12
30,104,0,0,2,2
30,104,1,1,12,11
30,104,2,3,16,13
30,104,3,4,16,12
30,104,4,1,13,12
30,104,5,1,11,10
30,104,6,0,9,9
30,105,0,0,11,11
30,105,1,1,9,8
30,105,2,3,9,6
30,105,3,2,8,6
30,105,4,0,9,9
30,105,5,1,13,12
30,105,6,0,8,8
30,106,0,0,4,4
30,106,1,0,6,6
30,106,2,2,11,9
30,106,3,1,9,8
30,106,4,3,13,10
30,106,5,1,14,13
30,106,6,0,7,7
30,107,0,0,8,8
30,107,1,2,8,6
30,107,2,1,8,7
30,107,3,2,7,5
30,107,4,4,10,6
30,107,5,1,11,10
30,107,6,0,5,5
30,108,0,2,10,8
30,108,1,0,4,4
30,108,2,0,10,10
30,108,3,0,10,10
30,108,4,3,11,8
30,108,5,1,8,7
30,108,6,3,9,6
30,109,0,0,13,13
30,109,1,1,13,12
30,109,2,4,17,13
30,109,3,0,6,6
30,109,4,0,8,8
30,109,5,1,7,6
30,109,6,0,7,7
30,110,0,1,9,8
30,110,1,1,8,7
30,110,2,1,14,13
30,110,3,0,7,7
30,110,4,1,8,7
30,110,5,0,9,9
30,110,6,0,6,6
30,111,0,0,9,9
30,111,1,0,7,7
30,111,2,3,7,4
30,111,3,1,7,6
30,111,4,4,10,6
30,111,5,0,6,6
30,111,6,2,15,13
30,112,0,1,10,9
30,112,1,4,17,13
30,112,2,1,13,12
30,112,3,0,15,15
30,112,4,0,9,9
30,112,5,0,12,12
30,112,6,0,6,6
30,113,0,0,4,4
30,113,1,0,8,8
30,113,2,0,4,4
30,113,3,4,14,10
30,113,4,4,13,9
30,113,5,0,11,11
30,113,6,0,7,7
30,114,0,2,11,9
30,114,1,1,18,17
30,114,2,0,9,9
30,114,3,1,8,7
30,114,4,1,4,3
30,114,5,1,8,7
30,114,6,2,8,6
30,115,0,1,8,7
30,115,1,3,9,6
30,115,2,2,8,6
30,115,3,2,10,8
30,115,4,2,11,9
30,115,5,6,15,9
30,115,6,4,11,7
30,116,0,2,7,5
30,116,1,3,9,6
30,116,2,0,7,7
30,116,3,2,13,11
30,116,4,0,4,4
30,116,5,0,5,5
30,116,6,5,12,7
30,117,0,2,10,8
30,117,1,1,7,6
30,117,2,0,5,5
30,117,3,3,10,7
30,117,4,0,4,4
30,117,5,3,9,6
30,117,6,1,13,12
30,118,0,1,8,7
30,118,1,0,6,6
30,118,2,0,7,7
30,118,3,0,8,8
30,118,4,1,10,9
30,118,5,5,13,8
30,118,6,7,19,12
30,119,0,0,3,3
30,119,1,2,10,8
30,119,2,0,6,6
30,119,3,0,5,5
30,119,4,5,14,9
30,119,5,2,14,12
30,119,6,4,15,11
30,120,0,0,9,9
30,120,1,0,5,5
30,120,2,2,11,9
30,120,3,2,9,7
30,120,4,2,14,12
30,120,5,1,7,6
30,120,6,5,18,13
30,121,0,2,9,7
30,121,1,0,6,6
30,121,2,5,15,10
30,121,3,3,8,5
30,121,4,4,13,9
30,121,5,2,10,8
30,121,6,12,21,9
30,122,0,2,10,8
30,122,1,0,4,4
30,122,2,2,6,4
30,122,3,1,14,13
30,122,4,2,10,8
30,122,5,1,6,5
30,122,6,5,14,9
30,123,0,2,8,6
30,123,1,0,13,13
30,123,2,0,9,9
30,123,3,2,8,6
30,123,4,0,6,6
30,123,5,1,14,13
30,123,6,4,15,11
30,124,0,0,4,4
30,124,1,0,4,4
30,124,2,1,4,3
30,124,3,1,5,4
30,124,4,1,5,4
30,124,5,2,9,7
30,124,6,3,9,6
30,125,0,0,2,2
30,125,1,1,4,3
30,125,2,0,7,7
30,125,3,1,9,8
30,125,4,1,6,5
30,125,5,1,10,9
30,125,6,0,9,9
30,126,0,1,6,5
30,126,1,1,9,8
30,126,2,0,5,5
30,126,3,1,4,3
30,126,4,0,5,5
30,126,5,0,8,8
30,126,6,0,2,2
30,127,0,1,8,7
30,127,1,2,4,2
30,127,2,0,10,10
30,127,3,4,7,3
30,127,4,3,11,8
30,127,5,0,7,7
30,127,6,1,9,8
30,128,0,0,5,5
30,128,1,2,5,3
30,128,2,1,3,2
30,128,3,2,8,6
30,128,4,1,12,11
30,128,5,0,6,6
30,128,6,1,7,6
30,129,0,4,9,5
30,129,1,1,8,7
30,129,2,0,2,2
30,129,3,0,3,3
30,129,4,2,8,6
30,129,5,0,6,6
30,129,6,0,1,1
30,130,0,2,5,3
30,130,1,0,4,4
30,130,2,0,3,3
30,130,3,0,4,4
30,130,4,3,7,4
30,130,5,2,8,6
30,130,6,0,4,4
30,131,0,0,2,2
30,131,1,2,4,2
30,131,2,3,12,9
30,131,3,1,5,4
30,131,4,0,4,4
30,131,5,0,3,3
30,131,6,7,9,2
30,132,0,1,3,2
30,132,1,1,7,6
30,132,2,2,7,5
30,132,3,1,3,2
30,132,4,1,7,6
30,132,5,5,7,2
30,132,6,0,3,3
30,133,0,1,4,3
30,133,1,0,2,2
30,133,2,0,5,5
30,133,3,1,5,4
30,133,4,0,4,4
30,133,5,3,5,2
30,133,6,4,8,4
30,134,1,0,3,3
30,134,3,4,5,1
30,134,4,0,3,3
30,134,5,0,4,4
30,134,6,3,5,2
30,135,0,0,2,2
30,135,1,0,1,1
30,135,2,1,4,3
30,135,3,1,5,4
30,135,4,0,3,3
30,135,5,1,5,4
30,135,6,0,2,2
30,136,1,0,1,1
30,136,2,1,1,0
30,136,3,0,2,2
30,136,4,0,1,1
30,136,5,0,2,2
30,136,6,1,3,2
30,137,0,1,7,6
30,137,2,0,2,2
30,137,4,1,7,6
30,137,5,0,2,2
30,137,6,1,2,1
30,138,0,2,3,1
30,138,1,1,2,1
30,138,2,1,3,2
30,138,5,1,1,0
30,138,6,4,5,1
30,139,0,2,4,2
30,139,2,5,6,1
30,139,3,0,2,2
30,139,4,0,1,1
30,139,5,0,1,1
30,139,6,0,3,3
30,140,0,1,2,1
30,140,1,0,1,1
30,140,2,2,2,0
30,140,4,2,4,2
30,140,6,1,1,0
30,141,0,1,4,3
30,141,2,0,1,1
30,141,3,2,3,1
30,141,4,1,2,1
30,141,5,2,5,3
30,141,6,2,3,1
30,142,0,1,1,0
30,142,1,1,2,1
30,142,3,1,5,4
30,142,5,6,11,5
30,143,0,2,4,2
30,143,1,2,2,0
30,143,2,0,1,1
30,143,3,0,2,2
30,143,4,0,2,2
30,143,5,2,6,4
30,143,6,1,2,1
31,0,0,3,7,4
31,0,1,2,10,8
31,0,2,6,18,12
31,0,3,5,11,6
31,0,4,3,12,9
31,0,5,5,10,5
31,0,6,4,17,13
31,1,0,0,7,7
31,1,1,10,18,8
31,1,2,7,18,11
31,1,3,2,8,6
31,1,4,2,13,11
31,1,5,0,7,7
31,1,6,3,12,9
31,2,0,2,11,9
31,2,1,6,14,8
31,2,2,2,9,7
31,2,3,7,12,5
31,2,4,3,14,11
31,2,5,3,7,4
31,2,6,1,6,5
31,3,0,3,8,5
31,3,1,4,10,6
31,3,2,4,8,4
31,3,3,1,6,5
31,3,4,6,14,8
31,3,5,0,12,12
31,3,6,0,3,3
31,4,0,3,7,4
31,4,1,7,14,7
31,4,2,1,4,3
31,4,3,0,4,4
31,4,4,6,10,4
31,4,5,8,18,10
31,4,6,0,8,8
31,5,0,0,4,4
31,5,1,0,3,3
31,5,2,6,12,6
31,5,3,2,7,5
31,5,4,4,13,9
31,5,5,8,17,9
31,5,6,5,13,8
31,6,0,2,6,4
31,6,1,2,7,5
31,6,2,6,10,4
31,6,3,4,6,2
31,6,4,3,9,6
31,6,5,1,4,3
31,6,6,4,15,11
31,7,0,6,14,8
31,7,1,1,4,3
31,7,2,5,9,4
31,7,3,2,4,2
31,7,4,1,7,6
31,7,5,1,9,8
31,7,6,4,11,7
31,8,0,4,6,2
31,8,1,2,6,4
31,8,3,2,9,7
31,8,4,7,16,9
31,8,5,1,6,5
31,8,6,7,10,3
31,9,0,8,11,3
31,9,1,0,5,5
31,9,2,5,8,3
31,9,3,0,3,3
31,9,4,2,6,4
31,9,5,5,10,5
31,9,6,2,9,7
31,10,0,0,4,4
31,10,1,0,3,3
31,10,2,1,2,1
31,10,3,0,1,1
31,10,4,1,5,4
31,10,5,2,5,3
31,10,6,3,7,4
31,11,0,0,1,1
31,11,1,5,8,3
31,11,3,2,5,3
31,11,4,3,11,8
31,11,5,0,2,2
31,11,6,2,9,7
31,12,0,1,3,2
31,12,1,2,5,3
31,12,2,0,2,2
31,12,3,1,3,2
31,12,4,3,9,6
31,12,6,2,5,3
31,13,0,0,3,3
31,13,1,2,3,1
31,13,2,3,3,0
31,13,3,0,1,1
31,13,4,0,2,2
31,13,5,4,6,2
31,13,6,0,1,1
31,14,0,1,1,0
31,14,1,1,3,2
31,14,2,3,4,1
31,14,3,1,3,2
31,14,4,4,8,4
31,14,5,3,5,2
31,14,6,0,2,2
31,15,0,0,3,3
31,15,1,0,1,1
31,15,2,4,4,0
31,15,3,3,6,3
31,15,4,6,10,4
31,15,5,3,5,2
31,15,6,0,2,2
31,16,1,3,4,1
31,16,2,4,8,4
31,16,3,5,6,1
31,16,4,3,5,2
31,16,5,1,3,2
31,16,6,0,1,1
31,17,0,1,2,1
31,17,1,2,2,0
31,17,2,2,2,0
31,17,3,2,4,2
31,17,4,11,13,2
31,17,5,0,3,3
31,17,6,2,2,0
31,18,0,0,2,2
31,18,1,0,1,1
31,18,2,4,6,2
31,18,3,3,4,1
31,18,4,2,2,0
31,18,6,2,2,0
31,19,0,1,1,0
31,19,1,1,2,1
31,19,2,0,1,1
31,19,3,3,3,0
31,19,4,2,3,1
31,19,6,1,2,1
31,20,0,0,1,1
31,20,1,1,1,0
31,20,2,1,3,2
31,20,4,0,1,1
31,20,5,0,1,1
31,20,6,0,1,1
31,21,3,0,2,2
31,21,6,0,1,1
31,22,0,0,1,1
31,22,1,2,2,0
31,22,2,1,2,1
31,22,4,2,2,0
31,23,0,1,1,0
31,23,2,1,1,0
31,23,3,0,1,1
31,23,4,1,2,1
31,23,5,1,2,1
31,24,1,5,6,1
31,24,2,1,2,1
31,24,3,1,1,0
31,24,5,1,1,0
31,25,2,0,1,1
31,25,5,2,3,1
31,26,0,1,1,0
31,26,1,1,1,0
31,26,4,1,1,0
31,26,5,1,1,0
31,26,6,0,1,1
31,27,0,2,2,0
31,27,5,1,2,1
31,27,6,2,2,0
31,28,0,1,1,0
31,28,2,1,1,0
31,28,4,2,2,0
31,28,5,2,2,0
31,28,6,0,1,1
31,29,0,0,1,1
31,29,1,1,1,0
31,29,5,0,1,1
31,29,6,1,1,0
31,30,0,3,3,0
31,30,1,3,3,0
31,30,2,0,1,1
31,30,3,2,4,2
31,30,4,0,1,1
31,30,6,3,3,0
31,31,0,5,5,0
31,31,1,1,1,0
31,31,5,2,2,0
31,31,6,1,1,0
31,32,0,3,4,1
31,32,1,2,3,1
31,32,2,0,1,1
31,32,4,1,3,2
31,32,5,6,7,1
31,32,6,4,4,0
31,33,0,4,5,1
31,33,2,1,1,0
31,33,3,1,1,0
31,33,5,1,4,3
31,34,3,1,3,2
31,34,4,2,3,1
31,34,6,5,5,0
31,35,0,5,7,2
31,35,1,8,10,2
31,35,2,1,2,1
31,35,3,1,2,1
31,35,4,0,2,2
31,35,5,1,4,3
31,36,0,11,15,4
31,36,1,13,15,2
31,36,2,3,6,3
31,36,3,2,5,3
31,36,4,5,8,3
31,36,5,3,4,1
31,36,6,1,2,1
31,37,0,5,8,3
31,37,1,6,8,2
31,37,2,1,6,5
31,37,3,1,3,2
31,37,4,5,6,1
31,37,5,2,5,3
31,37,6,4,7,3
31,38,0,14,22,8
31,38,1,5,13,8
31,38,2,1,5,4
31,38,3,2,7,5
31,38,4,7,12,5
31,38,5,2,6,4
31,38,6,6,10,4
31,39,0,11,34,23
31,39,1,3,19,16
31,39,2,4,25,21
31,39,3,4,21,17
31,39,4,8,27,19
31,39,5,1,7,6
31,39,6,3,4,1
31,40,0,6,24,18
31,40,1,3,26,23
31,40,2,1,16,15
31,40,3,5,22,17
31,40,4,0,20,20
31,40,5,3,13,10
31,40,6,2,8,6
31,41,0,10,39,29
31,41,1,2,31,29
31,41,2,3,23,20
31,41,3,7,30,23
31,41,4,4,21,17
31,41,5,2,9,7
31,41,6,9,23,14
31,42,0,16,54,38
31,42,1,8,43,35
31,42,2,6,63,57
31,42,3,11,55,44
31,42,4,10,32,22
31,42,5,6,22,16
31,42,6,5,20,15
31,43,0,15,66,51
31,43,1,8,58,50
31,43,2,11,63,52
31,43,3,17,72,55
31,43,4,2,44,42
31,43,5,8,25,17
31,43,6,4,25,21
31,44,0,7,82,75
31,44,1,10,58,48
31,44,2,13,67,54
31,44,3,19,75,56
31,44,4,3,40,37
31,44,5,6,38,32
31,44,6,5,31,26
31,45,0,17,96,79
31,45,1,9,70,61
31,45,2,11,84,73
31,45,3,28,86,58
31,45,4,5,49,44
31,45,5,4,38,34
31,45,6,9,43,34
31,46,0,17,97,80
31,46,1,5,72,67
31,46,2,10,73,63
31,46,3,12,86,74
31,46,4,8,74,66
31,46,5,2,36,34
31,46,6,10,37,27
31,47,0,7,91,84
31,47,1,5,89,84
31,47,2,8,96,88
31,47,3,10,95,85
31,47,4,6,58,52
31,47,5,5,45,40
31,47,6,6,50,44
31,48,0,16,92,76
31,48,1,16,91,75
31,48,2,34,114,80
31,48,3,19,102,83
31,48,4,3,65,62
31,48,5,4,41,37
31,48,6,6,46,40
31,49,0,10,79,69
31,49,1,9,83,74
31,49,2,42,114,72
31,49,3,12,75,63
31,49,4,7,62,55
31,49,5,4,48,44
31,49,6,4,41,37
31,50,0,9,70,61
31,50,1,8,67,59
31,50,2,5,61,56
31,50,3,15,86,71
31,50,4,9,68,59
31,50,5,2,33,31
31,50,6,2,38,36
31,51,0,5,67,62
31,51,1,13,84,71
31,51,2,6,72,66
31,51,3,10,71,61
31,51,4,4,63,59
31,51,5,5,50,45
31,51,6,6,60,54
31,52,0,5,74,69
31,52,1,13,87,74
31,52,2,6,56,50
31,52,3,10,73,63
31,52,4,4,66,62
31,52,5,14,66,52
31,52,6,6,49,43
31,53,0,9,55,46
31,53,1,8,78,70
31,53,2,12,73,61
31,53,3,14,79,65
31,53,4,8,53,45
31,53,5,5,52,47
31,53,6,7,40,33
31,54,0,3,44,41
31,54,1,7,59,52
31,54,2,5,61,56
31,54,3,8,62,54
31,54,4,10,43,33
31,54,5,11,51,40
31,54,6,4,34,30
31,55,0,4,56,52
31,55,1,4,51,47
31,55,2,4,56,52
31,55,3,11,69,58
31,55,4,10,43,33
31,55,5,7,51,44
31,55,6,7,44,37
31,56,0,6,47,41
31,56,1,3,37,34
31,56,2,8,62,54
31,56,3,10,64,54
31,56,4,9,44,35
31,56,5,4,36,32
31,56,6,14,38,24
31,57,0,6,50,44
31,57,1,4,38,34
31,57,2,5,44,39
31,57,3,9,37,28
31,57,4,15,51,36
31,57,5,1,34,33
31,57,6,17,45,28
31,58,0,13,49,36
31,58,1,5,51,46
31,58,2,11,46,35
31,58,3,7,49,42
31,58,4,7,43,36
31,58,5,12,54,42
31,58,6,9,51,42
31,59,0,5,31,26
31,59,1,15,71,56
31,59,2,18,55,37
31,59,3,13,47,34
31,59,4,3,33,30
31,59,5,11,49,38
31,59,6,5,41,36
31,60,0,7,31,24
31,60,1,13,34,21
31,60,2,7,36,29
31,60,3,8,45,37
31,60,4,11,47,36
31,60,5,6,44,38
31,60,6,4,24,20
31,61,0,8,40,32
31,61,1,4,39,35
31,61,2,4,38,34
31,61,3,4,33,29
31,61,4,12,45,33
31,61,5,7,43,36
31,61,6,6,35,29
31,62,0,3,32,29
31,62,1,3,41,38
31,62,2,6,32,26
31,62,3,9,39,30
31,62,4,15,40,25
31,62,5,0,21,21
31,62,6,12,45,33
31,63,0,10,36,26
31,63,1,5,32,27
31,63,2,6,43,37
31,63,3,13,50,37
31,63,4,8,32,24
31,63,5,7,39,32
31,63,6,10,49,39
31,64,0,9,36,27
31,64,1,4,29,25
31,64,2,5,31,26
31,64,3,11,37,26
31,64,4,20,51,31
31,64,5,4,32,28
31,64,6,21,55,34
31,65,0,7,37,30
31,65,1,9,38,29
31,65,2,8,36,28
31,65,3,6,34,28
31,65,4,13,35,22
31,65,5,7,44,37
31,65,6,10,29,19
31,66,0,5,35,30
31,66,1,4,31,27
31,66,2,9,28,19
31,66,3,10,42,32
31,66,4,16,34,18
31,66,5,7,41,34
31,66,6,9,39,30
31,67,0,1,30,29
31,67,1,6,34,28
31,67,2,6,30,24
31,67,3,8,39,31
31,67,4,17,43,26
31,67,5,8,32,24
31,67,6,16,43,27
31,68,0,3,36,33
31,68,1,4,29,25
31,68,2,16,42,26
31,68,3,7,44,37
31,68,4,11,43,32
31,68,5,7,38,31
31,68,6,11,48,37
31,69,0,11,36,25
31,69,1,7,37,30
31,69,2,5,40,35
31,69,3,8,40,32
31,69,4,15,50,35
31,69,5,10,40,30
31,69,6,9,45,36
31,70,0,9,25,16
31,70,1,4,28,24
31,70,2,13,43,30
31,70,3,13,42,29
31,70,4,35,66,31
31,70,5,4,37,33
31,70,6,3,40,37
31,71,0,3,25,22
31,71,1,2,24,22
31,71,2,6,25,19
31,71,3,3,24,21
31,71,4,26,59,33
31,71,5,0,24,24
31,71,6,12,48,36
31,72,0,4,29,25
31,72,1,8,38,30
31,72,2,10,34,24
31,72,3,3,25,22
31,72,4,23,58,35
31,72,5,12,52,40
31,72,6,3,37,34
31,73,0,3,35,32
31,73,1,10,41,31
31,73,2,7,41,34
31,73,3,11,45,34
31,73,4,13,48,35
31,73,5,10,54,44
31,73,6,7,34,27
31,74,0,2,28,26
31,74,1,5,24,19
31,74,2,8,41,33
31,74,3,13,41,28
31,74,4,5,39,34
31,74,5,5,39,34
31,74,6,8,42,34
31,75,0,1,29,28
31,75,1,3,24,21
31,75,2,8,33,25
31,75,3,7,40,33
31,75,4,12,45,33
31,75,5,7,39,32
31,75,6,8,49,41
31,76,0,16,53,37
31,76,1,13,45,32
31,76,2,10,44,34
31,76,3,8,28,20
31,76,4,8,33,25
31,76,5,2,37,35
31,76,6,9,48,39
31,77,0,15,44,29
31,77,1,3,30,27
31,77,2,10,40,30
31,77,3,13,48,35
31,77,4,8,36,28
31,77,5,12,45,33
31,77,6,14,60,46
31,78,0,6,32,26
31,78,1,11,30,19
31,78,2,15,53,38
31,78,3,7,32,25
31,78,4,4,40,36
31,78,5,7,46,39
31,78,6,3,36,33
31,79,0,12,54,42
31,79,1,9,41,32
31,79,2,3,25,22
31,79,3,7,30,23
31,79,4,13,50,37
31,79,5,3,45,42
31,79,6,9,43,34
31,80,0,11,41,30
31,80,1,10,34,24
31,80,2,5,31,26
31,80,3,9,42,33
31,80,4,19,49,30
31,80,5,7,42,35
31,80,6,6,36,30
31,81,0,14,34,20
31,81,1,5,32,27
31,81,2,3,33,30
31,81,3,10,30,20
31,81,4,13,42,29
31,81,5,8,37,29
31,81,6,9,46,37
31,82,0,7,35,28
31,82,1,13,31,18
31,82,2,13,38,25
31,82,3,10,36,26
31,82,4,16,45,29
31,82,5,8,46,38
31,82,6,6,42,36
31,83,0,5,36,31
31,83,1,3,26,23
31,83,2,15,38,23
31,83,3,13,42,29
31,83,4,17,46,29
31,83,5,6,41,35
31,83,6,9,43,34
31,84,0,7,38,31
31,84,1,0,20,20
31,84,2,5,28,23
31,84,3,6,48,42
31,84,4,13,40,27
31,84,5,4,42,38
31,84,6,5,41,36
31,85,0,10,37,27
31,85,1,3,39,36
31,85,2,0,22,22
31,85,3,9,28,19
31,85,4,11,37,26
31,85,5,5,37,32
31,85,6,8,30,22
31,86,0,3,25,22
31,86,1,4,24,20
31,86,2,1,27,26
31,86,3,2,27,25
31,86,4,9,48,39
31,86,5,13,44,31
31,86,6,19,55,36
31,87,0,7,43,36
31,87,1,2,24,22
31,87,2,1,29,28
31,87,3,3,34,31
31,87,4,7,40,33
31,87,5,3,42,39
31,87,6,5,39,34
31,88,0,1,20,19
31,88,1,2,20,18
31,88,2,7,32,25
31,88,3,3,25,22
31,88,4,7,29,22
31,88,5,8,39,31
31,88,6,10,39,29
31,89,0,2,27,25
31,89,1,3,28,25
31,89,2,10,26,16
31,89,3,7,34,27
31,89,4,9,43,34
31,89,5,7,25,18
31,89,6,9,35,26
31,90,0,5,32,27
31,90,1,6,33,27
31,90,2,5,34,29
31,90,3,8,35,27
31,90,4,2,21,19
31,90,5,1,23,22
31,90,6,5,34,29
31,91,0,10,26,16
31,91,1,3,29,26
31,91,2,3,31,28
31,91,3,2,20,18
31,91,4,6,16,10
31,91,5,5,27,22
31,91,6,6,43,37
31,92,0,4,30,26
31,92,1,2,22,20
31,92,2,2,29,27
31,92,3,2,21,19
31,92,4,4,32,28
31,92,5,1,28,27
31,92,6,8,31,23
31,93,0,5,33,28
31,93,1,1,25,24
31,93,2,4,33,29
31,93,3,7,36,29
31,93,4,0,33,33
31,93,5,15,43,28
31,93,6,9,37,28
31,94,0,3,36,33
31,94,1,0,23,23
31,94,2,5,36,31
31,94,3,5,27,22
31,94,4,6,31,25
31,94,5,5,22,17
31,94,6,8,38,30
31,95,0,7,31,24
31,95,1,6,33,27
31,95,2,9,39,30
31,95,3,7,42,35
31,95,4,6,45,39
31,95,5,3,40,37
31,95,6,18,48,30
31,96,0,2,24,22
31,96,1,6,38,32
31,96,2,4,31,27
31,96,3,3,30,27
31,96,4,9,45,36
31,96,5,4,37,33
31,96,6,4,39,35
31,97,0,1,24,23
31,97,1,3,33,30
31,97,2,2,39,37
31,97,3,5,34,29
31,97,4,9,39,30
31,97,5,11,38,27
31,97,6,8,42,34
31,98,0,1,36,35
31,98,1,3,34,31
31,98,2,7,42,35
31,98,3,3,38,35
31,98,4,15,56,41
31,98,5,6,44,38
31,98,6,6,45,39
31,99,0,2,43,41
31,99,1,1,33,32
31,99,2,9,48,39
31,99,3,10,55,45
31,99,4,9,64,55
31,99,5,5,48,43
31,99,6,3,39,36
31,100,0,12,50,38
31,100,1,2,34,32
31,100,2,5,47,42
31,100,3,14,45,31
31,100,4,3,34,31
31,100,5,5,35,30
31,100,6,4,42,38
31,101,0,7,47,40
31,101,1,6,44,38
31,101,2,5,48,43
31,101,3,4,47,43
31,101,4,20,73,53
31,101,5,5,39,34
31,101,6,6,48,42
31,102,0,4,50,46
31,102,1,6,44,38
31,102,2,8,52,44
31,102,3,7,66,59
31,102,4,5,41,36
31,102,5,6,43,37
31,102,6,5,49,44
31,103,0,6,29,23
31,103,1,7,42,35
31,103,2,3,40,37
31,103,3,7,37,30
31,103,4,8,54,46
31,103,5,8,28,20
31,103,6,7,44,37
31,104,0,5,41,36
31,104,1,1,40,39
31,104,2,5,53,48
31,104,3,4,39,35
31,104,4,12,48,36
31,104,5,5,41,36
31,104,6,7,44,37
31,105,0,5,38,33
31,105,1,5,57,52
31,105,2,6,44,38
31,105,3,10,66,56
31,105,4,6,53,47
31,105,5,6,49,43
31,105,6,2,47,45
31,106,0,2,39,37
31,106,1,1,41,40
31,106,2,6,47,41
31,106,3,5,43,38
31,106,4,7,41,34
31,106,5,4,33,29
31,106,6,1,42,41
31,107,0,4,47,43
31,107,1,3,31,28
31,107,2,10,44,34
31,107,3,2,31,29
31,107,4,10,51,41
31,107,5,4,44,40
31,107,6,2,42,40
31,108,0,3,27,24
31,108,1,5,40,35
31,108,2,8,42,34
31,108,3,6,31,25
31,108,4,10,40,30
31,108,5,2,48,46
31,108,6,8,53,45
31,109,0,6,49,43
31,109,1,4,44,40
31,109,2,8,37,29
31,109,3,1,28,27
31,109,4,6,39,33
31,109,5,15,60,45
31,109,6,4,47,43
31,110,0,6,30,24
31,110,1,7,40,33
31,110,2,9,47,38
31,110,3,2,29,27
31,110,4,2,30,28
31,110,5,10,53,43
31,110,6,9,43,34
31,111,0,0,33,33
31,111,1,3,32,29
31,111,2,1,34,33
31,111,3,4,43,39
31,111,4,4,42,38
31,111,5,5,46,41
31,111,6,3,34,31
31,112,0,11,45,34
31,112,1,3,34,31
31,112,2,4,30,26
31,112,3,2,29,27
31,112,4,6,40,34
31,112,5,3,33,30
31,112,6,4,28,24
31,113,0,1,38,37
31,113,1,3,33,30
31,113,2,0,37,37
31,113,3,4,39,35
31,113,4,4,33,29
31,113,5,0,30,30
31,113,6,15,47,32
31,114,0,10,41,31
31,114,1,1,21,20
31,114,2,7,28,21
31,114,3,5,32,27
31,114,4,10,34,24
31,114,5,2,38,36
31,114,6,5,35,30
31,115,0,10,33,23
31,115,1,1,20,19
31,115,2,1,26,25
31,115,3,1,28,27
31,115,4,4,26,22
31,115,5,4,24,20
31,115,6,6,35,29
31,116,0,8,37,29
31,116,1,3,29,26
31,116,2,1,35,34
31,116,3,3,23,20
31,116,4,5,30,25
31,116,5,5,30,25
31,116,6,9,35,26
31,117,0,6,25,19
31,117,1,8,31,23
31,117,2,3,25,22
31,117,3,1,29,28
31,117,4,4,28,24
31,117,5,7,27,20
31,117,6,11,37,26
31,118,0,3,28,25
31,118,1,4,24,20
31,118,2,1,19,18
31,118,3,2,30,28
31,118,4,3,27,24
31,118,5,1,29,28
31,118,6,9,31,22
31,119,0,6,24,18
31,119,1,2,26,24
31,119,2,0,17,17
31,119,3,3,22,19
31,119,4,5,33,28
31,119,5,5,28,23
31,119,6,6,40,34
31,120,0,3,19,16
31,120,1,5,31,26
31,120,2,0,29,29
31,120,3,2,23,21
31,120,4,2,30,28
31,120,5,8,33,25
31,120,6,1,30,29
31,121,0,5,27,22
31,121,1,4,30,26
31,121,2,0,15,15
31,121,3,3,28,25
31,121,4,9,41,32
31,121,5,4,31,27
31,121,6,2,33,31
31,122,0,4,28,24
31,122,1,4,32,28
31,122,2,7,35,28
31,122,3,6,25,19
31,122,4,9,31,22
31,122,5,2,31,29
31,122,6,1,45,44
31,123,0,1,28,27
31,123,1,2,27,25
31,123,2,3,36,33
31,123,3,6,31,25
31,123,4,8,31,23
31,123,5,4,35,31
31,123,6,2,28,26
31,124,0,0,20,20
31,124,1,3,23,20
31,124,2,5,31,26
31,124,3,4,23,19
31,124,4,8,33,25
31,124,5,6,33,27
31,124,6,5,32,27
31,125,0,3,26,23
31,125,1,3,24,21
31,125,2,2,22,20
31,125,3,3,21,18
31,125,4,2,16,14
31,125,5,9,33,24
31,125,6,8,35,27
31,126,0,5,28,23
31,126,1,4,24,20
31,126,2,2,26,24
31,126,3,0,18,18
31,126,4,9,32,23
31,126,5,2,28,26
31,126,6,3,28,25
31,127,0,2,30,28
31,127,1,1,17,16
31,127,2,0,16,16
31,127,3,4,24,20
31,127,4,2,22,20
31,127,5,0,24,24
31,127,6,3,27,24
31,128,0,3,14,11
31,128,1,3,19,16
31,128,2,2,21,19
31,128,3,1,17,16
31,128,4,3,24,21
31,128,5,2,20,18
31,128,6,3,23,20
31,129,0,0,14,14
31,129,1,5,20,15
31,129,2,1,14,13
31,129,3,4,17,13
31,129,4,6,24,18
31,129,5,3,25,22
31,129,6,4,17,13
31,130,0,2,22,20
31,130,1,1,19,18
31,130,2,1,15,14
31,130,3,3,25,22
31,130,4,7,26,19
31,130,5,2,15,13
31,130,6,5,23,18
31,131,0,7,26,19
31,131,1,2,20,18
31,131,2,0,18,18
31,131,3,4,25,21
31,131,4,1,21,20
31,131,5,6,26,20
31,131,6,7,26,19
31,132,0,3,20,17
31,132,1,7,28,21
31,132,2,1,29,28
31,132,3,4,27,23
31,132,4,4,24,20
31,132,5,1,14,13
31,132,6,4,27,23
31,133,0,7,25,18
31,133,1,3,22,19
31,133,2,2,15,13
31,133,3,2,28,26
31,133,4,0,15,15
31,133,5,3,16,13
31,133,6,2,19,17
31,134,0,4,20,16
31,134,1,3,18,15
31,134,2,1,21,20
31,134,3,4,16,12
31,134,4,0,14,14
31,134,5,5,19,14
31,134,6,3,21,18
31,135,0,0,10,10
31,135,1,2,19,17
31,135,2,1,20,19
31,135,3,5,14,9
31,135,4,2,20,18
31,135,5,2,19,17
31,135,6,1,15,14
31,136,0,5,22,17
31,136,1,3,15,12
31,136,2,1,12,11
31,136,3,0,13,13
31,136,4,2,23,21
31,136,5,2,25,23
31,136,6,3,19,16
31,137,0,2,13,11
31,137,1,1,15,14
31,137,2,1,17,16
31,137,3,1,12,11
31,137,4,4,19,15
31,137,5,0,13,13
31,137,6,6,20,14
31,138,0,3,16,13
31,138,1,3,14,11
31,138,2,3,20,17
31,138,3,2,14,12
31,138,4,2,11,9
31,138,5,1,29,28
31,138,6,3,15,12
31,139,0,2,11,9
31,139,1,1,13,12
31,139,2,4,12,8
31,139,3,3,10,7
31,139,4,0,11,11
31,139,5,3,12,9
31,139,6,8,16,8
31,140,0,3,13,10
31,140,1,5,18,13
31,140,2,2,11,9
31,140,3,0,7,7
31,140,4,1,10,9
31,140,5,3,19,16
31,140,6,3,11,8
31,141,0,1,10,9
31,141,1,3,16,13
31,141,2,4,7,3
31,141,3,5,17,12
31,141,4,5,25,20
31,141,5,2,18,16
31,141,6,2,9,7
31,142,0,0,15,15
31,142,1,3,13,10
31,142,2,1,9,8
31,142,3,4,13,9
31,142,4,3,16,13
31,142,5,3,12,9
31,142,6,2,10,8
31,143,0,3,8,5
31,143,1,3,16,13
31,143,2,1,10,9
31,143,3,6,14,8
31,143,4,0,11,11
31,143,5,2,16,14
31,143,6,7,16,9
32,0,0,1,3,2
32,0,1,1,3,2
32,0,3,1,4,3
32,0,4,4,4,0
32,0,5,0,2,2
32,0,6,0,3,3
32,1,1,2,3,1
32,1,2,1,3,2
32,1,4,1,3,2
32,1,5,2,4,2
32,1,6,3,7,4
32,2,0,2,5,3
32,2,1,0,1,1
32,2,3,1,1,0
32,2,4,3,6,3
32,2,5,3,5,2
32,2,6,1,3,2
32,3,0,0,1,1
32,3,1,2,3,1
32,3,2,0,3,3
32,3,3,3,5,2
32,3,4,1,2,1
32,3,5,2,2,0
32,3,6,0,1,1
32,4,0,2,3,1
32,4,2,1,1,0
32,4,3,0,1,1
32,4,4,0,2,2
32,4,5,0,1,1
32,4,6,6,9,3
32,5,1,3,5,2
32,5,2,0,1,1
32,5,3,0,3,3
32,5,4,3,5,2
32,5,5,3,5,2
32,5,6,0,1,1
32,6,0,0,3,3
32,6,1,1,2,1
32,6,2,3,3,0
32,6,3,0,1,1
32,6,4,0,1,1
32,6,5,1,1,0
32,6,6,0,1,1
32,7,0,0,1,1
32,7,1,2,2,0
32,7,2,2,4,2
32,7,4,0,2,2
32,7,5,0,1,1
32,8,1,0,1,1
32,8,4,2,2,0
32,9,3,3,4,1
32,9,4,1,4,3
32,9,5,2,3,1
32,9,6,1,2,1
32,10,0,2,4,2
32,10,1,1,1,0
32,10,2,0,2,2
32,10,3,1,1,0
32,10,4,0,2,2
32,10,6,0,1,1
32,11,1,1,1,0
32,11,2,0,2,2
32,11,3,1,1,0
32,11,4,1,2,1
32,11,5,1,1,0
32,11,6,1,2,1
32,12,0,0,1,1
32,12,2,1,1,0
32,12,3,1,1,0
32,12,4,0,1,1
32,12,5,1,1,0
32,13,1,0,1,1
32,13,4,0,1,1
32,13,6,0,1,1
32,14,0,2,2,0
32,14,2,2,2,0
32,15,0,3,4,1
32,15,2,3,3,0
32,16,1,2,2,0
32,16,2,1,2,1
32,16,4,0,1,1
32,17,1,2,2,0
32,17,2,0,1,1
32,17,4,3,3,0
32,17,6,1,2,1
32,18,0,1,1,0
32,18,1,1,1,0
32,18,4,0,1,1
32,18,5,1,2,1
32,19,0,2,3,1
32,19,1,0,1,1
32,19,2,1,2,1
32,19,4,1,1,0
32,20,0,2,3,1
32,20,1,2,2,0
32,21,2,0,1,1
32,21,3,0,1,1
32,22,3,1,1,0
32,23,2,1,1,0
32,23,4,1,1,0
32,23,5,1,2,1
32,24,0,2,2,0
32,24,4,0,1,1
32,24,6,0,1,1
32,25,0,2,2,0
32,25,2,1,1,0
32,25,6,1,2,1
32,26,6,1,1,0
32,27,3,1,1,0
32,29,5,1,1,0
32,30,2,1,1,0
32,31,0,1,1,0
32,33,1,1,1,0
32,33,4,2,2,0
32,34,0,0,2,2
32,34,4,2,2,0
32,34,6,0,1,1
32,35,0,1,1,0
32,35,2,0,1,1
32,36,0,3,3,0
32,36,2,0,2,2
32,37,0,0,1,1
32,37,3,1,1,0
32,38,2,1,1,0
32,38,3,1,2,1
32,38,4,0,1,1
32,39,0,1,2,1
32,39,1,2,4,2
32,39,2,0,1,1
32,39,3,1,2,1
32,39,5,0,1,1
32,39,6,1,1,0
32,40,0,0,3,3
32,40,1,3,4,1
32,40,2,0,5,5
32,40,3,2,2,0
32,40,4,1,5,4
32,40,5,1,2,1
32,40,6,4,4,0
32,41,0,0,2,2
32,41,1,1,3,2
32,41,2,1,5,4
32,41,3,0,5,5
32,41,4,2,6,4
32,41,5,1,7,6
32,41,6,0,1,1
32,42,0,5,8,3
32,42,1,1,4,3
32,42,2,1,3,2
32,42,3,0,4,4
32,42,4,0,1,1
32,42,5,4,7,3
32,42,6,0,2,2
32,43,0,4,6,2
32,43,1,2,6,4
32,43,2,0,4,4
32,43,3,0,7,7
32,43,4,2,8,6
32,43,5,0,3,3
32,43,6,0,2,2
32,44,0,3,8,5
32,44,1,1,8,7
32,44,2,1,6,5
32,44,3,3,12,9
32,44,4,0,6,6
32,44,5,1,4,3
32,44,6,2,6,4
32,45,0,0,12,12
32,45,1,0,10,10
32,45,2,0,6,6
32,45,3,2,9,7
32,45,4,5,14,9
32,45,5,5,9,4
32,45,6,1,8,7
32,46,0,3,22,19
32,46,1,3,14,11
32,46,2,1,10,9
32,46,3,1,15,14
32,46,4,3,15,12
32,46,5,0,9,9
32,46,6,0,1,1
32,47,0,1,13,12
32,47,1,3,10,7
32,47,2,0,18,18
32,47,3,2,10,8
32,47,4,0,7,7
32,47,5,0,8,8
32,47,6,0,6,6
32,48,0,1,18,17
32,48,1,7,21,14
32,48,2,4,18,14
32,48,3,5,17,12
32,48,4,0,17,17
32,48,5,3,12,9
32,48,6,2,8,6
32,49,0,2,16,14
32,49,1,2,14,12
32,49,2,3,14,11
32,49,3,4,19,15
32,49,4,1,10,9
32,49,5,1,15,14
32,49,6,3,12,9
32,50,0,1,12,11
32,50,1,1,10,9
32,50,2,1,9,8
32,50,3,4,18,14
32,50,4,4,16,12
32,50,5,2,9,7
32,50,6,2,12,10
32,51,0,2,14,12
32,51,1,6,16,10
32,51,2,2,15,13
32,51,3,4,10,6
32,51,4,0,5,5
32,51,5,5,18,13
32,51,6,2,12,10
32,52,0,2,6,4
32,52,1,2,9,7
32,52,2,3,10,7
32,52,3,2,6,4
32,52,4,1,8,7
32,52,5,0,7,7
32,52,6,0,3,3
32,53,0,0,2,2
32,53,1,0,7,7
32,53,2,1,8,7
32,53,3,0,8,8
32,53,4,2,5,3
32,53,5,0,7,7
32,53,6,2,3,1
32,54,0,0,9,9
32,54,1,0,11,11
32,54,2,1,7,6
32,54,3,0,4,4
32,54,4,5,11,6
32,54,5,0,3,3
32,54,6,1,8,7
32,55,0,0,4,4
32,55,1,1,7,6
32,55,2,1,5,4
32,55,3,4,11,7
32,55,4,3,6,3
32,55,5,1,7,6
32,55,6,0,2,2
32,56,0,1,9,8
32,56,1,1,8,7
32,56,2,4,11,7
32,56,3,4,10,6
32,56,4,0,6,6
32,56,5,3,10,7
32,56,6,2,6,4
32,57,0,2,5,3
32,57,1,5,13,8
32,57,2,3,9,6
32,57,3,0,4,4
32,57,4,0,2,2
32,57,5,2,6,4
32,57,6,5,7,2
32,58,0,5,14,9
32,58,1,7,11,4
32,58,2,2,6,4
32,58,3,3,6,3
32,58,4,0,1,1
32,58,5,5,10,5
32,58,6,0,12,12
32,59,0,3,7,4
32,59,1,1,6,5
32,59,2,2,7,5
32,59,3,0,3,3
32,59,4,0,4,4
32,59,5,1,8,7
32,59,6,1,6,5
32,60,0,2,2,0
32,60,1,1,5,4
32,60,2,1,2,1
32,60,3,4,7,3
32,60,4,1,5,4
32,60,5,1,7,6
32,60,6,1,5,4
32,61,0,0,2,2
32,61,1,3,11,8
32,61,2,1,4,3
32,61,3,8,12,4
32,61,4,6,11,5
32,61,5,0,6,6
32,61,6,1,8,7
32,62,0,0,3,3
32,62,1,2,8,6
32,62,2,2,6,4
32,62,3,1,5,4
32,62,4,5,10,5
32,62,5,2,6,4
32,62,6,3,6,3
32,63,0,2,4,2
32,63,1,1,1,0
32,63,2,4,10,6
32,63,3,0,3,3
32,63,4,2,7,5
32,63,5,4,8,4
32,63,6,4,10,6
32,64,0,0,2,2
32,64,1,3,6,3
32,64,2,3,7,4
32,64,3,2,7,5
32,64,4,4,7,3
32,64,5,4,11,7
32,64,6,1,6,5
32,65,0,2,6,4
32,65,1,1,4,3
32,65,2,4,8,4
32,65,3,0,2,2
32,65,4,0,7,7
32,65,5,2,6,4
32,65,6,1,7,6
32,66,0,4,10,6
32,66,1,0,2,2
32,66,2,1,5,4
32,66,3,0,5,5
32,66,4,3,9,6
32,66,5,0,6,6
32,66,6,4,12,8
32,67,0,6,9,3
32,67,1,0,5,5
32,67,2,2,8,6
32,67,3,1,4,3
32,67,4,5,9,4
32,67,5,0,5,5
32,67,6,4,10,6
32,68,0,5,12,7
32,68,1,2,8,6
32,68,2,2,7,5
32,68,3,1,6,5
32,68,4,0,3,3
32,68,5,1,5,4
32,68,6,13,25,12
32,69,0,0,2,2
32,69,1,0,5,5
32,69,2,14,20,6
32,69,3,1,7,6
32,69,4,0,2,2
32,69,5,0,4,4
32,69,6,4,13,9
32,70,0,0,4,4
32,70,1,1,5,4
32,70,2,4,7,3
32,70,3,3,5,2
32,70,4,4,12,8
32,70,5,2,10,8
32,70,6,1,11,10
32,71,0,2,6,4
32,71,1,0,4,4
32,71,2,4,5,1
32,71,3,0,3,3
32,71,4,3,9,6
32,71,5,0,3,3
32,71,6,12,22,10
32,72,0,0,5,5
32,72,1,4,12,8
32,72,2,0,5,5
32,72,3,8,16,8
32,72,4,1,4,3
32,72,5,5,13,8
32,72,6,1,8,7
32,73,0,3,11,8
32,73,1,6,9,3
32,73,2,1,6,5
32,73,3,4,11,7
32,73,4,3,10,7
32,73,5,3,7,4
32,73,6,6,20,14
32,74,0,1,6,5
32,74,1,6,12,6
32,74,2,0,6,6
32,74,3,5,17,12
32,74,4,4,13,9
32,74,5,2,9,7
32,74,6,4,10,6
32,75,0,13,18,5
32,75,1,5,16,11
32,75,2,1,7,6
32,75,3,5,11,6
32,75,4,1,6,5
32,75,5,8,19,11
32,75,6,12,24,12
32,76,0,11,15,4
32,76,1,2,7,5
32,76,2,0,4,4
32,76,3,2,8,6
32,76,4,0,11,11
32,76,5,11,21,10
32,76,6,11,21,10
32,77,0,3,8,5
32,77,1,3,9,6
32,77,2,1,4,3
32,77,3,0,8,8
32,77,4,1,5,4
32,77,5,1,9,8
32,77,6,2,9,7
32,78,0,9,12,3
32,78,1,1,13,12
32,78,2,8,14,6
32,78,3,4,10,6
32,78,4,3,11,8
32,78,5,2,5,3
32,78,6,2,10,8
32,79,0,9,17,8
32,79,1,2,9,7
32,79,2,3,9,6
32,79,3,1,4,3
32,79,4,0,3,3
32,79,5,3,12,9
32,79,6,0,7,7
32,80,0,2,7,5
32,80,1,2,5,3
32,80,2,4,11,7
32,80,3,1,6,5
32,80,4,1,3,2
32,80,5,1,5,4
32,80,6,1,4,3
32,81,0,9,15,6
32,81,1,0,10,10
32,81,2,3,7,4
32,81,3,7,12,5
32,81,4,3,7,4
32,81,5,3,8,5
32,81,6,4,12,8
32,82,0,2,6,4
32,82,1,4,9,5
32,82,2,2,10,8
32,82,3,0,4,4
32,82,4,0,8,8
32,82,5,6,10,4
32,82,6,3,13,10
32,83,0,3,5,2
32,83,1,5,10,5
32,83,2,0,6,6
32,83,3,3,10,7
32,83,4,2,10,8
32,83,5,3,7,4
32,83,6,1,6,5
32,84,0,4,11,7
32,84,1,2,6,4
32,84,2,3,3,0
32,84,3,3,7,4
32,84,4,6,13,7
32,84,5,0,5,5
32,84,6,5,19,14
32,85,0,0,3,3
32,85,1,0,4,4
32,85,2,3,12,9
32,85,3,1,6,5
32,85,4,6,14,8
32,85,5,2,7,5
32,85,6,0,8,8
32,86,0,3,8,5
32,86,2,2,11,9
32,86,3,3,9,6
32,86,4,1,4,3
32,86,5,13,15,2
32,86,6,1,10,9
32,87,0,1,3,2
32,87,1,1,4,3
32,87,2,0,5,5
32,87,3,0,6,6
32,87,4,2,6,4
32,87,5,8,12,4
32,87,6,0,3,3
32,88,0,3,6,3
32,88,1,1,4,3
32,88,2,0,2,2
32,88,3,3,6,3
32,88,4,1,3,2
32,88,5,2,9,7
32,88,6,1,6,5
32,89,0,2,5,3
32,89,1,2,6,4
32,89,2,3,8,5
32,89,3,2,4,2
32,89,4,4,14,10
32,89,5,2,6,4
32,89,6,1,5,4
32,90,0,2,3,1
32,90,1,2,6,4
32,90,2,4,10,6
32,90,3,1,7,6
32,90,4,2,9,7
32,90,5,2,6,4
32,90,6,0,2,2
32,91,0,3,10,7
32,91,1,1,7,6
32,91,2,1,7,6
32,91,3,1,5,4
32,91,4,6,11,5
32,91,5,0,7,7
32,91,6,2,9,7
32,92,0,5,9,4
32,92,1,0,7,7
32,92,2,1,7,6
32,92,3,1,5,4
32,92,4,2,8,6
32,92,5,1,7,6
32,92,6,0,5,5
32,93,0,2,9,7
32,93,1,1,3,2
32,93,2,1,6,5
32,93,3,0,7,7
32,93,4,3,7,4
32,93,5,0,6,6
32,93,6,6,9,3
32,94,0,0,5,5
32,94,1,0,5,5
32,94,2,0,8,8
32,94,3,2,10,8
32,94,4,0,6,6
32,94,5,0,2,2
32,94,6,2,8,6
32,95,0,4,10,6
32,95,1,1,8,7
32,95,2,5,16,11
32,95,3,1,5,4
32,95,4,0,6,6
32,95,5,1,6,5
32,95,6,4,11,7
32,96,0,2,10,8
32,96,1,1,14,13
32,96,2,2,12,10
32,96,3,4,12,8
32,96,4,3,12,9
32,96,5,3,10,7
32,96,6,7,16,9
32,97,0,0,11,11
32,97,1,2,23,21
32,97,2,1,8,7
32,97,3,6,16,10
32,97,4,1,10,9
32,97,5,3,8,5
32,97,6,4,10,6
32,98,0,1,12,11
32,98,1,0,6,6
32,98,2,8,23,15
32,98,3,3,15,12
32,98,4,0,10,10
32,98,5,0,5,5
32,98,6,7,18,11
32,99,0,4,13,9
32,99,1,0,15,15
32,99,2,6,23,17
32,99,3,1,15,14
32,99,4,1,6,5
32,99,5,3,12,9
32,99,6,6,15,9
32,100,0,1,9,8
32,100,1,1,5,4
32,100,2,2,17,15
32,100,3,0,12,12
32,100,4,1,11,10
32,100,5,7,14,7
32,100,6,4,12,8
32,101,0,4,15,11
32,101,1,0,8,8
32,101,2,2,14,12
32,101,3,1,16,15
32,101,4,0,14,14
32,101,5,1,6,5
32,101,6,1,17,16
32,102,0,1,9,8
32,102,1,0,14,14
32,102,2,2,14,12
32,102,3,4,11,7
32,102,4,1,10,9
32,102,5,3,14,11
32,102,6,1,19,18
32,103,0,0,14,14
32,103,1,0,5,5
32,103,2,1,17,16
32,103,3,2,15,13
32,103,4,10,19,9
32,103,5,1,11,10
32,103,6,3,15,12
32,104,0,2,16,14
32,104,1,0,6,6
32,104,2,1,13,12
32,104,3,3,14,11
32,104,4,1,14,13
32,104,5,2,11,9
32,104,6,3,8,5
32,105,0,0,8,8
32,105,1,5,15,10
32,105,2,0,8,8
32,105,3,0,14,14
32,105,4,0,10,10
32,105,5,1,13,12
32,105,6,0,15,15
32,106,0,1,8,7
32,106,1,2,15,13
32,106,2,2,16,14
32,106,3,0,12,12
32,106,4,1,7,6
32,106,5,6,17,11
32,106,6,0,13,13
32,107,0,2,15,13
32,107,1,3,14,11
32,107,2,2,13,11
32,107,3,5,18,13
32,107,4,5,11,6
32,107,5,9,19,10
32,107,6,4,12,8
32,108,0,1,10,9
32,108,1,1,9,8
32,108,2,0,11,11
32,108,3,6,15,9
32,108,4,3,9,6
32,108,5,1,13,12
32,108,6,12,24,12
32,109,0,6,13,7
32,109,1,0,4,4
32,109,2,1,7,6
32,109,3,5,18,13
32,109,4,2,13,11
32,109,5,2,14,12
32,109,6,4,18,14
32,110,0,0,8,8
32,110,1,0,6,6
32,110,2,0,8,8
32,110,3,2,14,12
32,110,4,0,12,12
32,110,5,4,14,10
32,110,6,9,16,7
32,111,0,4,13,9
32,111,1,0,8,8
32,111,2,1,14,13
32,111,3,1,13,12
32,111,4,1,9,8
32,111,5,1,5,4
32,111,6,2,8,6
32,112,0,2,8,6
32,112,1,1,6,5
32,112,2,4,15,11
32,112,3,4,15,11
32,112,4,0,8,8
32,112,5,1,8,7
32,112,6,0,2,2
32,113,0,6,16,10
32,113,1,0,7,7
32,113,2,6,11,5
32,113,3,1,11,10
32,113,4,2,9,7
32,113,5,0,6,6
32,113,6,1,11,10
32,114,0,3,11,8
32,114,1,3,9,6
32,114,2,4,13,9
32,114,3,4,14,10
32,114,4,2,9,7
32,114,5,2,10,8
32,114,6,4,14,10
32,115,0,1,11,10
32,115,1,0,9,9
32,115,2,3,14,11
32,115,3,2,9,7
32,115,4,4,11,7
32,115,5,1,12,11
32,115,6,1,8,7
32,116,0,0,6,6
32,116,1,2,4,2
32,116,2,6,14,8
32,116,3,3,8,5
32,116,4,5,12,7
32,116,5,2,10,8
32,116,6,1,10,9
32,117,0,5,15,10
32,117,1,1,6,5
32,117,2,2,5,3
32,117,3,4,13,9
32,117,4,3,12,9
32,117,5,3,15,12
32,117,6,4,10,6
32,118,0,2,6,4
32,118,1,7,15,8
32,118,2,4,12,8
32,118,3,3,14,11
32,118,4,7,15,8
32,118,5,5,14,9
32,118,6,4,10,6
32,119,0,11,18,7
32,119,1,7,12,5
32,119,2,3,16,13
32,119,3,0,6,6
32,119,4,2,8,6
32,119,5,1,7,6
32,119,6,4,15,11
32,120,0,2,13,11
32,120,1,0,6,6
32,120,2,0,5,5
32,120,3,0,10,10
32,120,4,2,11,9
32,120,5,2,12,10
32,120,6,3,7,4
32,121,0,9,15,6
32,121,1,2,7,5
32,121,2,0,3,3
32,121,3,3,9,6
32,121,4,0,11,11
32,121,5,1,6,5
32,121,6,6,11,5
32,122,0,3,6,3
32,122,1,2,8,6
32,122,2,0,10,10
32,122,3,2,7,5
32,122,4,1,8,7
32,122,5,4,11,7
32,122,6,5,10,5
32,123,0,2,8,6
32,123,1,0,6,6
32,123,2,9,14,5
32,123,3,3,10,7
32,123,4,0,8,8
32,123,5,0,6,6
32,123,6,4,15,11
32,124,0,0,5,5
32,124,1,0,4,4
32,124,2,9,13,4
32,124,3,1,14,13
32,124,4,0,4,4
32,124,5,0,9,9
32,124,6,8,17,9
32,125,0,3,9,6
32,125,1,3,7,4
32,125,2,0,4,4
32,125,3,1,7,6
32,125,4,0,5,5
32,125,5,4,10,6
32,125,6,5,11,6
32,126,0,0,6,6
32,126,1,0,3,3
32,126,2,3,8,5
32,126,3,3,7,4
32,126,4,3,16,13
32,126,5,0,3,3
32,126,6,3,10,7
32,127,0,0,10,10
32,127,1,0,4,4
32,127,2,2,10,8
32,127,3,2,10,8
32,127,4,3,10,7
32,127,5,0,7,7
32,127,6,7,17,10
32,128,0,2,6,4
32,128,1,0,5,5
32,128,2,4,9,5
32,128,3,7,16,9
32,128,4,0,6,6
32,128,5,2,8,6
32,128,6,2,11,9
32,129,0,3,11,8
32,129,1,2,9,7
32,129,2,0,7,7
32,129,3,4,8,4
32,129,4,2,5,3
32,129,5,2,9,7
32,129,6,1,4,3
32,130,0,1,7,6
32,130,1,0,4,4
32,130,2,2,10,8
32,130,3,0,9,9
32,130,4,3,9,6
32,130,5,0,6,6
32,130,6,0,7,7
32,131,0,1,8,7
32,131,2,1,8,7
32,131,3,1,4,3
32,131,4,0,8,8
32,131,5,5,12,7
32,131,6,1,7,6
32,132,0,6,8,2
32,132,1,1,4,3
32,132,2,1,3,2
32,132,3,3,9,6
32,132,4,3,11,8
32,132,5,2,7,5
32,132,6,0,5,5
32,133,1,2,3,1
32,133,2,0,3,3
32,133,3,3,10,7
32,133,4,1,4,3
32,133,5,0,6,6
32,133,6,0,2,2
32,134,0,1,3,2
32,134,1,4,8,4
32,134,2,0,3,3
32,134,3,1,7,6
32,134,4,0,4,4
32,134,5,1,6,5
32,134,6,1,4,3
32,135,1,3,7,4
32,135,2,1,6,5
32,135,3,2,7,5
32,135,4,0,6,6
32,135,5,1,9,8
32,135,6,3,6,3
32,136,0,0,2,2
32,136,1,3,7,4
32,136,2,1,7,6
32,136,3,3,4,1
32,136,4,2,5,3
32,136,5,0,2,2
32,136,6,8,10,2
32,137,0,2,3,1
32,137,1,0,4,4
32,137,2,0,6,6
32,137,3,7,8,1
32,137,4,1,8,7
32,137,5,1,9,8
32,137,6,1,8,7
32,138,0,0,2,2
32,138,1,3,9,6
32,138,3,7,10,3
32,138,4,0,1,1
32,138,5,2,6,4
32,138,6,2,5,3
32,139,0,0,1,1
32,139,1,1,5,4
32,139,3,3,5,2
32,139,4,2,2,0
32,139,5,2,5,3
32,139,6,3,5,2
32,140,0,1,4,3
32,140,1,0,6,6
32,140,2,1,4,3
32,140,3,0,1,1
32,140,4,1,2,1
32,140,5,1,3,2
32,140,6,1,4,3
32,141,0,1,3,2
32,141,1,0,2,2
32,141,2,1,4,3
32,141,3,0,3,3
32,141,4,1,3,2
32,141,5,0,1,1
32,141,6,3,6,3
32,142,0,4,8,4
32,142,1,0,1,1
32,142,2,2,4,2
32,142,3,1,3,2
32,142,4,3,5,2
32,142,5,1,4,3
32,142,6,1,2,1
32,143,0,3,4,1
32,143,1,2,3,1
32,143,2,0,3,3
32,143,3,1,2,1
32,143,4,1,4,3
32,143,5,0,3,3
32,143,6,0,1,1
33,0,0,9,16,7
33,0,1,3,10,7
33,0,2,1,3,2
33,0,3,1,6,5
33,0,4,0,5,5
33,0,5,1,11,10
33,0,6,0,11,11
33,1,0,5,15,10
33,1,1,4,8,4
33,1,2,0,6,6
33,1,3,4,8,4
33,1,4,0,8,8
33,1,5,0,10,10
33,1,6,2,12,10
33,2,0,1,10,9
33,2,1,5,12,7
33,2,2,2,13,11
33,2,3,0,5,5
33,2,4,2,10,8
33,2,5,0,4,4
33,2,6,6,12,6
33,3,0,6,9,3
33,3,1,8,13,5
33,3,2,0,3,3
33,3,3,4,10,6
33,3,4,2,10,8
33,3,5,2,12,10
33,3,6,3,12,9
33,4,0,3,12,9
33,4,1,0,6,6
33,4,2,0,7,7
33,4,3,1,6,5
33,4,4,3,11,8
33,4,5,1,5,4
33,4,6,2,8,6
33,5,0,2,4,2
33,5,1,0,3,3
33,5,2,0,3,3
33,5,3,2,2,0
33,5,4,0,12,12
33,5,5,4,8,4
33,5,6,1,4,3
33,6,0,0,3,3
33,6,1,0,2,2
33,6,2,1,2,1
33,6,3,0,5,5
33,6,4,4,8,4
33,6,5,5,12,7
33,6,6,1,5,4
33,7,0,1,4,3
33,7,1,1,2,1
33,7,2,0,2,2
33,7,3,5,8,3
33,7,4,1,6,5
33,7,5,0,6,6
33,7,6,4,8,4
33,8,0,0,3,3
33,8,1,0,1,1
33,8,4,2,6,4
33,8,5,2,4,2
33,8,6,2,6,4
33,9,0,2,5,3
33,9,1,10,12,2
33,9,2,0,1,1
33,9,3,1,1,0
33,9,4,1,6,5
33,9,5,8,10,2
33,9,6,5,7,2
33,10,1,1,2,1
33,10,2,1,1,0
33,10,3,3,4,1
33,10,4,1,4,3
33,10,5,1,6,5
33,10,6,2,6,4
33,11,0,1,3,2
33,11,1,0,1,1
33,11,3,4,8,4
33,11,4,2,5,3
33,11,5,0,2,2
33,11,6,1,4,3
33,12,1,1,2,1
33,12,2,2,4,2
33,12,3,0,2,2
33,12,4,2,7,5
33,12,5,0,1,1
33,12,6,0,4,4
33,13,1,0,2,2
33,13,2,1,4,3
33,13,3,1,3,2
33,13,5,1,3,2
33,13,6,0,2,2
33,14,0,3,4,1
33,14,1,0,3,3
33,14,4,1,4,3
33,14,5,0,1,1
33,14,6,0,2,2
33,15,1,3,6,3
33,15,3,1,1,0
33,15,6,0,1,1
33,16,0,1,1,0
33,16,2,1,1,0
33,16,3,0,1,1
33,16,4,1,1,0
33,16,5,0,1,1
33,16,6,1,1,0
33,17,0,0,1,1
33,17,1,5,5,0
33,17,2,3,3,0
33,17,3,1,2,1
33,17,4,1,1,0
33,18,1,1,2,1
33,18,2,1,3,2
33,18,3,0,1,1
33,18,4,3,5,2
33,18,5,3,4,1
33,18,6,4,4,0
33,19,1,1,1,0
33,19,2,1,1,0
33,19,5,1,1,0
33,19,6,4,7,3
33,20,2,2,3,1
33,20,4,0,1,1
33,20,6,5,6,1
33,21,2,1,3,2
33,21,3,0,1,1
33,21,4,4,4,0
33,21,5,2,3,1
33,21,6,0,1,1
33,22,0,0,2,2
33,22,1,1,2,1
33,22,2,0,1,1
33,22,4,3,3,0
33,22,5,7,7,0
33,23,0,1,2,1
33,23,1,1,2,1
33,23,2,1,1,0
33,23,5,4,5,1
33,24,0,0,1,1
33,24,1,1,1,0
33,24,2,2,2,0
33,24,4,1,2,1
33,24,5,2,2,0
33,24,6,2,2,0
33,25,0,1,1,0
33,25,1,2,3,1
33,25,2,0,1,1
33,25,4,1,1,0
33,25,5,1,2,1
33,26,2,1,1,0
33,26,4,3,4,1
33,26,5,1,3,2
33,26,6,1,2,1
33,27,0,0,1,1
33,27,2,1,1,0
33,27,3,1,1,0
33,27,4,2,3,1
33,27,5,2,2,0
33,27,6,0,2,2
33,28,3,1,1,0
33,28,4,0,2,2
33,28,5,3,4,1
33,29,1,1,1,0
33,29,4,0,1,1
33,30,4,2,2,0
33,30,6,0,1,1
33,31,2,1,1,0
33,31,4,5,5,0
33,31,6,0,1,1
33,32,0,0,1,1
33,32,2,0,1,1
33,32,3,1,1,0
33,32,4,2,4,2
33,32,5,0,1,1
33,33,0,1,1,0
33,33,1,1,4,3
33,33,2,0,1,1
33,33,3,2,2,0
33,33,4,4,4,0
33,33,6,1,1,0
33,34,2,1,2,1
33,34,3,1,1,0
33,34,6,0,1,1
33,35,1,2,3,1
33,35,2,6,7,1
33,35,3,3,3,0
33,35,4,0,1,1
33,35,5,0,1,1
33,35,6,2,2,0
33,36,1,3,4,1
33,36,2,2,3,1
33,36,3,1,2,1
33,36,4,2,2,0
33,36,6,0,1,1
33,37,1,1,3,2
33,37,2,0,2,2
33,37,3,1,1,0
33,37,4,1,3,2
33,37,5,0,2,2
33,38,0,0,4,4
33,38,1,1,5,4
33,38,2,0,3,3
33,38,3,1,6,5
33,38,4,2,3,1
33,38,6,0,3,3
33,39,0,0,11,11
33,39,1,1,8,7
33,39,2,3,11,8
33,39,3,0,8,8
33,39,4,0,10,10
33,39,5,0,4,4
33,39,6,1,2,1
33,40,0,1,14,13
33,40,1,0,9,9
33,40,2,2,18,16
33,40,3,0,10,10
33,40,4,0,8,8
33,40,5,1,6,5
33,40,6,1,3,2
33,41,0,3,26,23
33,41,1,0,16,16
33,41,2,0,15,15
33,41,3,0,13,13
33,41,4,1,9,8
33,41,5,3,16,13
33,41,6,0,7,7
33,42,0,0,19,19
33,42,1,0,26,26
33,42,2,1,20,19
33,42,3,3,28,25
33,42,4,1,21,20
33,42,5,1,7,6
33,42,6,2,11,9
33,43,0,4,35,31
33,43,1,0,16,16
33,43,2,1,15,14
33,43,3,0,19,19
33,43,4,0,20,20
33,43,5,3,19,16
33,43,6,2,10,8
33,44,0,1,37,36
33,44,1,0,25,25
33,44,2,1,27,26
33,44,3,1,27,26
33,44,4,2,32,30
33,44,5,1,17,16
33,44,6,1,11,10
33,45,0,0,30,30
33,45,1,0,25,25
33,45,2,0,18,18
33,45,3,0,18,18
33,45,4,6,31,25
33,45,5,2,19,17
33,45,6,2,22,20
33,46,0,0,22,22
33,46,1,2,26,24
33,46,2,1,27,26
33,46,3,1,24,23
33,46,4,4,22,18
33,46,5,1,19,18
33,46,6,0,25,25
33,47,0,2,27,25
33,47,1,2,32,30
33,47,2,5,42,37
33,47,3,4,38,34
33,47,4,0,22,22
33,47,5,0,24,24
33,47,6,1,8,7
33,48,0,7,45,38
33,48,1,3,36,33
33,48,2,4,35,31
33,48,3,3,33,30
33,48,4,0,21,21
33,48,5,0,17,17
33,48,6,0,15,15
33,49,0,11,54,43
33,49,1,3,45,42
33,49,2,3,38,35
33,49,3,4,38,34
33,49,4,0,28,28
33,49,5,1,29,28
33,49,6,0,14,14
33,50,0,27,60,33
33,50,1,3,44,41
33,50,2,3,38,35
33,50,3,2,39,37
33,50,4,5,31,26
33,50,5,1,31,30
33,50,6,5,21,16
33,51,0,9,51,42
33,51,1,2,43,41
33,51,2,7,51,44
33,51,3,2,44,42
33,51,4,2,32,30
33,51,5,1,38,37
33,51,6,0,21,21
33,52,0,8,49,41
33,52,1,5,36,31
33,52,2,3,29,26
33,52,3,4,36,32
33,52,4,0,24,24
33,52,5,0,17,17
33,52,6,2,32,30
33,53,0,8,41,33
33,53,1,1,32,31
33,53,2,1,34,33
33,53,3,5,43,38
33,53,4,0,30,30
33,53,5,3,30,27
33,53,6,1,26,25
33,54,0,2,28,26
33,54,1,0,26,26
33,54,2,2,34,32
33,54,3,2,27,25
33,54,4,7,21,14
33,54,5,3,26,23
33,54,6,2,21,19
33,55,0,1,18,17
33,55,1,2,31,29
33,55,2,5,31,26
33,55,3,0,18,18
33,55,4,3,30,27
33,55,5,2,21,19
33,55,6,2,28,26
33,56,0,4,45,41
33,56,1,0,34,34
33,56,2,3,31,28
33,56,3,4,31,27
33,56,4,2,23,21
33,56,5,6,33,27
33,56,6,1,24,23
33,57,0,3,25,22
33,57,1,2,24,22
33,57,2,4,29,25
33,57,3,0,16,16
33,57,4,2,24,22
33,57,5,1,22,21
33,57,6,0,22,22
33,58,0,3,24,21
33,58,1,0,28,28
33,58,2,4,22,18
33,58,3,6,28,22
33,58,4,7,32,25
33,58,5,0,24,24
33,58,6,2,39,37
33,59,0,2,26,24
33,59,1,4,28,24
33,59,2,3,25,22
33,59,3,8,36,28
33,59,4,4,33,29
33,59,5,3,29,26
33,59,6,1,13,12
33,60,0,2,22,20
33,60,1,1,16,15
33,60,2,2,27,25
33,60,3,6,28,22
33,60,4,3,24,21
33,60,5,6,39,33
33,60,6,0,24,24
33,61,0,2,17,15
33,61,1,0,18,18
33,61,2,1,19,18
33,61,3,7,24,17
33,61,4,14,42,28
33,61,5,3,30,27
33,61,6,3,30,27
33,62,0,7,22,15
33,62,1,4,32,28
33,62,2,9,36,27
33,62,3,1,21,20
33,62,4,7,28,21
33,62,5,5,34,29
33,62,6,4,34,30
33,63,0,7,38,31
33,63,1,10,33,23
33,63,2,6,27,21
33,63,3,9,31,22
33,63,4,5,25,20
33,63,5,0,30,30
33,63,6,3,27,24
33,64,0,8,26,18
33,64,1,6,26,20
33,64,2,5,24,19
33,64,3,5,21,16
33,64,4,13,36,23
33,64,5,2,28,26
33,64,6,0,23,23
33,65,0,8,27,19
33,65,1,6,20,14
33,65,2,2,31,29
33,65,3,2,22,20
33,65,4,17,39,22
33,65,5,1,24,23
33,65,6,3,24,21
33,66,0,13,30,17
33,66,1,7,28,21
33,66,2,12,32,20
33,66,3,3,23,20
33,66,4,2,24,22
33,66,5,0,30,30
33,66,6,4,28,24
33,67,0,5,20,15
33,67,1,3,26,23
33,67,2,7,22,15
33,67,3,4,29,25
33,67,4,7,21,14
33,67,5,2,25,23
33,67,6,3,17,14
33,68,0,10,36,26
33,68,1,6,23,17
33,68,2,3,26,23
33,68,3,9,26,17
33,68,4,6,26,20
33,68,5,0,22,22
33,68,6,0,22,22
33,69,0,4,25,21
33,69,1,5,23,18
33,69,2,4,24,20
33,69,3,5,21,16
33,69,4,19,43,24
33,69,5,1,24,23
33,69,6,7,32,25
33,70,0,4,23,19
33,70,1,2,14,12
33,70,2,2,20,18
33,70,3,5,23,18
33,70,4,17,48,31
33,70,5,1,26,25
33,70,6,3,27,24
33,71,0,4,22,18
33,71,1,6,22,16
33,71,2,3,20,17
33,71,3,10,23,13
33,71,4,12,38,26
33,71,5,3,26,23
33,71,6,3,30,27
33,72,0,0,15,15
33,72,1,7,24,17
33,72,2,5,31,26
33,72,3,12,37,25
33,72,4,9,27,18
33,72,5,2,32,30
33,72,6,0,36,36
33,73,0,0,20,20
33,73,1,12,29,17
33,73,2,3,16,13
33,73,3,1,19,18
33,73,4,4,24,20
33,73,5,0,21,21
33,73,6,1,28,27
33,74,0,0,20,20
33,74,1,7,18,11
33,74,2,3,22,19
33,74,3,4,18,14
33,74,4,3,20,17
33,74,5,1,22,21
33,74,6,4,31,27
33,75,0,2,23,21
33,75,1,3,26,23
33,75,2,6,25,19
33,75,3,7,20,13
33,75,4,12,39,27
33,75,5,7,35,28
33,75,6,4,32,28
33,76,0,2,17,15
33,76,1,0,20,20
33,76,2,3,34,31
33,76,3,4,27,23
33,76,4,16,38,22
33,76,5,4,35,31
33,76,6,3,22,19
33,77,0,4,24,20
33,77,1,8,24,16
33,77,2,0,19,19
33,77,3,4,20,16
33,77,4,5,27,22
33,77,5,1,26,25
33,77,6,2,33,31
33,78,0,3,16,13
33,78,1,7,25,18
33,78,2,1,24,23
33,78,3,6,28,22
33,78,4,8,33,25
33,78,5,7,32,25
33,78,6,5,30,25
33,79,0,2,27,25
33,79,1,9,33,24
33,79,2,3,17,14
33,79,3,3,20,17
33,79,4,3,26,23
33,79,5,2,25,23
33,79,6,2,28,26
33,80,0,3,25,22
33,80,1,2,23,21
33,80,2,6,24,18
33,80,3,2,25,23
33,80,4,10,31,21
33,80,5,2,29,27
33,80,6,2,39,37
33,81,0,3,20,17
33,81,1,4,17,13
33,81,2,14,39,25
33,81,3,4,24,20
33,81,4,8,34,26
33,81,5,5,44,39
33,81,6,3,34,31
33,82,0,1,20,19
33,82,1,7,26,19
33,82,2,1,15,14
33,82,3,5,23,18
33,82,4,3,28,25
33,82,5,0,33,33
33,82,6,0,25,25
33,83,0,2,18,16
33,83,1,1,17,16
33,83,2,5,28,23
33,83,3,2,25,23
33,83,4,1,16,15
33,83,5,4,34,30
33,83,6,3,24,21
33,84,0,2,26,24
33,84,1,0,14,14
33,84,2,2,16,14
33,84,3,5,25,20
33,84,4,5,28,23
33,84,5,0,23,23
33,84,6,1,24,23
33,85,0,4,26,22
33,85,1,4,25,21
33,85,2,3,17,14
33,85,3,2,20,18
33,85,4,4,22,18
33,85,5,2,26,24
33,85,6,0,23,23
33,86,0,2,16,14
33,86,1,3,22,19
33,86,2,7,28,21
33,86,3,3,23,20
33,86,4,1,20,19
33,86,5,6,30,24
33,86,6,2,36,34
33,87,0,0,18,18
33,87,1,3,17,14
33,87,2,3,27,24
33,87,3,1,18,17
33,87,4,1,15,14
33,87,5,1,26,25
33,87,6,3,28,25
33,88,0,2,11,9
33,88,1,5,26,21
33,88,2,2,22,20
33,88,3,0,23,23
33,88,4,3,29,26
33,88,5,3,29,26
33,88,6,3,29,26
33,89,0,0,16,16
33,89,1,3,19,16
33,89,2,1,16,15
33,89,3,3,20,17
33,89,4,4,29,25
33,89,5,0,30,30
33,89,6,5,30,25
33,90,0,1,21,20
33,90,1,2,23,21
33,90,2,1,20,19
33,90,3,0,18,18
33,90,4,4,26,22
33,90,5,0,19,19
33,90,6,4,26,22
33,91,0,0,16,16
33,91,1,0,17,17
33,91,2,0,17,17
33,91,3,3,28,25
33,91,4,4,30,26
33,91,5,0,21,21
33,91,6,4,23,19
33,92,0,3,22,19
33,92,1,2,33,31
33,92,2,0,10,10
33,92,3,4,27,23
33,92,4,2,19,17
33,92,5,4,28,24
33,92,6,4,28,24
33,93,0,0,23,23
33,93,1,0,29,29
33,93,2,1,17,16
33,93,3,0,27,27
33,93,4,3,40,37
33,93,5,4,30,26
33,93,6,2,29,27
33,94,0,1,16,15
33,94,1,0,25,25
33,94,2,0,27,27
33,94,3,1,16,15
33,94,4,0,20,20
33,94,5,1,33,32
33,94,6,2,30,28
33,95,0,0,23,23
33,95,1,2,24,22
33,95,2,2,30,28
33,95,3,4,30,26
33,95,4,0,25,25
33,95,5,2,39,37
33,95,6,1,28,27
33,96,0,0,22,22
33,96,1,0,32,32
33,96,2,0,14,14
33,96,3,6,31,25
33,96,4,1,23,22
33,96,5,7,41,34
33,96,6,3,31,28
33,97,0,1,21,20
33,97,1,0,21,21
33,97,2,1,21,20
33,97,3,2,32,30
33,97,4,0,24,24
33,97,5,0,32,32
33,97,6,0,36,36
33,98,0,1,22,21
33,98,1,1,26,25
33,98,2,0,26,26
33,98,3,1,17,16
33,98,4,2,35,33
33,98,5,2,26,24
33,98,6,1,19,18
33,99,0,0,24,24
33,99,1,2,35,33
33,99,2,6,33,27
33,99,3,1,32,31
33,99,4,0,32,32
33,99,5,2,37,35
33,99,6,2,25,23
33,100,0,2,28,26
33,100,1,1,29,28
33,100,2,2,34,32
33,100,3,0,23,23
33,100,4,1,42,41
33,100,5,0,25,25
33,100,6,0,26,26
33,101,0,0,41,41
33,101,1,0,28,28
33,101,2,0,25,25
33,101,3,0,26,26
33,101,4,1,24,23
33,101,5,1,36,35
33,101,6,0,20,20
33,102,0,0,27,27
33,102,1,1,28,27
33,102,2,2,38,36
33,102,3,0,25,25
33,102,4,0,28,28
33,102,5,3,31,28
33,102,6,0,35,35
33,103,0,2,23,21
33,103,1,0,31,31
33,103,2,3,26,23
33,103,3,1,28,27
33,103,4,0,26,26
33,103,5,1,35,34
33,103,6,2,35,33
33,104,0,1,23,22
33,104,1,2,25,23
33,104,2,2,30,28
33,104,3,2,38,36
33,104,4,3,35,32
33,104,5,2,48,46
33,104,6,1,31,30
33,105,0,0,30,30
33,105,1,2,37,35
33,105,2,3,39,36
33,105,3,0,28,28
33,105,4,1,30,29
33,105,5,0,12,12
33,105,6,0,25,25
33,106,0,0,23,23
33,106,1,0,21,21
33,106,2,0,33,33
33,106,3,1,28,27
33,106,4,2,27,25
33,106,5,0,24,24
33,106,6,1,23,22
33,107,0,0,29,29
33,107,1,0,29,29
33,107,2,1,26,25
33,107,3,1,27,26
33,107,4,0,21,21
33,107,5,1,28,27
33,107,6,2,24,22
33,108,0,0,28,28
33,108,1,1,30,29
33,108,2,1,33,32
33,108,3,1,29,28
33,108,4,4,36,32
33,108,5,3,43,40
33,108,6,2,25,23
33,109,0,0,19,19
33,109,1,3,34,31
33,109,2,2,23,21
33,109,3,1,29,28
33,109,4,2,31,29
33,109,5,2,24,22
33,109,6,3,28,25
33,110,0,1,23,22
33,110,1,1,21,20
33,110,2,1,21,20
33,110,3,1,25,24
33,110,4,3,36,33
33,110,5,5,30,25
33,110,6,0,22,22
33,111,0,2,24,22
33,111,1,3,29,26
33,111,2,2,31,29
33,111,3,0,22,22
33,111,4,2,31,29
33,111,5,1,33,32
33,111,6,0,31,31
33,112,0,0,23,23
33,112,1,2,21,19
33,112,2,1,27,26
33,112,3,1,23,22
33,112,4,2,37,35
33,112,5,1,37,36
33,112,6,0,20,20
33,113,0,1,20,19
33,113,1,1,22,21
33,113,2,1,21,20
33,113,3,5,29,24
33,113,4,0,25,25
33,113,5,1,20,19
33,113,6,0,34,34
33,114,0,0,17,17
33,114,1,1,27,26
33,114,2,3,27,24
33,114,3,4,22,18
33,114,4,0,24,24
33,114,5,0,22,22
33,114,6,1,26,25
33,115,0,4,25,21
33,115,1,0,20,20
33,115,2,1,18,17
33,115,3,1,16,15
33,115,4,5,34,29
33,115,5,2,26,24
33,115,6,2,20,18
33,116,0,1,22,21
33,116,1,3,23,20
33,116,2,3,25,22
33,116,3,2,30,28
33,116,4,2,29,27
33,116,5,0,21,21
33,116,6,2,26,24
33,117,0,0,12,12
33,117,1,2,34,32
33,117,2,0,23,23
33,117,3,0,27,27
33,117,4,2,23,21
33,117,5,4,28,24
33,117,6,2,21,19
33,118,0,0,11,11
33,118,1,0,23,23
33,118,2,0,22,22
33,118,3,0,19,19
33,118,4,1,20,19
33,118,5,5,28,23
33,118,6,3,35,32
33,119,0,2,17,15
33,119,1,1,24,23
33,119,2,2,29,27
33,119,3,0,18,18
33,119,4,1,26,25
33,119,5,7,29,22
33,119,6,5,26,21
33,120,0,0,14,14
33,120,1,3,20,17
33,120,2,2,18,16
33,120,3,1,20,19
33,120,4,3,35,32
33,120,5,2,28,26
33,120,6,2,29,27
33,121,0,1,18,17
33,121,1,1,17,16
33,121,2,1,15,14
33,121,3,2,21,19
33,121,4,2,27,25
33,121,5,1,21,20
33,121,6,4,23,19
33,122,0,0,19,19
33,122,1,0,16,16
33,122,2,1,26,25
33,122,3,1,24,23
33,122,4,2,23,21
33,122,5,2,20,18
33,122,6,2,24,22
33,123,0,0,16,16
33,123,1,1,23,22
33,123,2,1,22,21
33,123,3,1,18,17
33,123,4,0,21,21
33,123,5,2,19,17
33,123,6,2,20,18
33,124,0,3,16,13
33,124,1,0,22,22
33,124,2,0,29,29
33,124,3,0,24,24
33,124,4,1,19,18
33,124,5,3,17,14
33,124,6,1,19,18
33,125,0,5,25,20
33,125,1,2,25,23
33,125,2,0,18,18
33,125,3,3,20,17
33,125,4,1,24,23
33,125,5,3,24,21
33,125,6,2,19,17
33,126,0,0,24,24
33,126,1,1,16,15
33,126,2,1,21,20
33,126,3,0,18,18
33,126,4,3,25,22
33,126,5,2,28,26
33,126,6,0,17,17
33,127,0,0,18,18
33,127,1,0,17,17
33,127,2,1,21,20
33,127,3,3,23,20
33,127,4,1,13,12
33,127,5,3,18,15
33,127,6,2,24,22
33,128,0,2,13,11
33,128,1,2,18,16
33,128,2,2,24,22
33,128,3,4,15,11
33,128,4,5,23,18
33,128,5,2,19,17
33,128,6,3,26,23
33,129,0,1,14,13
33,129,1,2,10,8
33,129,2,5,28,23
33,129,3,0,11,11
33,129,4,5,22,17
33,129,5,1,19,18
33,129,6,1,13,12
33,130,0,0,18,18
33,130,1,2,15,13
33,130,2,0,18,18
33,130,3,1,18,17
33,130,4,0,17,17
33,130,5,4,16,12
33,130,6,2,12,10
33,131,0,1,13,12
33,131,1,0,18,18
33,131,2,1,16,15
33,131,3,1,13,12
33,131,4,1,20,19
33,131,5,0,13,13
33,131,6,1,14,13
33,132,0,1,15,14
33,132,1,2,12,10
33,132,2,1,8,7
33,132,3,1,12,11
33,132,4,2,24,22
33,132,5,0,18,18
33,132,6,1,18,17
33,133,0,1,13,12
33,133,1,1,12,11
33,133,2,0,10,10
33,133,3,2,22,20
33,133,4,1,15,14
33,133,5,4,22,18
33,133,6,0,13,13
33,134,0,1,10,9
33,134,1,2,21,19
33,134,2,3,28,25
33,134,3,0,15,15
33,134,4,0,14,14
33,134,5,3,13,10
33,134,6,5,19,14
33,135,0,1,12,11
33,135,1,3,18,15
33,135,2,2,17,15
33,135,3,0,13,13
33,135,4,1,21,20
33,135,5,2,19,17
33,135,6,7,20,13
33,136,0,1,14,13
33,136,1,4,17,13
33,136,2,0,11,11
33,136,3,1,17,16
33,136,4,1,19,18
33,136,5,1,14,13
33,136,6,3,13,10
33,137,0,2,17,15
33,137,1,0,12,12
33,137,2,2,13,11
33,137,3,1,17,16
33,137,4,1,13,12
33,137,5,1,18,17
33,137,6,8,18,10
33,138,0,0,9,9
33,138,1,1,10,9
33,138,2,1,9,8
33,138,3,1,15,14
33,138,4,2,9,7
33,138,5,1,15,14
33,138,6,4,25,21
33,139,0,0,11,11
33,139,1,1,9,8
33,139,2,2,15,13
33,139,3,0,14,14
33,139,4,1,12,11
33,139,5,0,14,14
33,139,6,2,11,9
33,140,0,0,6,6
33,140,1,0,9,9
33,140,2,1,11,10
33,140,3,4,19,15
33,140,4,0,10,10
33,140,5,3,14,11
33,140,6,4,11,7
33,141,0,2,9,7
33,141,1,0,8,8
33,141,2,1,9,8
33,141,3,12,19,7
33,141,4,3,19,16
33,141,5,6,20,14
33,141,6,2,13,11
33,142,0,3,8,5
33,142,1,1,10,9
33,142,2,4,8,4
33,142,3,1,11,10
33,142,4,9,25,16
33,142,5,5,15,10
33,142,6,3,8,5
33,143,0,1,7,6
33,143,1,2,8,6
33,143,2,1,6,5
33,143,3,4,14,10
33,143,4,1,6,5
33,143,5,4,15,11
33,143,6,2,13,11
34,0,0,0,2,2
34,0,1,3,7,4
34,0,2,1,3,2
34,0,4,1,4,3
34,0,5,2,5,3
34,0,6,2,7,5
34,1,0,0,6,6
34,1,1,4,5,1
34,1,2,0,1,1
34,1,3,1,1,0
34,1,4,1,4,3
34,1,5,0,2,2
34,1,6,2,5,3
34,2,0,1,3,2
34,2,1,4,7,3
34,2,2,1,2,1
34,2,3,2,2,0
34,2,4,1,4,3
34,2,5,0,1,1
34,2,6,3,7,4
34,3,0,0,4,4
34,3,1,5,6,1
34,3,2,1,2,1
34,3,3,2,3,1
34,3,4,4,7,3
34,3,5,2,3,1
34,3,6,0,1,1
34,4,0,1,4,3
34,4,1,2,6,4
34,4,2,2,2,0
34,4,3,1,2,1
34,4,4,8,10,2
34,4,5,5,6,1
34,4,6,2,5,3
34,5,0,0,2,2
34,5,1,0,3,3
34,5,2,7,10,3
34,5,3,1,2,1
34,5,4,1,2,1
34,5,6,0,2,2
34,6,0,1,3,2
34,6,1,0,1,1
34,6,2,1,2,1
34,6,3,1,2,1
34,6,4,3,6,3
34,6,5,0,1,1
34,6,6,0,2,2
34,7,1,0,1,1
34,7,2,1,2,1
34,7,3,2,5,3
34,7,4,3,6,3
34,7,6,1,1,0
34,8,2,0,1,1
34,8,3,0,2,2
34,8,4,1,1,0
34,8,5,0,2,2
34,8,6,1,4,3
34,9,0,1,2,1
34,9,1,0,1,1
34,9,3,4,5,1
34,9,4,1,5,4
34,10,1,0,2,2
34,10,2,3,5,2
34,10,3,3,3,0
34,10,4,2,5,3
34,10,5,1,1,0
34,10,6,0,3,3
34,11,0,0,1,1
34,11,1,1,2,1
34,11,2,1,4,3
34,11,3,2,3,1
34,11,4,8,9,1
34,11,5,0,1,1
34,11,6,2,2,0
34,12,0,2,3,1
34,12,1,5,5,0
34,12,2,2,3,1
34,12,3,0,1,1
34,12,4,3,5,2
34,12,5,1,1,0
34,13,0,2,3,1
34,13,1,3,3,0
34,13,2,0,4,4
34,13,3,1,1,0
34,13,4,1,3,2
34,13,5,0,1,1
34,13,6,1,3,2
34,14,0,1,1,0
34,14,1,3,3,0
34,14,4,0,1,1
34,14,6,2,2,0
34,15,0,1,1,0
34,15,1,0,3,3
34,15,3,0,1,1
34,15,5,0,1,1
34,15,6,4,4,0
34,16,0,0,1,1
34,16,1,1,1,0
34,16,6,0,1,1
34,17,0,1,1,0
34,17,4,1,3,2
34,17,6,0,1,1
34,18,0,2,4,2
34,18,5,1,1,0
34,19,0,5,5,0
34,19,4,0,1,1
34,19,6,2,2,0
34,20,0,3,4,1
34,20,2,1,1,0
34,20,5,1,1,0
34,21,0,0,1,1
34,21,1,1,1,0
34,21,2,1,1,0
34,21,4,1,2,1
34,22,0,0,1,1
34,22,1,1,2,1
34,22,4,4,4,0
34,22,6,1,1,0
34,23,2,1,2,1
34,23,4,1,3,2
34,23,6,3,4,1
34,24,0,3,4,1
34,24,2,1,1,0
34,24,3,1,2,1
34,24,4,1,1,0
34,25,4,0,1,1
34,27,1,1,1,0
34,27,4,0,1,1
34,27,6,0,1,1
34,28,4,1,1,0
34,28,6,0,1,1
34,29,2,2,3,1
34,29,4,4,6,2
34,29,6,2,3,1
34,30,1,3,3,0
34,30,4,5,5,0
34,30,6,0,1,1
34,31,0,1,2,1
34,31,1,4,5,1
34,31,2,1,1,0
34,31,3,3,3,0
34,31,4,3,3,0
34,32,0,0,2,2
34,32,1,0,1,1
34,32,2,1,2,1
34,32,3,3,3,0
34,32,4,4,5,1
34,32,5,1,1,0
34,32,6,6,6,0
34,33,0,3,3,0
34,33,1,3,4,1
34,33,2,0,1,1
34,33,3,3,3,0
34,33,4,2,2,0
34,33,6,10,13,3
34,34,0,1,1,0
34,34,1,1,2,1
34,34,2,0,2,2
34,34,3,0,1,1
34,34,4,2,4,2
34,34,5,2,3,1
34,34,6,1,2,1
34,35,0,0,1,1
34,35,1,1,1,0
34,35,2,1,4,3
34,35,4,2,3,1
34,35,6,6,7,1
34,36,0,1,2,1
34,36,2,0,2,2
34,36,3,0,2,2
34,36,4,5,9,4
34,36,5,0,1,1
34,36,6,2,4,2
34,37,0,3,4,1
34,37,1,1,2,1
34,37,2,1,3,2
34,37,3,2,4,2
34,37,4,5,8,3
34,37,5,0,2,2
34,37,6,2,7,5
34,38,0,1,2,1
34,38,1,0,3,3
34,38,2,1,5,4
34,38,3,1,4,3
34,38,4,8,14,6
34,38,5,1,7,6
34,38,6,1,2,1
34,39,0,2,7,5
34,39,1,0,5,5
34,39,2,0,1,1
34,39,3,0,6,6
34,39,4,3,9,6
34,39,5,0,2,2
34,39,6,0,6,6
34,40,0,2,6,4
34,40,1,0,4,4
34,40,2,1,6,5
34,40,3,3,10,7
34,40,4,0,5,5
34,40,5,0,7,7
34,40,6,2,5,3
34,41,0,1,10,9
34,41,1,1,11,10
34,41,2,0,9,9
34,41,3,0,9,9
34,41,4,1,5,4
34,41,5,1,13,12
34,41,6,2,7,5
34,42,0,1,10,9
34,42,1,0,10,10
34,42,2,2,17,15
34,42,3,3,18,15
34,42,4,0,12,12
34,42,5,2,12,10
34,42,6,2,7,5
34,43,0,1,19,18
34,43,1,0,16,16
34,43,2,1,18,17
34,43,3,2,20,18
34,43,4,2,21,19
34,43,5,1,10,9
34,43,6,2,14,12
34,44,0,2,21,19
34,44,1,0,19,19
34,44,2,4,27,23
34,44,3,2,24,22
34,44,4,4,29,25
34,44,5,1,21,20
34,44,6,6,25,19
34,45,0,0,23,23
34,45,1,3,22,19
34,45,2,2,24,22
34,45,3,7,31,24
34,45,4,1,31,30
34,45,5,5,26,21
34,45,6,2,18,16
34,46,0,8,34,26
34,46,1,7,31,24
34,46,2,5,39,34
34,46,3,6,50,44
34,46,4,7,32,25
34,46,5,1,21,20
34,46,6,0,11,11
34,47,0,5,50,45
34,47,1,5,26,21
34,47,2,4,33,29
34,47,3,7,43,36
34,47,4,0,28,28
34,47,5,4,17,13
34,47,6,0,11,11
34,48,0,1,36,35
34,48,1,2,31,29
34,48,2,4,27,23
34,48,3,6,33,27
34,48,4,2,26,24
34,48,5,2,28,26
34,48,6,3,19,16
34,49,0,1,24,23
34,49,1,0,27,27
34,49,2,2,26,24
34,49,3,4,35,31
34,49,4,2,22,20
34,49,5,3,21,18
34,49,6,4,33,29
34,50,0,2,26,24
34,50,1,1,20,19
34,50,2,2,26,24
34,50,3,6,25,19
34,50,4,7,34,27
34,50,5,4,25,21
34,50,6,8,31,23
34,51,0,3,22,19
34,51,1,4,26,22
34,51,2,12,40,28
34,51,3,8,23,15
34,51,4,12,34,22
34,51,5,5,32,27
34,51,6,3,13,10
34,52,0,3,27,24
34,52,1,1,31,30
34,52,2,3,20,17
34,52,3,2,22,20
34,52,4,4,32,28
34,52,5,4,27,23
34,52,6,5,26,21
34,53,0,7,28,21
34,53,1,3,25,22
34,53,2,4,23,19
34,53,3,4,27,23
34,53,4,0,33,33
34,53,5,5,31,26
34,53,6,1,25,24
34,54,0,1,15,14
34,54,1,0,27,27
34,54,2,2,16,14
34,54,3,3,32,29
34,54,4,2,36,34
34,54,5,7,35,28
34,54,6,3,34,31
34,55,0,0,17,17
34,55,1,3,23,20
34,55,2,2,29,27
34,55,3,5,23,18
34,55,4,4,33,29
34,55,5,8,30,22
34,55,6,11,33,22
34,56,0,1,25,24
34,56,1,5,26,21
34,56,2,2,23,21
34,56,3,5,25,20
34,56,4,5,37,32
34,56,5,4,23,19
34,56,6,3,23,20
34,57,0,6,24,18
34,57,1,4,22,18
34,57,2,5,20,15
34,57,3,5,29,24
34,57,4,17,49,32
34,57,5,5,30,25
34,57,6,6,29,23
34,58,0,3,21,18
34,58,1,1,20,19
34,58,2,8,33,25
34,58,3,12,37,25
34,58,4,14,42,28
34,58,5,4,36,32
34,58,6,14,43,29
34,59,0,7,21,14
34,59,1,6,28,22
34,59,2,9,24,15
34,59,3,5,28,23
34,59,4,15,41,26
34,59,5,7,37,30
34,59,6,14,39,25
34,60,0,2,22,20
34,60,1,9,23,14
34,60,2,11,30,19
34,60,3,4,24,20
34,60,4,6,45,39
34,60,5,3,18,15
34,60,6,18,43,25
34,61,0,7,27,20
34,61,1,4,23,19
34,61,2,6,25,19
34,61,3,12,38,26
34,61,4,24,54,30
34,61,5,13,34,21
34,61,6,4,28,24
34,62,0,5,28,23
34,62,1,4,21,17
34,62,2,3,20,17
34,62,3,14,34,20
34,62,4,25,50,25
34,62,5,6,19,13
34,62,6,9,40,31
34,63,0,11,32,21
34,63,1,14,31,17
34,63,2,4,21,17
34,63,3,17,36,19
34,63,4,17,42,25
34,63,5,7,16,9
34,63,6,5,30,25
34,64,0,11,27,16
34,64,1,6,27,21
34,64,2,2,28,26
34,64,3,6,36,30
34,64,4,19,46,27
34,64,5,5,34,29
34,64,6,10,39,29
34,65,0,5,24,19
34,65,1,8,29,21
34,65,2,6,27,21
34,65,3,4,25,21
34,65,4,10,37,27
34,65,5,7,39,32
34,65,6,11,44,33
34,66,0,3,18,15
34,66,1,0,20,20
34,66,2,11,34,23
34,66,3,7,34,27
34,66,4,9,30,21
34,66,5,1,27,26
34,66,6,27,52,25
34,67,0,5,25,20
34,67,1,5,29,24
34,67,2,13,42,29
34,67,3,6,32,26
34,67,4,10,34,24
34,67,5,5,26,21
34,67,6,17,50,33
34,68,0,1,19,18
34,68,1,5,26,21
34,68,2,26,47,21
34,68,3,10,37,27
34,68,4,37,73,36
34,68,5,1,32,31
34,68,6,23,49,26
34,69,0,1,19,18
34,69,1,3,19,16
34,69,2,11,33,22
34,69,3,11,36,25
34,69,4,14,46,32
34,69,5,2,31,29
34,69,6,17,57,40
34,70,0,6,20,14
34,70,1,7,21,14
34,70,2,11,35,24
34,70,3,4,22,18
34,70,4,6,28,22
34,70,5,3,30,27
34,70,6,20,56,36
34,71,0,2,18,16
34,71,1,5,17,12
34,71,2,14,38,24
34,71,3,14,37,23
34,71,4,14,49,35
34,71,5,10,39,29
34,71,6,11,37,26
34,72,0,3,22,19
34,72,1,11,31,20
34,72,2,9,22,13
34,72,3,19,51,32
34,72,4,28,56,28
34,72,5,6,33,27
34,72,6,13,39,26
34,73,0,2,15,13
34,73,1,7,30,23
34,73,2,9,30,21
34,73,3,25,50,25
34,73,4,29,54,25
34,73,5,2,34,32
34,73,6,8,32,24
34,74,0,3,20,17
34,74,1,8,34,26
34,74,2,17,38,21
34,74,3,15,45,30
34,74,4,21,39,18
34,74,5,3,26,23
34,74,6,11,40,29
34,75,0,1,29,28
34,75,1,13,38,25
34,75,2,32,45,13
34,75,3,11,34,23
34,75,4,12,46,34
34,75,5,5,29,24
34,75,6,16,46,30
34,76,0,6,18,12
34,76,1,15,40,25
34,76,2,9,39,30
34,76,3,6,35,29
34,76,4,7,34,27
34,76,5,8,41,33
34,76,6,17,42,25
34,77,0,8,33,25
34,77,1,12,33,21
34,77,2,6,29,23
34,77,3,15,42,27
34,77,4,27,59,32
34,77,5,3,27,24
34,77,6,29,63,34
34,78,0,12,31,19
34,78,1,7,27,20
34,78,2,11,39,28
34,78,3,7,35,28
34,78,4,6,37,31
34,78,5,12,38,26
34,78,6,10,51,41
34,79,0,11,27,16
34,79,1,13,32,19
34,79,2,6,27,21
34,79,3,8,48,40
34,79,4,4,26,22
34,79,5,14,46,32
34,79,6,13,36,23
34,80,0,8,34,26
34,80,1,18,49,31
34,80,2,10,32,22
34,80,3,16,59,43
34,80,4,18,45,27
34,80,5,21,48,27
34,80,6,6,32,26
34,81,0,12,34,22
34,81,1,7,24,17
34,81,2,11,34,23
34,81,3,4,35,31
34,81,4,13,47,34
34,81,5,3,28,25
34,81,6,10,48,38
34,82,0,12,41,29
34,82,1,6,33,27
34,82,2,3,15,12
34,82,3,2,31,29
34,82,4,11,30,19
34,82,5,1,19,18
34,82,6,0,28,28
34,83,0,3,20,17
34,83,1,7,29,22
34,83,2,3,21,18
34,83,3,0,20,20
34,83,4,8,27,19
34,83,5,8,30,22
34,83,6,6,31,25
34,84,0,3,27,24
34,84,1,7,28,21
34,84,2,9,29,20
34,84,3,0,14,14
34,84,4,8,39,31
34,84,5,3,27,24
34,84,6,7,35,28
34,85,0,6,29,23
34,85,1,6,23,17
34,85,2,21,42,21
34,85,3,0,20,20
34,85,4,2,32,30
34,85,5,5,34,29
34,85,6,1,27,26
34,86,0,5,22,17
34,86,1,3,28,25
34,86,2,15,40,25
34,86,3,0,25,25
34,86,4,3,22,19
34,86,5,3,29,26
34,86,6,0,16,16
34,87,0,6,32,26
34,87,1,1,20,19
34,87,2,10,32,22
34,87,3,4,32,28
34,87,4,3,37,34
34,87,5,4,32,28
34,87,6,1,26,25
34,88,0,16,41,25
34,88,1,4,24,20
34,88,2,6,39,33
34,88,3,0,26,26
34,88,4,12,43,31
34,88,5,1,21,20
34,88,6,4,27,23
34,89,0,7,31,24
34,89,1,3,21,18
34,89,2,7,33,26
34,89,3,8,31,23
34,89,4,4,36,32
34,89,5,5,32,27
34,89,6,7,36,29
34,90,0,13,46,33
34,90,1,6,28,22
34,90,2,9,45,36
34,90,3,7,34,27
34,90,4,10,38,28
34,90,5,3,26,23
34,90,6,9,36,27
34,91,0,11,32,21
34,91,1,14,44,30
34,91,2,8,33,25
34,91,3,11,35,24
34,91,4,14,40,26
34,91,5,4,28,24
34,91,6,5,35,30
34,92,0,1,26,25
34,92,1,5,26,21
34,92,2,8,38,30
34,92,3,13,29,16
34,92,4,0,38,38
34,92,5,9,30,21
34,92,6,5,33,28
34,93,0,4,30,26
34,93,1,1,29,28
34,93,2,3,31,28
34,93,3,5,29,24
34,93,4,7,56,49
34,93,5,3,39,36
34,93,6,3,23,20
34,94,0,4,44,40
34,94,1,3,26,23
34,94,2,3,23,20
34,94,3,2,22,20
34,94,4,0,25,25
34,94,5,6,27,21
34,94,6,3,34,31
34,95,0,4,32,28
34,95,1,2,25,23
34,95,2,2,32,30
34,95,3,1,19,18
34,95,4,1,34,33
34,95,5,3,21,18
34,95,6,1,31,30
34,96,0,4,32,28
34,96,1,0,27,27
34,96,2,6,45,39
34,96,3,2,22,20
34,96,4,4,37,33
34,96,5,1,22,21
34,96,6,3,24,21
34,97,0,2,25,23
34,97,1,3,30,27
34,97,2,6,41,35
34,97,3,6,37,31
34,97,4,2,28,26
34,97,5,2,19,17
34,97,6,1,28,27
34,98,0,1,33,32
34,98,1,3,22,19
34,98,2,5,27,22
34,98,3,1,28,27
34,98,4,1,32,31
34,98,5,1,16,15
34,98,6,1,20,19
34,99,0,2,32,30
34,99,1,2,28,26
34,99,2,4,32,28
34,99,3,0,22,22
34,99,4,1,31,30
34,99,5,0,31,31
34,99,6,4,39,35
34,100,0,4,28,24
34,100,1,1,27,26
34,100,2,2,25,23
34,100,3,1,32,31
34,100,4,3,36,33
34,100,5,1,28,27
34,100,6,1,35,34
34,101,0,1,27,26
34,101,1,0,23,23
34,101,2,6,33,27
34,101,3,2,34,32
34,101,4,3,37,34
34,101,5,3,30,27
34,101,6,1,32,31
34,102,0,5,21,16
34,102,1,2,28,26
34,102,2,4,31,27
34,102,3,2,30,28
34,102,4,3,25,22
34,102,5,4,25,21
34,102,6,8,36,28
34,103,0,2,22,20
34,103,1,4,29,25
34,103,2,9,32,23
34,103,3,2,32,30
34,103,4,0,32,32
34,103,5,4,30,26
34,103,6,3,36,33
34,104,0,1,26,25
34,104,1,1,35,34
34,104,2,2,28,26
34,104,3,1,40,39
34,104,4,0,34,34
34,104,5,4,34,30
34,104,6,2,38,36
34,105,0,4,28,24
34,105,1,2,30,28
34,105,2,2,36,34
34,105,3,3,49,46
34,105,4,1,34,33
34,105,5,5,50,45
34,105,6,1,20,19
34,106,0,6,33,27
34,106,1,4,35,31
34,106,2,9,42,33
34,106,3,11,51,40
34,106,4,6,51,45
34,106,5,11,65,54
34,106,6,5,27,22
34,107,0,5,32,27
34,107,1,5,33,28
34,107,2,8,54,46
34,107,3,8,41,33
34,107,4,1,32,31
34,107,5,4,55,51
34,107,6,1,32,31
34,108,0,0,34,34
34,108,1,4,34,30
34,108,2,3,37,34
34,108,3,4,30,26
34,108,4,3,29,26
34,108,5,10,46,36
34,108,6,1,35,34
34,109,0,3,29,26
34,109,1,1,30,29
34,109,2,6,39,33
34,109,3,8,59,51
34,109,4,3,37,34
34,109,5,3,34,31
34,109,6,6,40,34
34,110,0,1,29,28
34,110,1,2,27,25
34,110,2,4,27,23
34,110,3,10,43,33
34,110,4,2,31,29
34,110,5,7,43,36
34,110,6,2,27,25
34,111,0,2,32,30
34,111,1,3,37,34
34,111,2,7,29,22
34,111,3,7,45,38
34,111,4,3,30,27
34,111,5,4,34,30
34,111,6,5,36,31
34,112,0,3,27,24
34,112,1,7,37,30
34,112,2,6,32,26
34,112,3,5,28,23
34,112,4,1,27,26
34,112,5,3,41,38
34,112,6,0,31,31
34,113,0,3,34,31
34,113,1,2,19,17
34,113,2,7,38,31
34,113,3,2,27,25
34,113,4,2,29,27
34,113,5,1,40,39
34,113,6,4,26,22
34,114,0,3,25,22
34,114,1,0,25,25
34,114,2,4,20,16
34,114,3,2,20,18
34,114,4,1,27,26
34,114,5,3,29,26
34,114,6,2,31,29
34,115,0,3,27,24
34,115,1,1,17,16
34,115,2,1,25,24
34,115,3,3,31,28
34,115,4,3,31,28
34,115,5,1,32,31
34,115,6,2,29,27
34,116,0,4,36,32
34,116,1,11,30,19
34,116,2,2,24,22
34,116,3,4,32,28
34,116,4,4,30,26
34,116,5,1,27,26
34,116,6,0,23,23
34,117,0,5,32,27
34,117,1,3,37,34
34,117,2,8,29,21
34,117,3,2,20,18
34,117,4,2,26,24
34,117,5,7,35,28
34,117,6,1,20,19
34,118,0,8,24,16
34,118,1,4,33,29
34,118,2,6,28,22
34,118,3,5,27,22
34,118,4,3,31,28
34,118,5,1,31,30
34,118,6,5,25,20
34,119,0,2,28,26
34,119,1,6,30,24
34,119,2,2,27,25
34,119,3,5,17,12
34,119,4,4,27,23
34,119,5,7,41,34
34,119,6,0,26,26
34,120,0,1,24,23
34,120,1,2,25,23
34,120,2,2,32,30
34,120,3,4,24,20
34,120,4,2,20,18
34,120,5,7,37,30
34,120,6,0,31,31
34,121,0,1,24,23
34,121,1,4,25,21
34,121,2,7,31,24
34,121,3,5,37,32
34,121,4,3,33,30
34,121,5,7,40,33
34,121,6,2,28,26
34,122,0,1,26,25
34,122,1,4,21,17
34,122,2,6,36,30
34,122,3,3,24,21
34,122,4,3,29,26
34,122,5,4,30,26
34,122,6,2,28,26
34,123,0,2,24,22
34,123,1,2,20,18
34,123,2,9,32,23
34,123,3,2,24,22
34,123,4,3,31,28
34,123,5,3,29,26
34,123,6,0,27,27
34,124,0,0,16,16
34,124,1,4,32,28
34,124,2,10,35,25
34,124,3,1,17,16
34,124,4,3,36,33
34,124,5,3,30,27
34,124,6,1,28,27
34,125,0,4,25,21
34,125,1,1,20,19
34,125,2,2,24,22
34,125,3,1,20,19
34,125,4,4,31,27
34,125,5,10,28,18
34,125,6,0,20,20
34,126,0,0,23,23
34,126,1,2,15,13
34,126,2,0,20,20
34,126,3,5,15,10
34,126,4,4,23,19
34,126,5,0,24,24
34,126,6,1,16,15
34,127,0,1,15,14
34,127,1,3,24,21
34,127,2,0,11,11
34,127,3,2,16,14
34,127,4,4,24,20
34,127,5,7,38,31
34,127,6,3,21,18
34,128,0,4,17,13
34,128,1,6,21,15
34,128,2,2,16,14
34,128,3,1,16,15
34,128,4,2,20,18
34,128,5,1,15,14
34,128,6,5,21,16
34,129,0,1,9,8
34,129,1,9,23,14
34,129,2,3,16,13
34,129,3,3,10,7
34,129,4,4,22,18
34,129,5,3,32,29
34,129,6,2,16,14
34,130,0,1,13,12
34,130,1,1,10,9
34,130,2,2,11,9
34,130,3,2,14,12
34,130,4,3,15,12
34,130,5,14,39,25
34,130,6,4,13,9
34,131,0,3,14,11
34,131,1,1,17,16
34,131,2,0,10,10
34,131,3,3,11,8
34,131,4,2,16,14
34,131,5,5,29,24
34,131,6,1,10,9
34,132,0,0,7,7
34,132,1,1,9,8
34,132,2,0,13,13
34,132,3,1,10,9
34,132,4,2,14,12
34,132,5,6,24,18
34,132,6,1,13,12
34,133,0,7,21,14
34,133,1,1,12,11
34,133,2,1,10,9
34,133,3,5,12,7
34,133,4,0,17,17
34,133,5,1,19,18
34,133,6,1,13,12
34,134,0,5,16,11
34,134,1,1,6,5
34,134,2,2,13,11
34,134,3,3,12,9
34,134,4,2,14,12
34,134,5,0,9,9
34,134,6,2,9,7
34,135,0,0,15,15
34,135,1,2,10,8
34,135,2,3,19,16
34,135,3,1,7,6
34,135,4,4,27,23
34,135,5,1,9,8
34,135,6,8,21,13
34,136,0,5,17,12
34,136,1,4,6,2
34,136,2,5,11,6
34,136,3,0,10,10
34,136,4,1,14,13
34,136,5,0,11,11
34,136,6,0,8,8
34,137,0,6,14,8
34,137,1,2,11,9
34,137,2,4,15,11
34,137,3,9,15,6
34,137,4,3,12,9
34,137,5,0,10,10
34,137,6,1,8,7
34,138,0,8,14,6
34,138,1,2,7,5
34,138,2,1,4,3
34,138,3,2,8,6
34,138,4,0,7,7
34,138,5,3,9,6
34,138,6,0,3,3
34,139,0,5,7,2
34,139,1,11,17,6
34,139,2,2,8,6
34,139,3,0,5,5
34,139,4,0,6,6
34,139,5,0,3,3
34,139,6,2,5,3
34,140,0,0,5,5
34,140,1,3,9,6
34,140,2,3,11,8
34,140,3,2,5,3
34,140,4,2,11,9
34,140,5,2,6,4
34,140,6,1,3,2
34,141,0,4,6,2
34,141,1,6,15,9
34,141,2,2,9,7
34,141,3,3,3,0
34,141,4,1,4,3
34,141,5,3,13,10
34,141,6,2,4,2
34,142,0,8,15,7
34,142,1,1,1,0
34,142,2,1,9,8
34,142,3,4,5,1
34,142,4,4,8,4
34,142,5,3,9,6
34,142,6,2,4,2
34,143,0,2,4,2
34,143,1,1,4,3
34,143,2,1,3,2
34,143,3,1,4,3
34,143,4,0,4,4
34,143,5,1,6,5
34,143,6,2,3,1
35,0,0,2,8,6
35,0,1,2,8,6
35,0,2,1,8,7
35,0,3,6,12,6
35,0,4,0,10,10
35,0,5,1,9,8
35,0,6,4,16,12
35,1,0,0,2,2
35,1,1,2,7,5
35,1,2,0,5,5
35,1,3,1,4,3
35,1,4,0,6,6
35,1,5,3,6,3
35,1,6,0,6,6
35,2,0,2,4,2
35,2,1,8,13,5
35,2,2,1,13,12
35,2,3,3,6,3
35,2,4,2,12,10
35,2,5,0,4,4
35,2,6,0,3,3
35,3,0,0,2,2
35,3,1,3,5,2
35,3,2,1,7,6
35,3,3,0,4,4
35,3,4,2,9,7
35,3,5,2,4,2
35,3,6,1,6,5
35,4,0,2,10,8
35,4,1,0,1,1
35,4,2,4,10,6
35,4,3,0,2,2
35,4,4,2,10,8
35,4,5,0,3,3
35,4,6,2,6,4
35,5,2,2,7,5
35,5,3,7,12,5
35,5,4,0,7,7
35,5,5,3,7,4
35,5,6,3,6,3
35,6,0,0,1,1
35,6,1,0,1,1
35,6,2,0,2,2
35,6,3,0,2,2
35,6,4,3,6,3
35,6,5,0,5,5
35,6,6,1,3,2
35,7,0,0,2,2
35,7,2,1,2,1
35,7,3,1,3,2
35,7,4,2,3,1
35,7,5,1,3,2
35,7,6,12,18,6
35,8,0,0,1,1
35,8,1,0,2,2
35,8,2,1,2,1
35,8,3,1,4,3
35,8,4,0,4,4
35,8,5,1,3,2
35,8,6,2,4,2
35,9,0,0,2,2
35,9,1,0,1,1
35,9,2,0,1,1
35,9,3,0,5,5
35,9,4,1,2,1
35,9,5,0,2,2
35,9,6,3,8,5
35,10,0,1,1,0
35,10,2,0,1,1
35,10,3,1,3,2
35,10,4,2,8,6
35,10,5,2,3,1
35,10,6,0,8,8
35,11,1,0,3,3
35,11,2,1,1,0
35,11,3,0,3,3
35,11,4,0,3,3
35,11,5,1,1,0
35,11,6,0,6,6
35,12,0,4,7,3
35,12,1,1,1,0
35,12,3,0,1,1
35,12,4,0,1,1
35,12,5,1,2,1
35,12,6,1,2,1
35,13,0,1,1,0
35,13,2,1,3,2
35,13,3,2,2,0
35,13,4,0,2,2
35,13,5,0,1,1
35,14,1,0,1,1
35,14,2,1,5,4
35,14,3,4,6,2
35,14,4,0,1,1
35,14,5,3,4,1
35,15,1,2,2,0
35,15,3,4,5,1
35,15,4,1,2,1
35,15,5,0,1,1
35,16,1,0,1,1
35,16,2,1,1,0
35,16,3,3,3,0
35,16,4,1,4,3
35,16,5,0,1,1
35,16,6,1,1,0
35,17,2,0,1,1
35,17,3,2,3,1
35,17,5,2,3,1
35,18,0,1,1,0
35,18,3,4,4,0
35,18,4,1,1,0
35,18,5,0,2,2
35,18,6,0,2,2
35,19,0,1,2,1
35,19,3,1,1,0
35,19,4,3,4,1
35,19,6,0,1,1
35,20,0,0,1,1
35,20,2,0,1,1
35,20,3,0,2,2
35,20,4,4,5,1
35,20,5,0,2,2
35,20,6,1,1,0
35,21,3,0,1,1
35,21,4,0,3,3
35,22,4,2,2,0
35,23,0,0,1,1
35,24,4,2,3,1
35,25,6,1,2,1
35,26,4,1,2,1
35,27,2,1,1,0
35,27,3,2,2,0
35,27,6,1,1,0
35,28,3,0,1,1
35,28,5,1,1,0
35,29,5,0,1,1
35,30,0,1,2,1
35,30,4,0,1,1
35,31,1,1,2,1
35,31,3,0,1,1
35,31,4,4,4,0
35,32,1,1,2,1
35,32,2,1,1,0
35,32,3,0,1,1
35,32,5,0,2,2
35,32,6,1,1,0
35,33,0,2,2,0
35,33,1,2,3,1
35,33,4,6,7,1
35,33,6,4,5,1
35,34,0,0,1,1
35,34,1,1,1,0
35,34,2,2,4,2
35,34,4,4,5,1
35,34,5,0,1,1
35,35,1,4,7,3
35,35,2,0,1,1
35,35,3,1,1,0
35,35,4,4,6,2
35,35,5,0,2,2
35,35,6,1,2,1
35,36,0,0,2,2
35,36,1,5,5,0
35,36,2,2,3,1
35,36,3,1,4,3
35,36,4,4,4,0
35,36,6,1,1,0
35,37,0,0,3,3
35,37,1,5,5,0
35,37,2,1,2,1
35,37,3,1,3,2
35,37,4,2,3,1
35,37,5,6,7,1
35,37,6,2,2,0
35,38,0,1,4,3
35,38,1,0,3,3
35,38,2,1,2,1
35,38,3,6,9,3
35,38,4,4,5,1
35,38,5,2,3,1
35,38,6,0,1,1
35,39,0,1,12,11
35,39,1,0,8,8
35,39,2,3,19,16
35,39,3,0,11,11
35,39,4,11,24,13
35,39,5,2,9,7
35,39,6,0,4,4
35,40,0,1,10,9
35,40,1,0,9,9
35,40,2,1,3,2
35,40,3,3,8,5
35,40,4,7,15,8
35,40,5,0,4,4
35,40,6,0,2,2
35,41,0,0,9,9
35,41,1,1,9,8
35,41,2,0,10,10
35,41,3,4,21,17
35,41,4,1,15,14
35,41,5,1,7,6
35,41,6,2,12,10
35,42,0,3,15,12
35,42,1,0,8,8
35,42,2,2,10,8
35,42,3,0,17,17
35,42,4,5,17,12
35,42,5,0,6,6
35,42,6,7,12,5
35,43,0,2,21,19
35,43,1,0,18,18
35,43,2,1,14,13
35,43,3,2,19,17
35,43,4,9,22,13
35,43,5,2,8,6
35,43,6,3,10,7
35,44,0,3,24,21
35,44,1,0,12,12
35,44,2,0,19,19
35,44,3,2,28,26
35,44,4,1,20,19
35,44,5,2,15,13
35,44,6,8,21,13
35,45,0,3,48,45
35,45,1,1,45,44
35,45,2,1,46,45
35,45,3,3,47,44
35,45,4,5,39,34
35,45,5,1,27,26
35,45,6,5,32,27
35,46,0,3,50,47
35,46,1,1,32,31
35,46,2,2,35,33
35,46,3,3,42,39
35,46,4,3,22,19
35,46,5,3,29,26
35,46,6,5,18,13
35,47,0,11,63,52
35,47,1,4,63,59
35,47,2,2,52,50
35,47,3,3,66,63
35,47,4,6,55,49
35,47,5,3,35,32
35,47,6,3,25,22
35,48,0,10,85,75
35,48,1,3,78,75
35,48,2,2,79,77
35,48,3,8,107,99
35,48,4,17,93,76
35,48,5,2,37,35
35,48,6,6,34,28
35,49,0,5,96,91
35,49,1,3,106,103
35,49,2,1,104,103
35,49,3,5,110,105
35,49,4,6,78,72
35,49,5,2,41,39
35,49,6,0,20,20
35,50,0,2,128,126
35,50,1,5,148,143
35,50,2,7,137,130
35,50,3,5,129,124
35,50,4,3,95,92
35,50,5,0,49,49
35,50,6,5,53,48
35,51,0,9,191,182
35,51,1,3,187,184
35,51,2,8,190,182
35,51,3,5,196,191
35,51,4,6,123,117
35,51,5,6,87,81
35,51,6,2,61,59
35,52,0,15,199,184
35,52,1,7,198,191
35,52,2,9,162,153
35,52,3,12,203,191
35,52,4,5,141,136
35,52,5,2,66,64
35,52,6,1,49,48
35,53,0,5,159,154
35,53,1,7,136,129
35,53,2,7,140,133
35,53,3,6,149,143
35,53,4,5,111,106
35,53,5,0,50,50
35,53,6,0,44,44
35,54,0,7,163,156
35,54,1,0,140,140
35,54,2,6,161,155
35,54,3,3,165,162
35,54,4,2,106,104
35,54,5,3,44,41
35,54,6,4,31,27
35,55,0,3,131,128
35,55,1,2,129,127
35,55,2,3,170,167
35,55,3,8,169,161
35,55,4,2,95,93
35,55,5,2,48,46
35,55,6,1,43,42
35,56,0,10,103,93
35,56,1,1,97,96
35,56,2,9,123,114
35,56,3,1,113,112
35,56,4,4,92,88
35,56,5,4,45,41
35,56,6,3,35,32
35,57,0,3,69,66
35,57,1,4,92,88
35,57,2,4,83,79
35,57,3,3,97,94
35,57,4,5,90,85
35,57,5,0,45,45
35,57,6,1,42,41
35,58,0,3,69,66
35,58,1,8,73,65
35,58,2,9,78,69
35,58,3,2,114,112
35,58,4,6,68,62
35,58,5,3,57,54
35,58,6,1,44,43
35,59,0,3,53,50
35,59,1,6,56,50
35,59,2,2,75,73
35,59,3,2,63,61
35,59,4,8,70,62
35,59,5,3,44,41
35,59,6,1,47,46
35,60,0,2,23,21
35,60,1,2,37,35
35,60,2,2,35,33
35,60,3,1,47,46
35,60,4,4,44,40
35,60,5,11,46,35
35,60,6,0,36,36
35,61,0,0,30,30
35,61,1,5,28,23
35,61,2,1,37,36
35,61,3,1,30,29
35,61,4,23,61,38
35,61,5,1,32,31
35,61,6,1,31,30
35,62,0,0,29,29
35,62,1,1,21,20
35,62,2,6,36,30
35,62,3,2,44,42
35,62,4,12,43,31
35,62,5,5,40,35
35,62,6,2,29,27
35,63,0,2,25,23
35,63,1,1,29,28
35,63,2,1,27,26
35,63,3,1,35,34
35,63,4,7,40,33
35,63,5,2,48,46
35,63,6,2,31,29
35,64,0,1,25,24
35,64,1,0,25,25
35,64,2,3,33,30
35,64,3,5,43,38
35,64,4,17,39,22
35,64,5,2,34,32
35,64,6,0,43,43
35,65,0,0,17,17
35,65,1,2,32,30
35,65,2,4,37,33
35,65,3,1,32,31
35,65,4,9,40,31
35,65,5,1,46,45
35,65,6,5,43,38
35,66,0,2,15,13
35,66,1,4,30,26
35,66,2,5,38,33
35,66,3,1,33,32
35,66,4,19,45,26
35,66,5,1,39,38
35,66,6,4,47,43
35,67,0,2,25,23
35,67,1,1,33,32
35,67,2,0,25,25
35,67,3,2,40,38
35,67,4,19,38,19
35,67,5,9,52,43
35,67,6,4,41,37
35,68,0,1,24,23
35,68,1,3,21,18
35,68,2,1,25,24
35,68,3,5,42,37
35,68,4,20,46,26
35,68,5,2,37,35
35,68,6,2,46,44
35,69,0,3,28,25
35,69,1,3,38,35
35,69,2,5,42,37
35,69,3,2,42,40
35,69,4,16,53,37
35,69,5,1,37,36
35,69,6,3,48,45
35,70,0,2,27,25
35,70,1,2,33,31
35,70,2,5,37,32
35,70,3,7,47,40
35,70,4,18,50,32
35,70,5,9,49,40
35,70,6,1,37,36
35,71,0,4,37,33
35,71,1,8,34,26
35,71,2,8,42,34
35,71,3,4,44,40
35,71,4,23,55,32
35,71,5,10,45,35
35,71,6,5,49,44
35,72,0,1,35,34
35,72,1,7,45,38
35,72,2,5,41,36
35,72,3,5,42,37
35,72,4,18,57,39
35,72,5,5,61,56
35,72,6,4,40,36
35,73,0,3,34,31
35,73,1,12,45,33
35,73,2,6,49,43
35,73,3,4,41,37
35,73,4,17,56,39
35,73,5,11,53,42
35,73,6,1,40,39
35,74,0,3,29,26
35,74,1,4,26,22
35,74,2,3,38,35
35,74,3,5,39,34
35,74,4,15,45,30
35,74,5,11,54,43
35,74,6,6,47,41
35,75,0,0,17,17
35,75,1,8,28,20
35,75,2,4,43,39
35,75,3,3,50,47
35,75,4,5,31,26
35,75,5,13,52,39
35,75,6,3,52,49
35,76,0,4,41,37
35,76,1,6,29,23
35,76,2,5,34,29
35,76,3,3,45,42
35,76,4,14,48,34
35,76,5,7,47,40
35,76,6,5,51,46
35,77,0,0,21,21
35,77,1,5,38,33
35,77,2,2,35,33
35,77,3,0,38,38
35,77,4,17,52,35
35,77,5,11,46,35
35,77,6,4,47,43
35,78,0,2,30,28
35,78,1,8,50,42
35,78,2,4,44,40
35,78,3,3,47,44
35,78,4,6,45,39
35,78,5,8,43,35
35,78,6,7,57,50
35,79,0,1,40,39
35,79,1,6,49,43
35,79,2,3,45,42
35,79,3,2,39,37
35,79,4,16,51,35
35,79,5,10,51,41
35,79,6,4,48,44
35,80,0,4,32,28
35,80,1,0,33,33
35,80,2,6,45,39
35,80,3,11,58,47
35,80,4,16,51,35
35,80,5,23,67,44
35,80,6,2,37,35
35,81,0,0,36,36
35,81,1,3,33,30
35,81,2,4,37,33
35,81,3,3,47,44
35,81,4,4,27,23
35,81,5,9,42,33
35,81,6,1,40,39
35,82,0,1,30,29
35,82,1,1,35,34
35,82,2,9,54,45
35,82,3,4,48,44
35,82,4,11,42,31
35,82,5,8,63,55
35,82,6,1,37,36
35,83,0,0,21,21
35,83,1,3,22,19
35,83,2,3,42,39
35,83,3,1,33,32
35,83,4,8,42,34
35,83,5,15,50,35
35,83,6,8,47,39
35,84,0,5,34,29
35,84,1,1,25,24
35,84,2,2,31,29
35,84,3,3,41,38
35,84,4,8,36,28
35,84,5,3,38,35
35,84,6,4,41,37
35,85,0,4,26,22
35,85,1,0,20,20
35,85,2,3,40,37
35,85,3,0,29,29
35,85,4,9,46,37
35,85,5,10,52,42
35,85,6,4,39,35
35,86,0,2,29,27
35,86,1,0,32,32
35,86,2,0,30,30
35,86,3,0,43,43
35,86,4,14,38,24
35,86,5,2,38,36
35,86,6,3,39,36
35,87,0,1,16,15
35,87,1,1,26,25
35,87,2,2,28,26
35,87,3,1,33,32
35,87,4,2,33,31
35,87,5,3,43,40
35,87,6,4,40,36
35,88,0,0,28,28
35,88,1,4,37,33
35,88,2,1,28,27
35,88,3,2,34,32
35,88,4,17,44,27
35,88,5,2,32,30
35,88,6,2,36,34
35,89,0,1,20,19
35,89,1,1,29,28
35,89,2,3,42,39
35,89,3,2,39,37
35,89,4,11,40,29
35,89,5,3,40,37
35,89,6,6,42,36
35,90,0,4,22,18
35,90,1,0,32,32
35,90,2,3,27,24
35,90,3,1,38,37
35,90,4,10,44,34
35,90,5,9,54,45
35,90,6,6,52,46
35,91,0,7,34,27
35,91,1,7,33,26
35,91,2,10,46,36
35,91,3,9,55,46
35,91,4,7,42,35
35,91,5,5,39,34
35,91,6,4,52,48
35,92,0,6,31,25
35,92,1,9,50,41
35,92,2,6,53,47
35,92,3,3,41,38
35,92,4,11,43,32
35,92,5,3,40,37
35,92,6,3,42,39
35,93,0,5,31,26
35,93,1,2,37,35
35,93,2,5,47,42
35,93,3,1,36,35
35,93,4,0,45,45
35,93,5,3,44,41
35,93,6,2,36,34
35,94,0,0,18,18
35,94,1,2,43,41
35,94,2,1,34,33
35,94,3,4,36,32
35,94,4,1,44,43
35,94,5,4,40,36
35,94,6,4,37,33
35,95,0,3,25,22
35,95,1,1,34,33
35,95,2,1,37,36
35,95,3,2,39,37
35,95,4,2,42,40
35,95,5,6,48,42
35,95,6,4,39,35
35,96,0,0,29,29
35,96,1,0,37,37
35,96,2,1,44,43
35,96,3,2,52,50
35,96,4,2,50,48
35,96,5,1,62,61
35,96,6,3,53,50
35,97,0,0,17,17
35,97,1,1,38,37
35,97,2,4,51,47
35,97,3,1,42,41
35,97,4,2,42,40
35,97,5,1,30,29
35,97,6,5,44,39
35,98,0,3,36,33
35,98,1,3,66,63
35,98,2,2,40,38
35,98,3,1,51,50
35,98,4,3,36,33
35,98,5,2,47,45
35,98,6,9,55,46
35,99,0,1,37,36
35,99,1,3,54,51
35,99,2,2,51,49
35,99,3,3,49,46
35,99,4,6,58,52
35,99,5,2,42,40
35,99,6,4,38,34
35,100,0,2,32,30
35,100,1,2,49,47
35,100,2,2,58,56
35,100,3,4,53,49
35,100,4,1,34,33
35,100,5,4,57,53
35,100,6,6,41,35
35,101,0,2,40,38
35,101,1,4,58,54
35,101,2,2,57,55
35,101,3,8,54,46
35,101,4,4,59,55
35,101,5,3,49,46
35,101,6,7,53,46
35,102,0,3,51,48
35,102,1,2,46,44
35,102,2,4,65,61
35,102,3,3,75,72
35,102,4,1,72,71
35,102,5,2,63,61
35,102,6,3,62,59
35,103,0,2,43,41
35,103,1,2,51,49
35,103,2,3,46,43
35,103,3,2,59,57
35,103,4,2,40,38
35,103,5,8,52,44
35,103,6,1,73,72
35,104,0,0,35,35
35,104,1,2,41,39
35,104,2,2,36,34
35,104,3,5,67,62
35,104,4,3,60,57
35,104,5,2,38,36
35,104,6,2,76,74
35,105,0,1,44,43
35,105,1,2,68,66
35,105,2,9,83,74
35,105,3,3,76,73
35,105,4,3,60,57
35,105,5,2,54,52
35,105,6,1,49,48
35,106,0,3,49,46
35,106,1,7,61,54
35,106,2,21,67,46
35,106,3,9,73,64
35,106,4,4,52,48
35,106,5,9,65,56
35,106,6,1,47,46
35,107,0,2,59,57
35,107,1,8,71,63
35,107,2,15,64,49
35,107,3,8,92,84
35,107,4,6,74,68
35,107,5,1,50,49
35,107,6,0,35,35
35,108,0,8,87,79
35,108,1,11,104,93
35,108,2,8,87,79
35,108,3,13,97,84
35,108,4,26,99,73
35,108,5,4,61,57
35,108,6,7,55,48
35,109,0,8,98,90
35,109,1,18,103,85
35,109,2,19,104,85
35,109,3,21,86,65
35,109,4,38,100,62
35,109,5,19,77,58
35,109,6,1,44,43
35,110,0,5,77,72
35,110,1,8,84,76
35,110,2,35,117,82
35,110,3,33,118,85
35,110,4,44,102,58
35,110,5,23,68,45
35,110,6,3,37,34
35,111,0,9,96,87
35,111,1,10,85,75
35,111,2,15,85,70
35,111,3,14,107,93
35,111,4,29,88,59
35,111,5,10,48,38
35,111,6,2,40,38
35,112,0,6,53,47
35,112,1,3,69,66
35,112,2,6,68,62
35,112,3,9,79,70
35,112,4,27,85,58
35,112,5,7,42,35
35,112,6,2,20,18
35,113,0,5,54,49
35,113,1,6,64,58
35,113,2,3,73,70
35,113,3,16,76,60
35,113,4,33,91,58
35,113,5,4,39,35
35,113,6,1,24,23
35,114,0,10,57,47
35,114,1,8,47,39
35,114,2,39,88,49
35,114,3,28,87,59
35,114,4,40,76,36
35,114,5,9,38,29
35,114,6,0,22,22
35,115,0,24,59,35
35,115,1,11,60,49
35,115,2,7,56,49
35,115,3,17,57,40
35,115,4,43,74,31
35,115,5,0,25,25
35,115,6,2,21,19
35,116,0,19,51,32
35,116,1,12,64,52
35,116,2,28,72,44
35,116,3,15,63,48
35,116,4,56,106,50
35,116,5,2,37,35
35,116,6,4,33,29
35,117,0,18,64,46
35,117,1,6,44,38
35,117,2,24,78,54
35,117,3,8,70,62
35,117,4,25,59,34
35,117,5,4,30,26
35,117,6,3,34,31
35,118,0,25,49,24
35,118,1,10,57,47
35,118,2,9,47,38
35,118,3,3,28,25
35,118,4,20,41,21
35,118,5,1,25,24
35,118,6,4,33,29
35,119,0,13,54,41
35,119,1,3,52,49
35,119,2,17,71,54
35,119,3,15,52,37
35,119,4,9,43,34
35,119,5,1,28,27
35,119,6,1,24,23
35,120,0,10,63,53
35,120,1,7,62,55
35,120,2,6,50,44
35,120,3,7,67,60
35,120,4,6,50,44
35,120,5,1,25,24
35,120,6,6,31,25
35,121,0,5,34,29
35,121,1,1,44,43
35,121,2,10,62,52
35,121,3,6,57,51
35,121,4,18,54,36
35,121,5,3,29,26
35,121,6,0,23,23
35,122,0,3,40,37
35,122,1,5,49,44
35,122,2,3,52,49
35,122,3,2,42,40
35,122,4,16,65,49
35,122,5,1,28,27
35,122,6,3,21,18
35,123,0,3,44,41
35,123,1,6,50,44
35,123,2,2,48,46
35,123,3,3,46,43
35,123,4,11,42,31
35,123,5,0,15,15
35,123,6,2,22,20
35,124,0,9,51,42
35,124,1,3,41,38
35,124,2,3,51,48
35,124,3,8,59,51
35,124,4,1,36,35
35,124,5,0,18,18
35,124,6,1,15,14
35,125,0,5,42,37
35,125,1,2,41,39
35,125,2,4,45,41
35,125,3,7,46,39
35,125,4,5,34,29
35,125,5,1,26,25
35,125,6,3,31,28
35,126,0,14,61,47
35,126,1,13,62,49
35,126,2,24,83,59
35,126,3,6,46,40
35,126,4,2,46,44
35,126,5,0,31,31
35,126,6,1,20,19
35,127,0,21,69,48
35,127,1,34,78,44
35,127,2,47,84,37
35,127,3,12,43,31
35,127,4,3,33,30
35,127,5,0,21,21
35,127,6,5,23,18
35,128,0,30,64,34
35,128,1,32,52,20
35,128,2,21,69,48
35,128,3,19,49,30
35,128,4,10,46,36
35,128,5,1,30,29
35,128,6,1,18,17
35,129,0,31,72,41
35,129,1,30,67,37
35,129,2,13,46,33
35,129,3,10,37,27
35,129,4,7,44,37
35,129,5,1,18,17
35,129,6,0,18,18
35,130,0,22,66,44
35,130,1,24,64,40
35,130,2,9,46,37
35,130,3,4,33,29
35,130,4,2,37,35
35,130,5,0,20,20
35,130,6,2,24,22
35,131,0,4,37,33
35,131,1,7,38,31
35,131,2,10,43,33
35,131,3,6,32,26
35,131,4,4,28,24
35,131,5,1,21,20
35,131,6,1,14,13
35,132,0,1,23,22
35,132,1,3,35,32
35,132,2,13,50,37
35,132,3,4,36,32
35,132,4,4,31,27
35,132,5,1,19,18
35,132,6,1,15,14
35,133,0,0,27,27
35,133,1,5,42,37
35,133,2,3,32,29
35,133,3,2,23,21
35,133,4,1,27,26
35,133,5,1,17,16
35,133,6,2,24,22
35,134,0,0,19,19
35,134,1,2,22,20
35,134,2,1,18,17
35,134,3,3,22,19
35,134,4,1,23,22
35,134,5,1,18,17
35,134,6,0,20,20
35,135,0,0,24,24
35,135,1,1,23,22
35,135,2,1,24,23
35,135,3,0,21,21
35,135,4,2,20,18
35,135,5,0,18,18
35,135,6,1,16,15
35,136,0,3,28,25
35,136,1,3,25,22
35,136,2,1,21,20
35,136,3,2,35,33
35,136,4,3,20,17
35,136,5,0,17,17
35,136,6,2,16,14
35,137,0,2,24,22
35,137,1,0,23,23
35,137,2,1,23,22
35,137,3,0,27,27
35,137,4,2,23,21
35,137,5,0,12,12
35,137,6,1,20,19
35,138,0,4,28,24
35,138,1,0,27,27
35,138,2,5,24,19
35,138,3,0,12,12
35,138,4,3,16,13
35,138,5,0,18,18
35,138,6,5,20,15
35,139,0,2,12,10
35,139,1,0,16,16
35,139,2,0,18,18
35,139,3,0,13,13
35,139,4,0,5,5
35,139,5,1,13,12
35,139,6,1,13,12
35,140,0,0,15,15
35,140,1,1,7,6
35,140,2,2,12,10
35,140,3,0,7,7
35,140,4,0,7,7
35,140,5,6,31,25
35,140,6,1,8,7
35,141,0,1,9,8
35,141,1,2,11,9
35,141,2,0,16,16
35,141,3,0,7,7
35,141,4,1,12,11
35,141,5,0,11,11
35,141,6,0,7,7
35,142,0,1,6,5
35,142,1,4,20,16
35,142,2,0,9,9
35,142,3,1,11,10
35,142,4,0,7,7
35,142,5,0,3,3
35,142,6,1,12,11
35,143,0,3,10,7
35,143,1,1,9,8
35,143,2,3,10,7
35,143,3,2,8,6
35,143,4,1,11,10
35,143,5,2,15,13
35,143,6,2,8,6
36,0,0,0,9,9
36,0,1,8,26,18
36,0,2,1,13,12
36,0,3,1,6,5
36,0,4,2,19,17
36,0,5,1,12,11
36,0,6,2,19,17
36,1,0,3,12,9
36,1,1,3,8,5
36,1,2,5,15,10
36,1,3,1,4,3
36,1,4,0,16,16
36,1,5,0,7,7
36,1,6,3,13,10
36,2,0,1,8,7
36,2,1,0,9,9
36,2,2,14,30,16
36,2,3,0,2,2
36,2,4,0,12,12
36,2,5,0,9,9
36,2,6,1,8,7
36,3,0,0,6,6
36,3,1,5,11,6
36,3,2,3,8,5
36,3,3,0,5,5
36,3,4,1,21,20
36,3,5,0,6,6
36,3,6,2,14,12
36,4,0,2,8,6
36,4,1,1,5,4
36,4,2,1,8,7
36,4,3,1,9,8
36,4,4,1,10,9
36,4,5,0,5,5
36,4,6,0,5,5
36,5,0,0,2,2
36,5,1,1,8,7
36,5,2,0,5,5
36,5,3,0,1,1
36,5,4,2,14,12
36,5,5,2,10,8
36,5,6,1,4,3
36,6,0,1,7,6
36,6,1,2,5,3
36,6,2,0,3,3
36,6,3,0,5,5
36,6,4,0,10,10
36,6,5,0,7,7
36,6,6,1,8,7
36,7,0,0,7,7
36,7,1,2,10,8
36,7,2,0,4,4
36,7,4,0,10,10
36,7,5,2,13,11
36,7,6,0,5,5
36,8,0,0,3,3
36,8,1,0,6,6
36,8,2,1,5,4
36,8,3,1,8,7
36,8,4,1,8,7
36,8,5,1,6,5
36,8,6,0,4,4
36,9,0,1,8,7
36,9,1,0,1,1
36,9,2,0,6,6
36,9,3,0,4,4
36,9,4,0,5,5
36,9,5,0,5,5
36,9,6,0,1,1
36,10,0,4,8,4
36,10,1,0,6,6
36,10,2,0,1,1
36,10,3,0,3,3
36,10,4,0,11,11
36,10,5,1,9,8
36,10,6,0,2,2
36,11,0,0,1,1
36,11,1,0,2,2
36,11,2,0,5,5
36,11,3,1,4,3
36,11,4,0,13,13
36,11,5,1,4,3
36,11,6,0,2,2
36,12,0,4,8,4
36,12,1,0,9,9
36,12,2,0,5,5
36,12,3,0,2,2
36,12,4,0,7,7
36,12,5,0,1,1
36,12,6,0,2,2
36,13,1,0,2,2
36,13,2,0,3,3
36,13,3,0,1,1
36,13,4,0,4,4
36,13,5,1,9,8
36,13,6,0,2,2
36,14,1,1,2,1
36,14,2,0,2,2
36,14,3,1,4,3
36,14,4,0,2,2
36,14,5,2,6,4
36,15,1,0,1,1
36,15,2,0,2,2
36,15,3,0,3,3
36,15,4,5,14,9
36,15,5,2,4,2
36,16,0,0,2,2
36,16,1,0,3,3
36,16,2,0,1,1
36,16,3,0,3,3
36,16,4,0,3,3
36,16,5,1,7,6
36,16,6,0,3,3
36,17,0,0,2,2
36,17,1,2,3,1
36,17,2,0,3,3
36,17,3,0,2,2
36,17,4,0,5,5
36,17,5,5,11,6
36,17,6,0,3,3
36,18,0,0,3,3
36,18,3,1,3,2
36,18,4,0,3,3
36,18,5,0,1,1
36,18,6,0,2,2
36,19,0,1,5,4
36,19,1,0,2,2
36,19,2,0,4,4
36,19,3,0,2,2
36,19,4,3,6,3
36,19,5,0,2,2
36,19,6,0,4,4
36,20,0,0,7,7
36,20,1,1,1,0
36,20,2,0,1,1
36,20,4,0,2,2
36,20,5,0,3,3
36,20,6,1,3,2
36,21,0,1,3,2
36,21,2,0,1,1
36,21,4,1,6,5
36,21,5,0,3,3
36,21,6,1,3,2
36,22,0,0,1,1
36,22,1,0,2,2
36,22,4,1,3,2
36,22,5,1,6,5
36,22,6,1,2,1
36,23,0,0,1,1
36,23,1,0,1,1
36,23,2,2,2,0
36,23,3,0,1,1
36,23,5,2,3,1
36,23,6,1,4,3
36,24,0,0,3,3
36,24,1,0,3,3
36,24,2,1,1,0
36,24,3,0,1,1
36,24,4,0,2,2
36,24,5,0,1,1
36,25,0,1,1,0
36,25,1,1,2,1
36,25,2,0,1,1
36,25,3,0,1,1
36,25,4,0,1,1
36,25,5,0,1,1
36,25,6,0,2,2
36,26,0,0,1,1
36,26,1,0,1,1
36,26,2,0,2,2
36,26,3,0,2,2
36,26,4,0,1,1
36,26,5,0,2,2
36,26,6,0,1,1
36,27,0,1,2,1
36,27,1,0,1,1
36,27,2,1,2,1
36,27,3,0,4,4
36,27,4,1,1,0
36,27,5,1,2,1
36,27,6,0,1,1
36,28,0,1,1,0
36,28,1,1,2,1
36,28,2,1,3,2
36,28,3,1,2,1
36,28,4,1,3,2
36,28,5,0,1,1
36,28,6,0,2,2
36,29,1,0,1,1
36,29,2,0,2,2
36,29,3,0,3,3
36,29,4,3,7,4
36,29,5,0,2,2
36,30,1,1,1,0
36,30,2,0,3,3
36,30,4,3,6,3
36,30,5,1,2,1
36,30,6,0,2,2
36,31,1,0,1,1
36,31,2,0,1,1
36,31,3,0,1,1
36,31,4,0,2,2
36,31,6,0,2,2
36,32,0,0,2,2
36,32,1,0,1,1
36,32,2,0,1,1
36,32,3,0,3,3
36,32,4,0,2,2
36,32,5,0,1,1
36,33,0,1,4,3
36,33,1,0,3,3
36,33,2,0,2,2
36,33,4,2,6,4
36,33,5,0,1,1
36,33,6,0,1,1
36,34,0,0,3,3
36,34,1,0,3,3
36,34,2,0,5,5
36,34,3,0,3,3
36,34,4,7,8,1
36,34,5,0,2,2
36,34,6,0,2,2
36,35,0,0,3,3
36,35,1,0,3,3
36,35,2,2,8,6
36,35,3,0,2,2
36,35,4,6,8,2
36,35,5,1,3,2
36,35,6,0,1,1
36,36,0,9,19,10
36,36,1,0,3,3
36,36,2,2,8,6
36,36,3,2,8,6
36,36,4,11,18,7
36,36,5,1,7,6
36,36,6,1,5,4
36,37,0,3,10,7
36,37,1,2,9,7
36,37,2,4,7,3
36,37,3,1,3,2
36,37,4,18,26,8
36,37,5,6,12,6
36,37,6,4,13,9
36,38,0,3,13,10
36,38,1,4,14,10
36,38,2,3,13,10
36,38,3,6,15,9
36,38,4,12,16,4
36,38,5,3,13,10
36,38,6,4,12,8
36,39,0,1,18,17
36,39,1,0,13,13
36,39,2,1,20,19
36,39,3,0,13,13
36,39,4,20,38,18
36,39,5,3,23,20
36,39,6,3,14,11
36,40,0,0,20,20
36,40,1,0,16,16
36,40,2,0,15,15
36,40,3,1,14,13
36,40,4,37,50,13
36,40,5,1,24,23
36,40,6,1,16,15
36,41,0,1,28,27
36,41,1,0,27,27
36,41,2,2,25,23
36,41,3,1,27,26
36,41,4,36,76,40
36,41,5,0,24,24
36,41,6,2,25,23
36,42,0,2,47,45
36,42,1,1,44,43
36,42,2,0,36,36
36,42,3,3,38,35
36,42,4,8,44,36
36,42,5,0,40,40
36,42,6,1,33,32
36,43,0,1,54,53
36,43,1,3,66,63
36,43,2,2,58,56
36,43,3,1,50,49
36,43,4,3,50,47
36,43,5,2,38,36
36,43,6,0,23,23
36,44,0,3,93,90
36,44,1,2,85,83
36,44,2,0,74,74
36,44,3,4,77,73
36,44,4,2,79,77
36,44,5,0,47,47
36,44,6,1,40,39
36,45,0,2,95,93
36,45,1,4,123,119
36,45,2,4,132,128
36,45,3,3,120,117
36,45,4,2,83,81
36,45,5,0,70,70
36,45,6,0,33,33
36,46,0,6,158,152
36,46,1,4,143,139
36,46,2,2,137,135
36,46,3,5,127,122
36,46,4,4,108,104
36,46,5,1,68,67
36,46,6,2,49,47
36,47,0,4,127,123
36,47,1,9,147,138
36,47,2,3,135,132
36,47,3,6,159,153
36,47,4,2,117,115
36,47,5,0,83,83
36,47,6,0,73,73
36,48,0,25,222,197
36,48,1,2,173,171
36,48,2,16,224,208
36,48,3,34,214,180
36,48,4,6,139,133
36,48,5,5,144,139
36,48,6,0,89,89
36,49,0,39,200,161
36,49,1,9,166,157
36,49,2,81,247,166
36,49,3,30,193,163
36,49,4,8,142,134
36,49,5,8,153,145
36,49,6,2,95,93
36,50,0,39,149,110
36,50,1,13,140,127
36,50,2,28,156,128
36,50,3,29,158,129
36,50,4,10,117,107
36,50,5,9,128,119
36,50,6,4,88,84
36,51,0,28,129,101
36,51,1,8,129,121
36,51,2,11,155,144
36,51,3,17,135,118
36,51,4,4,125,121
36,51,5,16,145,129
36,51,6,6,124,118
36,52,0,39,151,112
36,52,1,28,162,134
36,52,2,17,143,126
36,52,3,18,134,116
36,52,4,4,124,120
36,52,5,49,206,157
36,52,6,8,109,101
36,53,0,21,135,114
36,53,1,13,137,124
36,53,2,4,90,86
36,53,3,6,127,121
36,53,4,7,130,123
36,53,5,15,159,144
36,53,6,5,79,74
36,54,0,2,109,107
36,54,1,3,113,110
36,54,2,1,75,74
36,54,3,5,79,74
36,54,4,5,118,113
36,54,5,0,90,90
36,54,6,1,79,78
36,55,0,10,100,90
36,55,1,1,85,84
36,55,2,2,117,115
36,55,3,4,98,94
36,55,4,5,132,127
36,55,5,4,94,90
36,55,6,1,83,82
36,56,0,2,109,107
36,56,1,1,57,56
36,56,2,6,128,122
36,56,3,4,86,82
36,56,4,1,99,98
36,56,5,3,81,78
36,56,6,1,96,95
36,57,0,2,86,84
36,57,1,1,88,87
36,57,2,1,100,99
36,57,3,9,95,86
36,57,4,8,128,120
36,57,5,1,114,113
36,57,6,4,95,91
36,58,0,3,90,87
36,58,1,2,82,80
36,58,2,4,114,110
36,58,3,3,107,104
36,58,4,2,106,104
36,58,5,1,87,86
36,58,6,2,105,103
36,59,0,1,83,82
36,59,1,1,82,81
36,59,2,8,161,153
36,59,3,2,89,87
36,59,4,3,91,88
36,59,5,1,84,83
36,59,6,1,74,73
36,60,0,1,86,85
36,60,1,4,74,70
36,60,2,1,101,100
36,60,3,3,87,84
36,60,4,6,87,81
36,60,5,5,76,71
36,60,6,2,77,75
36,61,0,0,84,84
36,61,1,0,64,64
36,61,2,3,101,98
36,61,3,4,75,71
36,61,4,3,89,86
36,61,5,3,97,94
36,61,6,0,91,91
36,62,0,2,85,83
36,62,1,3,70,67
36,62,2,2,57,55
36,62,3,1,39,38
36,62,4,0,98,98
36,62,5,2,85,83
36,62,6,4,82,78
36,63,0,0,88,88
36,63,1,2,58,56
36,63,2,4,57,53
36,63,3,1,52,51
36,63,4,2,85,83
36,63,5,2,81,79
36,63,6,1,62,61
36,64,0,2,73,71
36,64,1,9,74,65
36,64,2,4,63,59
36,64,3,1,64,63
36,64,4,6,78,72
36,64,5,1,83,82
36,64,6,7,92,85
36,65,0,2,66,64
36,65,1,4,64,60
36,65,2,3,76,73
36,65,3,1,54,53
36,65,4,1,61,60
36,65,5,1,72,71
36,65,6,5,84,79
36,66,0,1,107,106
36,66,1,1,47,46
36,66,2,2,86,84
36,66,3,7,90,83
36,66,4,5,142,137
36,66,5,3,137,134
36,66,6,4,97,93
36,67,0,8,93,85
36,67,1,1,71,70
36,67,2,4,94,90
36,67,3,7,87,80
36,67,4,7,115,108
36,67,5,3,99,96
36,67,6,7,145,138
36,68,0,4,72,68
36,68,1,2,52,50
36,68,2,4,94,90
36,68,3,1,67,66
36,68,4,7,94,87
36,68,5,1,94,93
36,68,6,3,108,105
36,69,0,0,83,83
36,69,1,3,73,70
36,69,2,3,61,58
36,69,3,4,60,56
36,69,4,10,105,95
36,69,5,5,82,77
36,69,6,12,99,87
36,70,0,1,80,79
36,70,1,3,81,78
36,70,2,4,56,52
36,70,3,2,73,71
36,70,4,8,115,107
36,70,5,2,85,83
36,70,6,5,104,99
36,71,0,1,71,70
36,71,1,3,62,59
36,71,2,2,68,66
36,71,3,4,78,74
36,71,4,10,104,94
36,71,5,4,75,71
36,71,6,4,91,87
36,72,0,3,69,66
36,72,1,2,61,59
36,72,2,2,71,69
36,72,3,0,47,47
36,72,4,7,108,101
36,72,5,2,83,81
36,72,6,4,106,102
36,73,0,3,79,76
36,73,1,8,66,58
36,73,2,3,60,57
36,73,3,4,67,63
36,73,4,8,86,78
36,73,5,2,70,68
36,73,6,3,73,70
36,74,0,1,73,72
36,74,1,3,59,56
36,74,2,1,60,59
36,74,3,4,57,53
36,74,4,10,89,79
36,74,5,4,82,78
36,74,6,2,89,87
36,75,0,1,69,68
36,75,1,1,66,65
36,75,2,1,72,71
36,75,3,1,65,64
36,75,4,10,93,83
36,75,5,6,106,100
36,75,6,1,96,95
36,76,0,1,72,71
36,76,1,3,64,61
36,76,2,3,84,81
36,76,3,3,73,70
36,76,4,4,73,69
36,76,5,2,105,103
36,76,6,6,87,81
36,77,0,4,104,100
36,77,1,4,78,74
36,77,2,2,93,91
36,77,3,4,109,105
36,77,4,6,99,93
36,77,5,2,97,95
36,77,6,2,96,94
36,78,0,5,110,105
36,78,1,8,93,85
36,78,2,1,103,102
36,78,3,8,106,98
36,78,4,7,110,103
36,78,5,3,126,123
36,78,6,7,103,96
36,79,0,3,97,94
36,79,1,4,88,84
36,79,2,1,76,75
36,79,3,3,81,78
36,79,4,14,129,115
36,79,5,3,122,119
36,79,6,1,98,97
36,80,0,4,81,77
36,80,1,2,85,83
36,80,2,2,75,73
36,80,3,5,108,103
36,80,4,1,90,89
36,80,5,3,93,90
36,80,6,8,112,104
36,81,0,2,80,78
36,81,1,2,70,68
36,81,2,4,71,67
36,81,3,9,91,82
36,81,4,3,91,88
36,81,5,5,96,91
36,81,6,9,115,106
36,82,0,0,86,86
36,82,1,4,85,81
36,82,2,5,118,113
36,82,3,11,125,114
36,82,4,6,95,89
36,82,5,3,107,104
36,82,6,10,169,159
36,83,0,9,81,72
36,83,1,4,76,72
36,83,2,1,83,82
36,83,3,2,81,79
36,83,4,7,120,113
36,83,5,2,109,107
36,83,6,6,143,137
36,84,0,0,65,65
36,84,1,5,63,58
36,84,2,1,57,56
36,84,3,4,80,76
36,84,4,2,75,73
36,84,5,4,112,108
36,84,6,4,110,106
36,85,0,3,72,69
36,85,1,1,66,65
36,85,2,1,70,69
36,85,3,3,58,55
36,85,4,4,70,66
36,85,5,2,83,81
36,85,6,2,99,97
36,86,0,1,86,85
36,86,1,4,62,58
36,86,2,3,50,47
36,86,3,6,73,67
36,86,4,4,82,78
36,86,5,0,95,95
36,86,6,4,109,105
36,87,0,0,75,75
36,87,1,2,47,45
36,87,2,2,76,74
36,87,3,7,72,65
36,87,4,11,86,75
36,87,5,2,100,98
36,87,6,4,113,109
36,88,0,2,61,59
36,88,1,2,68,66
36,88,2,2,65,63
36,88,3,5,70,65
36,88,4,4,75,71
36,88,5,3,100,97
36,88,6,2,118,116
36,89,0,1,91,90
36,89,1,2,60,58
36,89,2,1,56,55
36,89,3,7,60,53
36,89,4,4,102,98
36,89,5,3,87,84
36,89,6,4,102,98
36,90,0,3,65,62
36,90,1,5,62,57
36,90,2,5,57,52
36,90,3,2,55,53
36,90,4,1,81,80
36,90,5,6,77,71
36,90,6,2,80,78
36,91,0,3,74,71
36,91,1,3,74,71
36,91,2,9,77,68
36,91,3,7,47,40
36,91,4,9,83,74
36,91,5,3,66,63
36,91,6,3,96,93
36,92,0,5,72,67
36,92,1,3,49,46
36,92,2,16,71,55
36,92,3,1,41,40
36,92,4,6,84,78
36,92,5,3,83,80
36,92,6,4,76,72
36,93,0,3,91,88
36,93,1,4,46,42
36,93,2,5,119,114
36,93,3,8,123,115
36,93,4,5,134,129
36,93,5,4,113,109
36,93,6,10,171,161
36,94,0,1,77,76
36,94,1,0,71,71
36,94,2,4,62,58
36,94,3,6,96,90
36,94,4,3,84,81
36,94,5,9,100,91
36,94,6,3,102,99
36,95,0,2,61,59
36,95,1,1,45,44
36,95,2,2,58,56
36,95,3,4,71,67
36,95,4,3,93,90
36,95,5,1,57,56
36,95,6,3,89,86
36,96,0,1,69,68
36,96,1,6,63,57
36,96,2,10,77,67
36,96,3,6,85,79
36,96,4,0,91,91
36,96,5,3,81,78
36,96,6,3,88,85
36,97,0,3,58,55
36,97,1,7,73,66
36,97,2,0,66,66
36,97,3,2,72,70
36,97,4,1,76,75
36,97,5,0,86,86
36,97,6,0,82,82
36,98,0,3,58,55
36,98,1,5,73,68
36,98,2,1,76,75
36,98,3,3,71,68
36,98,4,3,90,87
36,98,5,5,84,79
36,98,6,0,77,77
36,99,0,5,76,71
36,99,1,1,79,78
36,99,2,5,90,85
36,99,3,1,80,79
36,99,4,1,93,92
36,99,5,2,62,60
36,99,6,1,82,81
36,100,0,0,73,73
36,100,1,0,77,77
36,100,2,3,52,49
36,100,3,14,79,65
36,100,4,6,75,69
36,100,5,8,86,78
36,100,6,4,72,68
36,101,0,4,94,90
36,101,1,15,91,76
36,101,2,3,75,72
36,101,3,7,85,78
36,101,4,1,85,84
36,101,5,4,91,87
36,101,6,3,77,74
36,102,0,9,143,134
36,102,1,4,150,146
36,102,2,1,141,140
36,102,3,4,129,125
36,102,4,1,115,114
36,102,5,3,107,104
36,102,6,4,98,94
36,103,0,2,106,104
36,103,1,6,129,123
36,103,2,4,119,115
36,103,3,5,116,111
36,103,4,3,132,129
36,103,5,6,96,90
36,103,6,6,95,89
36,104,0,0,100,100
36,104,1,3,102,99
36,104,2,2,112,110
36,104,3,2,109,107
36,104,4,2,111,109
36,104,5,1,97,96
36,104,6,0,86,86
36,105,0,5,113,108
36,105,1,2,117,115
36,105,2,2,121,119
36,105,3,2,129,127
36,105,4,6,135,129
36,105,5,3,147,144
36,105,6,2,92,90
36,106,0,2,141,139
36,106,1,5,122,117
36,106,2,5,119,114
36,106,3,2,123,121
36,106,4,4,141,137
36,106,5,0,109,109
36,106,6,10,116,106
36,107,0,7,103,96
36,107,1,0,78,78
36,107,2,3,111,108
36,107,3,2,108,106
36,107,4,3,96,93
36,107,5,1,111,110
36,107,6,6,97,91
36,108,0,4,92,88
36,108,1,4,106,102
36,108,2,11,113,102
36,108,3,5,105,100
36,108,4,6,123,117
36,108,5,9,95,86
36,108,6,2,96,94
36,109,0,9,100,91
36,109,1,6,90,84
36,109,2,2,92,90
36,109,3,1,90,89
36,109,4,3,100,97
36,109,5,4,57,53
36,109,6,1,78,77
36,110,0,1,96,95
36,110,1,1,79,78
36,110,2,1,71,70
36,110,3,10,104,94
36,110,4,3,96,93
36,110,5,3,78,75
36,110,6,5,71,66
36,111,0,2,98,96
36,111,1,5,80,75
36,111,2,1,71,70
36,111,3,5,77,72
36,111,4,3,75,72
36,111,5,2,84,82
36,111,6,0,66,66
36,112,0,2,66,64
36,112,1,4,75,71
36,112,2,2,70,68
36,112,3,11,79,68
36,112,4,5,96,91
36,112,5,4,78,74
36,112,6,2,78,76
36,113,0,2,59,57
36,113,1,0,68,68
36,113,2,3,67,64
36,113,3,4,61,57
36,113,4,2,77,75
36,113,5,1,68,67
36,113,6,6,73,67
36,114,0,2,63,61
36,114,1,0,56,56
36,114,2,5,71,66
36,114,3,2,60,58
36,114,4,4,88,84
36,114,5,4,53,49
36,114,6,6,65,59
36,115,0,7,73,66
36,115,1,4,61,57
36,115,2,0,60,60
36,115,3,4,48,44
36,115,4,4,81,77
36,115,5,2,58,56
36,115,6,1,66,65
36,116,0,8,86,78
36,116,1,2,56,54
36,116,2,3,59,56
36,116,3,2,51,49
36,116,4,1,60,59
36,116,5,1,47,46
36,116,6,3,66,63
36,117,0,2,63,61
36,117,1,0,74,74
36,117,2,3,65,62
36,117,3,1,64,63
36,117,4,1,63,62
36,117,5,1,50,49
36,117,6,3,74,71
36,118,0,2,72,70
36,118,1,1,57,56
36,118,2,2,59,57
36,118,3,2,62,60
36,118,4,1,63,62
36,118,5,1,59,58
36,118,6,4,51,47
36,119,0,2,68,66
36,119,1,1,60,59
36,119,2,2,61,59
36,119,3,6,86,80
36,119,4,0,64,64
36,119,5,0,48,48
36,119,6,4,52,48
36,120,0,0,89,89
36,120,1,2,96,94
36,120,2,3,82,79
36,120,3,6,95,89
36,120,4,0,73,73
36,120,5,1,82,81
36,120,6,1,62,61
36,121,0,0,64,64
36,121,1,2,71,69
36,121,2,1,66,65
36,121,3,3,69,66
36,121,4,4,61,57
36,121,5,4,63,59
36,121,6,4,60,56
36,122,0,1,55,54
36,122,1,2,64,62
36,122,2,3,58,55
36,122,3,3,50,47
36,122,4,5,57,52
36,122,5,2,49,47
36,122,6,0,36,36
36,123,0,1,51,50
36,123,1,2,59,57
36,123,2,2,67,65
36,123,3,2,69,67
36,123,4,3,64,61
36,123,5,1,46,45
36,123,6,4,45,41
36,124,0,1,46,45
36,124,1,3,51,48
36,124,2,3,45,42
36,124,3,1,44,43
36,124,4,0,47,47
36,124,5,0,53,53
36,124,6,2,49,47
36,125,0,0,53,53
36,125,1,1,43,42
36,125,2,1,53,52
36,125,3,2,57,55
36,125,4,1,45,44
36,125,5,3,51,48
36,125,6,1,34,33
36,126,0,4,53,49
36,126,1,1,60,59
36,126,2,3,53,50
36,126,3,3,39,36
36,126,4,0,52,52
36,126,5,1,58,57
36,126,6,3,53,50
36,127,0,1,49,48
36,127,1,7,48,41
36,127,2,0,49,49
36,127,3,4,46,42
36,127,4,3,53,50
36,127,5,1,36,35
36,127,6,0,37,37
36,128,0,1,37,36
36,128,1,5,51,46
36,128,2,0,52,52
36,128,3,1,36,35
36,128,4,1,46,45
36,128,5,1,35,34
36,128,6,1,41,40
36,129,0,0,35,35
36,129,1,2,33,31
36,129,2,2,42,40
36,129,3,4,40,36
36,129,4,1,52,51
36,129,5,3,52,49
36,129,6,2,48,46
36,130,0,2,38,36
36,130,1,3,51,48
36,130,2,1,42,41
36,130,3,1,33,32
36,130,4,1,50,49
36,130,5,1,42,41
36,130,6,2,27,25
36,131,0,0,30,30
36,131,1,1,30,29
36,131,2,0,37,37
36,131,3,3,38,35
36,131,4,2,35,33
36,131,5,2,48,46
36,131,6,2,32,30
36,132,0,3,38,35
36,132,1,1,33,32
36,132,2,1,40,39
36,132,3,0,24,24
36,132,4,2,41,39
36,132,5,4,41,37
36,132,6,0,30,30
36,133,0,2,32,30
36,133,1,0,32,32
36,133,2,3,32,29
36,133,3,2,38,36
36,133,4,0,31,31
36,133,5,7,45,38
36,133,6,2,35,33
36,134,0,1,25,24
36,134,1,1,30,29
36,134,2,5,38,33
36,134,3,13,45,32
36,134,4,2,38,36
36,134,5,2,39,37
36,134,6,0,30,30
36,135,0,3,22,19
36,135,1,0,22,22
36,135,2,5,23,18
36,135,3,5,36,31
36,135,4,1,32,31
36,135,5,2,37,35
36,135,6,2,23,21
36,136,0,3,44,41
36,136,1,1,25,24
36,136,2,1,23,22
36,136,3,1,30,29
36,136,4,4,31,27
36,136,5,0,28,28
36,136,6,0,14,14
36,137,0,2,25,23
36,137,1,0,32,32
36,137,2,1,31,30
36,137,3,1,21,20
36,137,4,1,22,21
36,137,5,1,23,22
36,137,6,3,29,26
36,138,0,2,28,26
36,138,1,2,17,15
36,138,2,4,28,24
36,138,3,2,23,21
36,138,4,2,20,18
36,138,5,4,22,18
36,138,6,2,18,16
36,139,0,2,24,22
36,139,1,2,13,11
36,139,2,5,24,19
36,139,3,1,11,10
36,139,4,3,11,8
36,139,5,2,11,9
36,139,6,8,19,11
36,140,0,5,22,17
36,140,1,4,16,12
36,140,2,3,10,7
36,140,3,1,18,17
36,140,4,0,12,12
36,140,5,1,13,12
36,140,6,2,13,11
36,141,0,2,13,11
36,141,1,1,14,13
36,141,2,2,13,11
36,141,3,0,13,13
36,141,4,0,17,17
36,141,5,0,11,11
36,141,6,0,13,13
36,142,0,2,20,18
36,142,1,0,12,12
36,142,2,1,9,8
36,142,3,2,13,11
36,142,4,0,12,12
36,142,5,2,8,6
36,142,6,3,11,8
36,143,0,3,17,14
36,143,1,0,14,14
36,143,2,1,10,9
36,143,3,1,15,14
36,143,4,1,12,11
36,143,5,0,10,10
36,143,6,0,14,14
37,0,0,7,134,127
37,0,1,6,130,124
37,0,2,11,134,123
37,0,3,16,149,133
37,0,4,7,180,173
37,0,5,4,151,147
37,0,6,11,187,176
37,1,0,8,127,119
37,1,1,6,90,84
37,1,2,9,94,85
37,1,3,4,107,103
37,1,4,60,292,232
37,1,5,7,139,132
37,1,6,12,143,131
37,2,0,9,100,91
37,2,1,2,77,75
37,2,2,4,83,79
37,2,3,1,90,89
37,2,4,99,294,195
37,2,5,1,108,107
37,2,6,9,154,145
37,3,0,5,62,57
37,3,1,7,73,66
37,3,2,3,83,80
37,3,3,3,94,91
37,3,4,140,357,217
37,3,5,4,97,93
37,3,6,5,93,88
37,4,0,2,91,89
37,4,1,6,72,66
37,4,2,9,79,70
37,4,3,3,69,66
37,4,4,96,275,179
37,4,5,6,105,99
37,4,6,5,117,112
37,5,0,2,72,70
37,5,1,3,67,64
37,5,2,6,67,61
37,5,3,9,88,79
37,5,4,26,205,179
37,5,5,2,81,79
37,5,6,5,94,89
37,6,0,5,65,60
37,6,1,4,82,78
37,6,2,1,53,52
37,6,3,3,59,56
37,6,4,9,173,164
37,6,5,1,83,82
37,6,6,4,101,97
37,7,0,1,44,43
37,7,1,0,53,53
37,7,2,6,63,57
37,7,3,5,57,52
37,7,4,3,135,132
37,7,5,6,75,69
37,7,6,2,78,76
37,8,0,1,55,54
37,8,1,1,41,40
37,8,2,3,57,54
37,8,3,2,45,43
37,8,4,4,110,106
37,8,5,2,61,59
37,8,6,3,74,71
37,9,0,4,56,52
37,9,1,1,50,49
37,9,2,4,47,43
37,9,3,3,37,34
37,9,4,7,124,117
37,9,5,4,61,57
37,9,6,1,54,53
37,10,0,4,40,36
37,10,1,1,38,37
37,10,2,5,32,27
37,10,3,3,42,39
37,10,4,8,93,85
37,10,5,6,57,51
37,10,6,2,54,52
37,11,0,5,43,38
37,11,1,1,35,34
37,11,2,2,36,34
37,11,3,5,41,36
37,11,4,8,69,61
37,11,5,4,54,50
37,11,6,3,57,54
37,12,0,10,62,52
37,12,1,1,29,28
37,12,2,3,36,33
37,12,3,8,55,47
37,12,4,5,71,66
37,12,5,7,62,55
37,12,6,3,59,56
37,13,0,1,37,36
37,13,1,5,41,36
37,13,2,4,21,17
37,13,3,5,29,24
37,13,4,4,67,63
37,13,5,36,95,59
37,13,6,3,47,44
37,14,0,1,31,30
37,14,1,5,37,32
37,14,2,3,28,25
37,14,3,3,36,33
37,14,4,1,49,48
37,14,5,28,72,44
37,14,6,1,36,35
37,15,0,3,20,17
37,15,1,2,31,29
37,15,2,2,21,19
37,15,3,0,22,22
37,15,4,2,55,53
37,15,5,9,57,48
37,15,6,2,45,43
37,16,0,1,21,20
37,16,1,1,27,26
37,16,2,1,20,19
37,16,3,1,28,27
37,16,4,3,51,48
37,16,5,3,40,37
37,16,6,4,38,34
37,17,0,2,27,25
37,17,1,0,15,15
37,17,2,1,30,29
37,17,3,4,25,21
37,17,4,4,45,41
37,17,5,1,22,21
37,17,6,3,22,19
37,18,0,2,24,22
37,18,1,0,21,21
37,18,2,2,25,23
37,18,3,2,19,17
37,18,4,7,42,35
37,18,5,1,21,20
37,18,6,4,27,23
37,19,0,2,24,22
37,19,1,0,16,16
37,19,2,2,23,21
37,19,3,1,14,13
37,19,4,9,34,25
37,19,5,2,20,18
37,19,6,4,29,25
37,20,0,3,26,23
37,20,1,0,20,20
37,20,2,1,19,18
37,20,3,4,19,15
37,20,4,8,45,37
37,20,5,1,21,20
37,20,6,1,24,23
37,21,0,1,14,13
37,21,1,0,15,15
37,21,2,0,19,19
37,21,3,4,25,21
37,21,4,18,44,26
37,21,5,1,15,14
37,21,6,1,19,18
37,22,0,0,14,14
37,22,1,1,17,16
37,22,2,1,8,7
37,22,3,4,18,14
37,22,4,8,26,18
37,22,5,2,22,20
37,22,6,0,17,17
37,23,0,1,10,9
37,23,1,0,17,17
37,23,2,4,21,17
37,23,3,3,19,16
37,23,4,5,26,21
37,23,5,0,14,14
37,23,6,0,17,17
37,24,0,1,14,13
37,24,1,2,17,15
37,24,2,3,13,10
37,24,3,0,15,15
37,24,4,8,32,24
37,24,5,1,17,16
37,24,6,1,20,19
37,25,0,0,10,10
37,25,1,5,19,14
37,25,2,1,12,11
37,25,3,1,14,13
37,25,4,6,23,17
37,25,5,1,17,16
37,25,6,2,22,20
37,26,0,0,8,8
37,26,1,4,15,11
37,26,2,2,14,12
37,26,3,5,18,13
37,26,4,4,23,19
37,26,5,0,10,10
37,26,6,4,17,13
37,27,0,0,8,8
37,27,1,0,13,13
37,27,2,0,11,11
37,27,3,4,14,10
37,27,4,7,29,22
37,27,5,1,15,14
37,27,6,0,15,15
37,28,0,1,18,17
37,28,1,1,9,8
37,28,2,1,12,11
37,28,3,1,12,11
37,28,4,16,33,17
37,28,5,2,20,18
37,28,6,0,15,15
37,29,0,6,20,14
37,29,1,3,13,10
37,29,2,3,16,13
37,29,3,2,10,8
37,29,4,15,32,17
37,29,5,3,19,16
37,29,6,0,16,16
37,30,0,8,23,15
37,30,1,5,13,8
37,30,2,2,18,16
37,30,3,2,12,10
37,30,4,9,23,14
37,30,5,1,12,11
37,30,6,3,13,10
37,31,0,3,18,15
37,31,1,2,15,13
37,31,2,1,10,9
37,31,3,4,21,17
37,31,4,16,28,12
37,31,5,3,22,19
37,31,6,8,14,6
37,32,0,3,17,14
37,32,1,14,31,17
37,32,2,3,15,12
37,32,3,13,24,11
37,32,4,35,48,13
37,32,5,6,18,12
37,32,6,6,18,12
37,33,0,16,27,11
37,33,1,2,8,6
37,33,2,6,19,13
37,33,3,6,19,13
37,33,4,52,71,19
37,33,5,1,19,18
37,33,6,5,23,18
37,34,0,16,33,17
37,34,1,3,13,10
37,34,2,4,19,15
37,34,3,11,30,19
37,34,4,66,82,16
37,34,5,7,24,17
37,34,6,3,19,16
37,35,0,25,41,16
37,35,1,8,21,13
37,35,2,7,23,16
37,35,3,10,22,12
37,35,4,80,103,23
37,35,5,15,30,15
37,35,6,10,30,20
37,36,0,35,50,15
37,36,1,20,39,19
37,36,2,26,40,14
37,36,3,18,34,16
37,36,4,124,140,16
37,36,5,21,46,25
37,36,6,28,50,22
37,37,0,31,53,22
37,37,1,43,70,27
37,37,2,32,46,14
37,37,3,28,50,22
37,37,4,146,164,18
37,37,5,24,39,15
37,37,6,13,32,19
37,38,0,35,62,27
37,38,1,35,68,33
37,38,2,39,68,29
37,38,3,25,41,16
37,38,4,155,196,41
37,38,5,28,55,27
37,38,6,23,39,16
37,39,0,13,166,153
37,39,1,8,156,148
37,39,2,10,133,123
37,39,3,4,133,129
37,39,4,159,262,103
37,39,5,14,76,62
37,39,6,17,64,47
37,40,0,14,195,181
37,40,1,7,146,139
37,40,2,8,180,172
37,40,3,9,147,138
37,40,4,188,305,117
37,40,5,23,89,66
37,40,6,14,67,53
37,41,0,47,247,200
37,41,1,14,192,178
37,41,2,12,215,203
37,41,3,12,189,177
37,41,4,176,319,143
37,41,5,63,146,83
37,41,6,23,80,57
37,42,0,85,379,294
37,42,1,14,304,290
37,42,2,20,286,266
37,42,3,17,264,247
37,42,4,252,435,183
37,42,5,52,165,113
37,42,6,28,122,94
37,43,0,179,530,351
37,43,1,45,353,308
37,43,2,51,399,348
37,43,3,71,388,317
37,43,4,251,523,272
37,43,5,49,165,116
37,43,6,58,159,101
37,44,0,399,760,361
37,44,1,155,527,372
37,44,2,122,575,453
37,44,3,170,553,383
37,44,4,246,540,294
37,44,5,86,259,173
37,44,6,81,209,128
37,45,0,544,930,386
37,45,1,300,727,427
37,45,2,285,742,457
37,45,3,347,817,470
37,45,4,349,698,349
37,45,5,83,283,200
37,45,6,96,222,126
37,46,0,636,1063,427
37,46,1,475,929,454
37,46,2,490,969,479
37,46,3,333,825,492
37,46,4,493,867,374
37,46,5,138,352,214
37,46,6,105,260,155
37,47,0,830,1279,449
37,47,1,905,1385,480
37,47,2,740,1223,483
37,47,3,549,1103,554
37,47,4,748,1112,364
37,47,5,249,497,248
37,47,6,144,335,191
37,48,0,1006,1431,425
37,48,1,1213,1714,501
37,48,2,853,1326,473
37,48,3,633,1130,497
37,48,4,902,1287,385
37,48,5,378,689,311
37,48,6,137,372,235
37,49,0,987,1419,432
37,49,1,1034,1520,486
37,49,2,833,1316,483
37,49,3,690,1214,524
37,49,4,689,1068,379
37,49,5,334,677,343
37,49,6,206,435,229
37,50,0,1083,1554,471
37,50,1,1219,1726,507
37,50,2,809,1354,545
37,50,3,612,1135,523
37,50,4,565,989,424
37,50,5,346,704,358
37,50,6,163,433,270
37,51,0,1217,1700,483
37,51,1,1056,1605,549
37,51,2,800,1328,528
37,51,3,708,1267,559
37,51,4,622,1079,457
37,51,5,387,750,363
37,51,6,168,447,279
37,52,0,993,1549,556
37,52,1,954,1521,567
37,52,2,751,1300,549
37,52,3,702,1287,585
37,52,4,492,949,457
37,52,5,348,734,386
37,52,6,175,482,307
37,53,0,723,1380,657
37,53,1,617,1245,628
37,53,2,534,1227,693
37,53,3,426,1211,785
37,53,4,392,940,548
37,53,5,121,470,349
37,53,6,97,404,307
37,54,0,457,1095,638
37,54,1,550,1257,707
37,54,2,263,1093,830
37,54,3,308,1119,811
37,54,4,272,917,645
37,54,5,92,486,394
37,54,6,25,311,286
37,55,0,503,1186,683
37,55,1,730,1432,702
37,55,2,262,1040,778
37,55,3,366,1136,770
37,55,4,317,881,564
37,55,5,95,534,439
37,55,6,26,350,324
37,56,0,367,1053,686
37,56,1,495,1243,748
37,56,2,159,898,739
37,56,3,228,980,752
37,56,4,305,911,606
37,56,5,90,502,412
37,56,6,15,343,328
37,57,0,289,815,526
37,57,1,430,1027,597
37,57,2,231,851,620
37,57,3,360,1007,647
37,57,4,278,764,486
37,57,5,144,541,397
37,57,6,63,397,334
37,58,0,212,728,516
37,58,1,280,749,469
37,58,2,199,733,534
37,58,3,304,843,539
37,58,4,204,597,393
37,58,5,154,504,350
37,58,6,66,436,370
37,59,0,87,527,440
37,59,1,172,664,492
37,59,2,69,541,472
37,59,3,79,602,523
37,59,4,165,534,369
37,59,5,148,505,357
37,59,6,54,404,350
37,60,0,25,430,405
37,60,1,64,458,394
37,60,2,48,437,389
37,60,3,28,485,457
37,60,4,222,564,342
37,60,5,118,459,341
37,60,6,47,401,354
37,61,0,18,387,369
37,61,1,44,407,363
37,61,2,46,434,388
37,61,3,24,394,370
37,61,4,169,459,290
37,61,5,149,497,348
37,61,6,56,407,351
37,62,0,13,350,337
37,62,1,21,358,337
37,62,2,19,371,352
37,62,3,13,364,351
37,62,4,195,494,299
37,62,5,180,578,398
37,62,6,67,424,357
37,63,0,15,304,289
37,63,1,20,328,308
37,63,2,21,353,332
37,63,3,15,345,330
37,63,4,212,508,296
37,63,5,190,532,342
37,63,6,74,407,333
37,64,0,8,296,288
37,64,1,5,275,270
37,64,2,20,327,307
37,64,3,12,320,308
37,64,4,231,497,266
37,64,5,189,545,356
37,64,6,102,444,342
37,65,0,13,299,286
37,65,1,7,273,266
37,65,2,19,318,299
37,65,3,14,294,280
37,65,4,215,503,288
37,65,5,127,457,330
37,65,6,105,413,308
37,66,0,5,280,275
37,66,1,5,256,251
37,66,2,33,314,281
37,66,3,9,286,277
37,66,4,261,551,290
37,66,5,197,552,355
37,66,6,179,477,298
37,67,0,11,276,265
37,67,1,27,310,283
37,67,2,41,283,242
37,67,3,15,287,272
37,67,4,255,529,274
37,67,5,194,519,325
37,67,6,233,539,306
37,68,0,6,273,267
37,68,1,23,303,280
37,68,2,71,355,284
37,68,3,31,340,309
37,68,4,285,573,288
37,68,5,289,655,366
37,68,6,245,586,341
37,69,0,12,316,304
37,69,1,48,366,318
37,69,2,104,373,269
37,69,3,22,353,331
37,69,4,226,547,321
37,69,5,326,677,351
37,69,6,283,640,357
37,70,0,23,337,314
37,70,1,38,324,286
37,70,2,60,350,290
37,70,3,58,397,339
37,70,4,220,501,281
37,70,5,311,677,366
37,70,6,277,629,352
37,71,0,26,299,273
37,71,1,62,341,279
37,71,2,48,340,292
37,71,3,55,368,313
37,71,4,228,488,260
37,71,5,325,670,345
37,71,6,299,631,332
37,72,0,39,364,325
37,72,1,91,392,301
37,72,2,47,369,322
37,72,3,39,380,341
37,72,4,250,569,319
37,72,5,269,629,360
37,72,6,124,541,417
37,73,0,19,320,301
37,73,1,65,323,258
37,73,2,59,379,320
37,73,3,27,349,322
37,73,4,160,471,311
37,73,5,368,747,379
37,73,6,164,582,418
37,74,0,33,381,348
37,74,1,44,348,304
37,74,2,54,360,306
37,74,3,24,361,337
37,74,4,146,441,295
37,74,5,350,753,403
37,74,6,137,554,417
37,75,0,73,383,310
37,75,1,36,350,314
37,75,2,55,376,321
37,75,3,23,366,343
37,75,4,169,478,309
37,75,5,355,786,431
37,75,6,190,612,422
37,76,0,50,366,316
37,76,1,57,380,323
37,76,2,98,466,368
37,76,3,50,419,369
37,76,4,207,490,283
37,76,5,363,779,416
37,76,6,206,631,425
37,77,0,36,360,324
37,77,1,117,440,323
37,77,2,89,426,337
37,77,3,63,414,351
37,77,4,197,533,336
37,77,5,276,645,369
37,77,6,194,656,462
37,78,0,87,409,322
37,78,1,110,435,325
37,78,2,123,480,357
37,78,3,126,480,354
37,78,4,176,510,334
37,78,5,339,698,359
37,78,6,237,689,452
37,79,0,85,391,306
37,79,1,110,426,316
37,79,2,139,469,330
37,79,3,94,434,340
37,79,4,168,472,304
37,79,5,344,760,416
37,79,6,264,697,433
37,80,0,98,421,323
37,80,1,120,427,307
37,80,2,217,524,307
37,80,3,110,439,329
37,80,4,209,488,279
37,80,5,366,748,382
37,80,6,244,699,455
37,81,0,114,451,337
37,81,1,130,429,299
37,81,2,310,637,327
37,81,3,97,450,353
37,81,4,268,591,323
37,81,5,368,763,395
37,81,6,279,699,420
37,82,0,117,458,341
37,82,1,59,379,320
37,82,2,167,484,317
37,82,3,86,406,320
37,82,4,218,532,314
37,82,5,422,831,409
37,82,6,292,739,447
37,83,0,123,435,312
37,83,1,85,390,305
37,83,2,129,459,330
37,83,3,99,425,326
37,83,4,182,472,290
37,83,5,284,687,403
37,83,6,214,674,460
37,84,0,83,391,308
37,84,1,59,396,337
37,84,2,90,416,326
37,84,3,74,398,324
37,84,4,200,509,309
37,84,5,223,612,389
37,84,6,212,670,458
37,85,0,86,379,293
37,85,1,44,331,287
37,85,2,101,395,294
37,85,3,43,367,324
37,85,4,162,496,334
37,85,5,233,590,357
37,85,6,181,634,453
37,86,0,77,377,300
37,86,1,41,294,253
37,86,2,93,392,299
37,86,3,40,343,303
37,86,4,157,473,316
37,86,5,224,665,441
37,86,6,184,610,426
37,87,0,98,410,312
37,87,1,51,361,310
37,87,2,30,366,336
37,87,3,52,342,290
37,87,4,156,451,295
37,87,5,139,554,415
37,87,6,213,670,457
37,88,0,46,343,297
37,88,1,39,346,307
37,88,2,34,330,296
37,88,3,55,366,311
37,88,4,203,496,293
37,88,5,111,554,443
37,88,6,113,573,460
37,89,0,38,320,282
37,89,1,32,310,278
37,89,2,36,356,320
37,89,3,49,353,304
37,89,4,187,492,305
37,89,5,92,526,434
37,89,6,70,541,471
37,90,0,43,359,316
37,90,1,21,333,312
37,90,2,46,381,335
37,90,3,42,375,333
37,90,4,212,510,298
37,90,5,57,502,445
37,90,6,78,542,464
37,91,0,124,410,286
37,91,1,42,362,320
37,91,2,98,375,277
37,91,3,81,394,313
37,91,4,211,505,294
37,91,5,51,445,394
37,91,6,109,549,440
37,92,0,135,447,312
37,92,1,140,425,285
37,92,2,150,464,314
37,92,3,57,393,336
37,92,4,216,516,300
37,92,5,101,518,417
37,92,6,110,553,443
37,93,0,18,401,383
37,93,1,59,418,359
37,93,2,88,472,384
37,93,3,12,397,385
37,93,4,22,490,468
37,93,5,52,462,410
37,93,6,85,505,420
37,94,0,10,348,338
37,94,1,43,352,309
37,94,2,63,383,320
37,94,3,11,342,331
37,94,4,16,440,424
37,94,5,62,495,433
37,94,6,129,575,446
37,95,0,16,357,341
37,95,1,50,369,319
37,95,2,43,335,292
37,95,3,19,380,361
37,95,4,11,388,377
37,95,5,105,560,455
37,95,6,170,669,499
37,96,0,13,399,386
37,96,1,10,416,406
37,96,2,18,393,375
37,96,3,11,391,380
37,96,4,25,474,449
37,96,5,17,540,523
37,96,6,17,597,580
37,97,0,10,384,374
37,97,1,9,388,379
37,97,2,24,417,393
37,97,3,9,384,375
37,97,4,17,386,369
37,97,5,5,458,453
37,97,6,14,513,499
37,98,0,17,370,353
37,98,1,7,386,379
37,98,2,59,421,362
37,98,3,13,425,412
37,98,4,27,471,444
37,98,5,14,503,489
37,98,6,12,534,522
37,99,0,12,382,370
37,99,1,14,424,410
37,99,2,56,514,458
37,99,3,12,444,432
37,99,4,45,563,518
37,99,5,18,516,498
37,99,6,18,555,537
37,100,0,10,448,438
37,100,1,16,453,437
37,100,2,130,602,472
37,100,3,25,495,470
37,100,4,34,555,521
37,100,5,21,543,522
37,100,6,14,559,545
37,101,0,13,513,500
37,101,1,17,531,514
37,101,2,193,734,541
37,101,3,28,623,595
37,101,4,47,556,509
37,101,5,14,556,542
37,101,6,18,537,519
37,102,0,23,733,710
37,102,1,42,684,642
37,102,2,287,965,678
37,102,3,32,805,773
37,102,4,77,782,705
37,102,5,20,608,588
37,102,6,21,637,616
37,103,0,29,631,602
37,103,1,64,713,649
37,103,2,255,846,591
37,103,3,49,733,684
37,103,4,135,806,671
37,103,5,10,671,661
37,103,6,17,617,600
37,104,0,27,697,670
37,104,1,55,676,621
37,104,2,280,935,655
37,104,3,94,783,689
37,104,4,217,859,642
37,104,5,16,662,646
37,104,6,24,587,563
37,105,0,86,920,834
37,105,1,100,906,806
37,105,2,321,1033,712
37,105,3,160,1025,865
37,105,4,362,1027,665
37,105,5,32,673,641
37,105,6,18,564,546
37,106,0,121,796,675
37,106,1,102,806,704
37,106,2,318,960,642
37,106,3,107,859,752
37,106,4,451,1027,576
37,106,5,26,647,621
37,106,6,18,560,542
37,107,0,70,704,634
37,107,1,133,811,678
37,107,2,368,969,601
37,107,3,91,781,690
37,107,4,360,1011,651
37,107,5,14,583,569
37,107,6,11,559,548
37,108,0,70,829,759
37,108,1,160,943,783
37,108,2,420,1114,694
37,108,3,96,928,832
37,108,4,477,1160,683
37,108,5,16,617,601
37,108,6,12,517,505
37,109,0,92,823,731
37,109,1,154,927,773
37,109,2,362,1073,711
37,109,3,112,861,749
37,109,4,435,1026,591
37,109,5,23,548,525
37,109,6,12,522,510
37,110,0,42,695,653
37,110,1,62,720,658
37,110,2,303,985,682
37,110,3,89,737,648
37,110,4,287,925,638
37,110,5,14,545,531
37,110,6,8,503,495
37,111,0,21,593,572
37,111,1,38,711,673
37,111,2,191,872,681
37,111,3,28,625,597
37,111,4,108,728,620
37,111,5,18,589,571
37,111,6,14,514,500
37,112,0,21,586,565
37,112,1,16,587,571
37,112,2,99,682,583
37,112,3,26,581,555
37,112,4,87,646,559
37,112,5,9,488,479
37,112,6,2,444,442
37,113,0,22,516,494
37,113,1,12,557,545
37,113,2,56,626,570
37,113,3,15,504,489
37,113,4,33,544,511
37,113,5,18,454,436
37,113,6,14,470,456
37,114,0,17,508,491
37,114,1,21,497,476
37,114,2,51,605,554
37,114,3,18,515,497
37,114,4,27,513,486
37,114,5,11,417,406
37,114,6,17,445,428
37,115,0,24,441,417
37,115,1,22,489,467
37,115,2,47,534,487
37,115,3,22,492,470
37,115,4,32,480,448
37,115,5,11,408,397
37,115,6,10,409,399
37,116,0,14,429,415
37,116,1,14,466,452
37,116,2,48,527,479
37,116,3,18,421,403
37,116,4,56,509,453
37,116,5,8,371,363
37,116,6,13,413,400
37,117,0,28,503,475
37,117,1,17,417,400
37,117,2,28,556,528
37,117,3,17,401,384
37,117,4,31,493,462
37,117,5,17,380,363
37,117,6,18,380,362
37,118,0,26,431,405
37,118,1,16,467,451
37,118,2,26,474,448
37,118,3,22,480,458
37,118,4,22,470,448
37,118,5,13,393,380
37,118,6,14,410,396
37,119,0,34,470,436
37,119,1,30,499,469
37,119,2,19,480,461
37,119,3,15,451,436
37,119,4,32,471,439
37,119,5,7,339,332
37,119,6,14,406,392
37,120,0,21,543,522
37,120,1,22,509,487
37,120,2,19,509,490
37,120,3,19,478,459
37,120,4,14,448,434
37,120,5,12,416,404
37,120,6,23,454,431
37,121,0,10,445,435
37,121,1,10,452,442
37,121,2,17,534,517
37,121,3,11,472,461
37,121,4,26,462,436
37,121,5,18,411,393
37,121,6,15,377,362
37,122,0,12,464,452
37,122,1,18,438,420
37,122,2,23,466,443
37,122,3,17,448,431
37,122,4,12,462,450
37,122,5,10,400,390
37,122,6,12,382,370
37,123,0,16,455,439
37,123,1,15,446,431
37,123,2,29,494,465
37,123,3,15,451,436
37,123,4,24,477,453
37,123,5,9,401,392
37,123,6,16,443,427
37,124,0,22,527,505
37,124,1,23,496,473
37,124,2,9,499,490
37,124,3,18,459,441
37,124,4,25,469,444
37,124,5,13,384,371
37,124,6,11,382,371
37,125,0,12,503,491
37,125,1,22,489,467
37,125,2,25,489,464
37,125,3,8,458,450
37,125,4,28,439,411
37,125,5,11,417,406
37,125,6,11,344,333
37,126,0,15,586,571
37,126,1,33,522,489
37,126,2,27,596,569
37,126,3,13,496,483
37,126,4,21,483,462
37,126,5,8,409,401
37,126,6,14,409,395
37,127,0,25,522,497
37,127,1,29,585,556
37,127,2,21,590,569
37,127,3,23,512,489
37,127,4,56,554,498
37,127,5,18,425,407
37,127,6,8,406,398
37,128,0,30,523,493
37,128,1,33,524,491
37,128,2,16,545,529
37,128,3,58,527,469
37,128,4,48,498,450
37,128,5,17,426,409
37,128,6,18,359,341
37,129,0,23,473,450
37,129,1,21,493,472
37,129,2,11,474,463
37,129,3,18,503,485
37,129,4,27,451,424
37,129,5,34,505,471
37,129,6,10,373,363
37,130,0,21,398,377
37,130,1,21,466,445
37,130,2,15,452,437
37,130,3,12,409,397
37,130,4,40,446,406
37,130,5,30,434,404
37,130,6,12,334,322
37,131,0,10,418,408
37,131,1,21,431,410
37,131,2,19,424,405
37,131,3,21,448,427
37,131,4,31,497,466
37,131,5,60,506,446
37,131,6,12,349,337
37,132,0,9,398,389
37,132,1,36,464,428
37,132,2,13,473,460
37,132,3,30,448,418
37,132,4,26,444,418
37,132,5,100,544,444
37,132,6,9,323,314
37,133,0,21,354,333
37,133,1,10,377,367
37,133,2,9,350,341
37,133,3,30,406,376
37,133,4,31,415,384
37,133,5,65,447,382
37,133,6,10,276,266
37,134,0,9,323,314
37,134,1,7,292,285
37,134,2,14,339,325
37,134,3,19,330,311
37,134,4,15,378,363
37,134,5,28,346,318
37,134,6,3,241,238
37,135,0,7,242,235
37,135,1,11,296,285
37,135,2,9,300,291
37,135,3,17,281,264
37,135,4,11,342,331
37,135,5,18,310,292
37,135,6,12,258,246
37,136,0,7,232,225
37,136,1,9,263,254
37,136,2,13,287,274
37,136,3,8,258,250
37,136,4,6,251,245
37,136,5,9,270,261
37,136,6,19,235,216
37,137,0,10,212,202
37,137,1,9,225,216
37,137,2,6,225,219
37,137,3,13,232,219
37,137,4,12,293,281
37,137,5,15,290,275
37,137,6,8,220,212
37,138,0,9,182,173
37,138,1,4,184,180
37,138,2,8,211,203
37,138,3,16,176,160
37,138,4,3,236,233
37,138,5,9,258,249
37,138,6,12,206,194
37,139,0,7,155,148
37,139,1,7,168,161
37,139,2,4,164,160
37,139,3,9,192,183
37,139,4,12,219,207
37,139,5,9,233,224
37,139,6,1,136,135
37,140,0,9,151,142
37,140,1,11,158,147
37,140,2,2,152,150
37,140,3,5,180,175
37,140,4,12,185,173
37,140,5,10,191,181
37,140,6,14,171,157
37,141,0,4,126,122
37,141,1,1,123,122
37,141,2,7,162,155
37,141,3,10,149,139
37,141,4,10,199,189
37,141,5,5,191,186
37,141,6,9,152,143
37,142,0,8,125,117
37,142,1,3,121,118
37,142,2,6,130,124
37,142,3,7,117,110
37,142,4,9,168,159
37,142,5,13,205,192
37,142,6,11,138,127
37,143,0,5,89,84
37,143,1,3,111,108
37,143,2,9,137,128
37,143,3,8,144,136
37,143,4,5,132,127
37,143,5,6,144,138
37,143,6,2,132,130
38,0,0,1,5,4
38,0,1,1,5,4
38,0,2,1,13,12
38,0,3,0,6,6
38,0,4,0,6,6
38,0,5,1,12,11
38,0,6,0,8,8
38,1,0,3,4,1
38,1,1,1,8,7
38,1,2,2,10,8
38,1,3,3,8,5
38,1,4,2,15,13
38,1,5,0,10,10
38,1,6,3,14,11
38,2,0,1,6,5
38,2,1,1,9,8
38,2,2,1,6,5
38,2,3,4,11,7
38,2,4,0,8,8
38,2,5,2,16,14
38,2,6,0,8,8
38,3,0,2,9,7
38,3,1,0,5,5
38,3,2,1,9,8
38,3,3,3,8,5
38,3,4,3,19,16
38,3,5,10,23,13
38,3,6,0,12,12
38,4,0,1,3,2
38,4,1,1,3,2
38,4,2,3,7,4
38,4,3,2,8,6
38,4,4,1,9,8
38,4,5,1,3,2
38,4,6,2,12,10
38,5,0,2,5,3
38,5,1,4,14,10
38,5,2,1,4,3
38,5,3,0,5,5
38,5,4,0,4,4
38,5,5,0,6,6
38,5,6,1,12,11
38,6,0,0,5,5
38,6,1,2,6,4
38,6,2,13,14,1
38,6,3,2,7,5
38,6,4,0,8,8
38,6,5,2,3,1
38,6,6,1,6,5
38,7,0,1,3,2
38,7,1,0,1,1
38,7,2,0,6,6
38,7,3,2,6,4
38,7,4,0,6,6
38,7,5,4,7,3
38,7,6,1,7,6
38,8,0,0,3,3
38,8,1,0,1,1
38,8,2,1,4,3
38,8,3,1,6,5
38,8,4,0,7,7
38,8,5,0,3,3
38,8,6,1,6,5
38,9,0,3,7,4
38,9,1,3,6,3
38,9,3,1,5,4
38,9,4,2,10,8
38,9,5,0,4,4
38,9,6,3,6,3
38,10,0,3,4,1
38,10,1,2,3,1
38,10,2,1,3,2
38,10,3,1,1,0
38,10,4,2,5,3
38,10,5,8,9,1
38,10,6,1,4,3
38,11,0,4,5,1
38,11,1,1,4,3
38,11,2,2,5,3
38,11,3,10,12,2
38,11,4,4,8,4
38,11,5,2,7,5
38,11,6,1,3,2
38,12,0,0,3,3
38,12,1,1,4,3
38,12,2,5,10,5
38,12,3,5,7,2
38,12,4,0,4,4
38,12,5,1,2,1
38,12,6,4,6,2
38,13,0,0,2,2
38,13,1,1,4,3
38,13,2,0,1,1
38,13,3,3,7,4
38,13,4,1,5,4
38,13,5,2,2,0
38,13,6,0,6,6
38,14,0,2,5,3
38,14,1,0,2,2
38,14,2,0,2,2
38,14,4,0,2,2
38,14,5,0,5,5
38,14,6,0,2,2
38,15,0,0,1,1
38,15,1,0,2,2
38,15,4,1,2,1
38,15,5,1,4,3
38,15,6,0,1,1
38,16,0,0,2,2
38,16,3,5,5,0
38,16,4,2,4,2
38,16,5,2,3,1
38,17,0,1,3,2
38,17,1,0,3,3
38,17,2,0,1,1
38,17,3,3,3,0
38,17,4,0,1,1
38,17,5,1,1,0
38,17,6,0,4,4
38,18,1,1,4,3
38,18,4,1,4,3
38,18,5,1,3,2
38,18,6,1,2,1
38,19,3,2,2,0
38,19,4,1,3,2
38,19,5,3,3,0
38,19,6,0,1,1
38,20,0,0,2,2
38,20,1,0,3,3
38,20,3,3,3,0
38,20,4,1,2,1
38,20,5,1,2,1
38,20,6,1,2,1
38,21,0,1,1,0
38,21,3,1,2,1
38,21,4,1,1,0
38,21,5,1,2,1
38,21,6,0,1,1
38,22,0,0,2,2
38,22,1,4,6,2
38,22,2,5,5,0
38,22,3,2,4,2
38,22,4,3,3,0
38,22,5,2,3,1
38,23,0,2,3,1
38,23,2,2,3,1
38,23,3,2,3,1
38,23,4,2,3,1
38,23,5,1,1,0
38,23,6,0,1,1
38,24,0,1,1,0
38,24,2,3,4,1
38,24,3,3,4,1
38,24,4,1,1,0
38,24,5,2,2,0
38,25,0,0,1,1
38,25,2,1,1,0
38,25,4,2,3,1
38,25,5,2,2,0
38,25,6,1,1,0
38,26,1,2,2,0
38,26,3,1,1,0
38,26,4,1,2,1
38,26,6,1,2,1
38,27,4,2,3,1
38,27,5,0,1,1
38,28,4,0,1,1
38,28,5,1,1,0
38,28,6,1,1,0
38,29,0,0,3,3
38,29,2,0,2,2
38,29,5,1,2,1
38,30,0,1,1,0
38,30,4,0,1,1
38,30,6,2,2,0
38,31,0,1,1,0
38,31,1,1,1,0
38,31,2,0,1,1
38,31,4,0,2,2
38,32,1,2,2,0
38,32,3,2,2,0
38,32,4,3,5,2
38,32,6,1,1,0
38,33,0,3,4,1
38,33,1,4,6,2
38,33,2,0,2,2
38,33,4,5,6,1
38,33,5,3,3,0
38,33,6,0,1,1
38,34,0,1,1,0
38,34,1,2,2,0
38,34,4,4,6,2
38,34,5,1,1,0
38,35,0,3,6,3
38,35,1,1,1,0
38,35,2,1,2,1
38,35,4,3,3,0
38,35,5,1,1,0
38,35,6,0,2,2
38,36,0,1,1,0
38,36,1,3,4,1
38,36,2,1,2,1
38,36,3,4,5,1
38,36,4,12,12,0
38,36,5,1,5,4
38,36,6,0,2,2
38,37,0,1,5,4
38,37,1,6,7,1
38,37,2,3,5,2
38,37,3,4,7,3
38,37,4,10,14,4
38,37,5,12,15,3
38,37,6,0,2,2
38,38,0,1,6,5
38,38,1,8,11,3
38,38,2,1,6,5
38,38,3,8,16,8
38,38,4,12,20,8
38,38,5,8,12,4
38,38,6,0,3,3
38,39,0,0,20,20
38,39,1,0,11,11
38,39,2,2,12,10
38,39,3,1,15,14
38,39,4,1,9,8
38,39,5,0,3,3
38,39,6,1,2,1
38,40,0,1,18,17
38,40,1,1,17,16
38,40,2,0,15,15
38,40,3,2,13,11
38,40,4,0,14,14
38,40,5,0,6,6
38,40,6,4,11,7
38,41,0,3,30,27
38,41,1,4,37,33
38,41,2,0,30,30
38,41,3,1,29,28
38,41,4,2,30,28
38,41,5,2,15,13
38,41,6,0,9,9
38,42,0,2,52,50
38,42,1,2,39,37
38,42,2,0,46,46
38,42,3,1,45,44
38,42,4,2,30,28
38,42,5,4,14,10
38,42,6,2,14,12
38,43,0,4,52,48
38,43,1,1,35,34
38,43,2,1,38,37
38,43,3,1,64,63
38,43,4,0,43,43
38,43,5,1,18,17
38,43,6,4,25,21
38,44,0,2,63,61
38,44,1,2,65,63
38,44,2,3,67,64
38,44,3,2,71,69
38,44,4,4,55,51
38,44,5,4,23,19
38,44,6,4,19,15
38,45,0,10,86,76
38,45,1,2,77,75
38,45,2,4,89,85
38,45,3,15,92,77
38,45,4,6,72,66
38,45,5,2,40,38
38,45,6,5,30,25
38,46,0,36,124,88
38,46,1,28,123,95
38,46,2,23,105,82
38,46,3,23,74,51
38,46,4,17,82,65
38,46,5,0,38,38
38,46,6,1,33,32
38,47,0,50,106,56
38,47,1,45,116,71
38,47,2,35,103,68
38,47,3,34,115,81
38,47,4,26,81,55
38,47,5,1,48,47
38,47,6,3,28,25
38,48,0,35,101,66
38,48,1,42,104,62
38,48,2,42,88,46
38,48,3,30,81,51
38,48,4,24,77,53
38,48,5,6,34,28
38,48,6,3,44,41
38,49,0,57,92,35
38,49,1,51,95,44
38,49,2,32,77,45
38,49,3,44,95,51
38,49,4,18,68,50
38,49,5,9,55,46
38,49,6,1,29,28
38,50,0,45,88,43
38,50,1,34,88,54
38,50,2,34,81,47
38,50,3,39,83,44
38,50,4,13,50,37
38,50,5,16,37,21
38,50,6,1,35,34
38,51,0,49,87,38
38,51,1,48,84,36
38,51,2,39,85,46
38,51,3,73,103,30
38,51,4,18,52,34
38,51,5,21,48,27
38,51,6,7,36,29
38,52,0,53,84,31
38,52,1,36,66,30
38,52,2,37,71,34
38,52,3,43,80,37
38,52,4,27,62,35
38,52,5,22,45,23
38,52,6,14,44,30
38,53,0,26,53,27
38,53,1,26,57,31
38,53,2,35,57,22
38,53,3,32,63,31
38,53,4,25,45,20
38,53,5,10,33,23
38,53,6,11,36,25
38,54,0,19,45,26
38,54,1,33,68,35
38,54,2,55,83,28
38,54,3,32,66,34
38,54,4,41,71,30
38,54,5,11,32,21
38,54,6,14,45,31
38,55,0,9,41,32
38,55,1,21,50,29
38,55,2,46,74,28
38,55,3,59,86,27
38,55,4,27,65,38
38,55,5,15,54,39
38,55,6,15,40,25
38,56,0,30,52,22
38,56,1,34,62,28
38,56,2,41,74,33
38,56,3,59,80,21
38,56,4,36,70,34
38,56,5,36,56,20
38,56,6,5,39,34
38,57,0,36,60,24
38,57,1,25,44,19
38,57,2,45,60,15
38,57,3,60,79,19
38,57,4,56,76,20
38,57,5,37,71,34
38,57,6,15,43,28
38,58,0,24,45,21
38,58,1,30,50,20
38,58,2,45,72,27
38,58,3,53,71,18
38,58,4,38,55,17
38,58,5,42,65,23
38,58,6,34,58,24
38,59,0,34,63,29
38,59,1,12,25,13
38,59,2,29,56,27
38,59,3,54,79,25
38,59,4,19,38,19
38,59,5,35,66,31
38,59,6,36,61,25
38,60,0,11,31,20
38,60,1,7,24,17
38,60,2,29,54,25
38,60,3,58,76,18
38,60,4,24,46,22
38,60,5,40,67,27
38,60,6,55,79,24
38,61,0,7,33,26
38,61,1,13,25,12
38,61,2,14,35,21
38,61,3,32,48,16
38,61,4,38,54,16
38,61,5,30,59,29
38,61,6,48,73,25
38,62,0,11,34,23
38,62,1,20,48,28
38,62,2,7,28,21
38,62,3,19,45,26
38,62,4,36,50,14
38,62,5,43,75,32
38,62,6,57,80,23
38,63,0,3,18,15
38,63,1,16,29,13
38,63,2,16,32,16
38,63,3,7,24,17
38,63,4,33,51,18
38,63,5,21,53,32
38,63,6,35,61,26
38,64,0,16,25,9
38,64,1,14,28,14
38,64,2,10,23,13
38,64,3,14,30,16
38,64,4,44,61,17
38,64,5,30,51,21
38,64,6,17,42,25
38,65,0,9,26,17
38,65,1,9,26,17
38,65,2,1,17,16
38,65,3,2,22,20
38,65,4,12,31,19
38,65,5,44,65,21
38,65,6,8,26,18
38,66,0,4,16,12
38,66,1,8,17,9
38,66,2,3,18,15
38,66,3,7,22,15
38,66,4,20,43,23
38,66,5,49,71,22
38,66,6,13,36,23
38,67,0,11,28,17
38,67,1,19,42,23
38,67,2,7,26,19
38,67,3,16,34,18
38,67,4,40,63,23
38,67,5,17,42,25
38,67,6,23,51,28
38,68,0,6,31,25
38,68,1,19,36,17
38,68,2,7,27,20
38,68,3,8,33,25
38,68,4,39,65,26
38,68,5,19,43,24
38,68,6,5,30,25
38,69,0,2,23,21
38,69,1,16,33,17
38,69,2,10,33,23
38,69,3,7,27,20
38,69,4,27,44,17
38,69,5,38,64,26
38,69,6,17,51,34
38,70,0,8,26,18
38,70,1,16,37,21
38,70,2,6,23,17
38,70,3,9,24,15
38,70,4,26,46,20
38,70,5,15,52,37
38,70,6,19,55,36
38,71,0,4,20,16
38,71,1,11,35,24
38,71,2,10,27,17
38,71,3,13,31,18
38,71,4,23,41,18
38,71,5,9,35,26
38,71,6,20,60,40
38,72,0,7,24,17
38,72,1,11,32,21
38,72,2,9,32,23
38,72,3,9,36,27
38,72,4,27,51,24
38,72,5,23,55,32
38,72,6,7,44,37
38,73,0,4,24,20
38,73,1,6,26,20
38,73,2,9,38,29
38,73,3,7,33,26
38,73,4,19,49,30
38,73,5,24,54,30
38,73,6,7,39,32
38,74,0,5,33,28
38,74,1,8,33,25
38,74,2,5,40,35
38,74,3,13,39,26
38,74,4,18,46,28
38,74,5,18,47,29
38,74,6,6,47,41
38,75,0,10,31,21
38,75,1,3,24,21
38,75,2,10,39,29
38,75,3,10,35,25
38,75,4,21,43,22
38,75,5,17,53,36
38,75,6,7,42,35
38,76,0,7,29,22
38,76,1,11,33,22
38,76,2,21,49,28
38,76,3,21,48,27
38,76,4,17,32,15
38,76,5,10,34,24
38,76,6,4,30,26
38,77,0,10,36,26
38,77,1,8,39,31
38,77,2,12,32,20
38,77,3,11,40,29
38,77,4,18,49,31
38,77,5,22,59,37
38,77,6,8,35,27
38,78,0,6,32,26
38,78,1,13,35,22
38,78,2,26,43,17
38,78,3,6,27,21
38,78,4,36,63,27
38,78,5,17,50,33
38,78,6,5,48,43
38,79,0,15,44,29
38,79,1,15,37,22
38,79,2,17,41,24
38,79,3,6,31,25
38,79,4,17,51,34
38,79,5,16,49,33
38,79,6,13,48,35
38,80,0,12,42,30
38,80,1,3,35,32
38,80,2,12,27,15
38,80,3,17,46,29
38,80,4,14,43,29
38,80,5,22,56,34
38,80,6,11,42,31
38,81,0,12,33,21
38,81,1,6,26,20
38,81,2,16,46,30
38,81,3,12,32,20
38,81,4,15,44,29
38,81,5,35,70,35
38,81,6,9,45,36
38,82,0,5,28,23
38,82,1,3,26,23
38,82,2,19,47,28
38,82,3,14,33,19
38,82,4,15,47,32
38,82,5,51,90,39
38,82,6,5,40,35
38,83,0,7,31,24
38,83,1,6,22,16
38,83,2,7,26,19
38,83,3,20,40,20
38,83,4,22,50,28
38,83,5,24,55,31
38,83,6,11,43,32
38,84,0,3,26,23
38,84,1,5,22,17
38,84,2,8,34,26
38,84,3,7,24,17
38,84,4,17,46,29
38,84,5,8,34,26
38,84,6,10,49,39
38,85,0,3,25,22
38,85,1,6,20,14
38,85,2,18,48,30
38,85,3,4,26,22
38,85,4,13,40,27
38,85,5,15,44,29
38,85,6,10,49,39
38,86,0,2,28,26
38,86,1,2,17,15
38,86,2,7,19,12
38,86,3,4,32,28
38,86,4,8,29,21
38,86,5,5,40,35
38,86,6,16,44,28
38,87,0,5,29,24
38,87,1,3,28,25
38,87,2,3,23,20
38,87,3,3,27,24
38,87,4,3,25,22
38,87,5,11,33,22
38,87,6,1,27,26
38,88,0,2,27,25
38,88,1,0,25,25
38,88,2,1,22,21
38,88,3,3,26,23
38,88,4,9,23,14
38,88,5,6,38,32
38,88,6,4,44,40
38,89,0,0,24,24
38,89,1,6,23,17
38,89,2,6,32,26
38,89,3,1,27,26
38,89,4,4,25,21
38,89,5,3,22,19
38,89,6,2,28,26
38,90,0,3,28,25
38,90,1,5,30,25
38,90,2,1,22,21
38,90,3,4,22,18
38,90,4,5,32,27
38,90,5,2,25,23
38,90,6,2,26,24
38,91,0,5,28,23
38,91,1,5,27,22
38,91,2,4,20,16
38,91,3,2,19,17
38,91,4,2,24,22
38,91,5,14,39,25
38,91,6,2,34,32
38,92,0,3,31,28
38,92,1,3,28,25
38,92,2,0,21,21
38,92,3,3,26,23
38,92,4,5,29,24
38,92,5,1,32,31
38,92,6,1,34,33
38,93,0,2,22,20
38,93,1,2,27,25
38,93,2,2,34,32
38,93,3,5,33,28
38,93,4,2,28,26
38,93,5,2,30,28
38,93,6,2,36,34
38,94,0,1,24,23
38,94,1,0,21,21
38,94,2,0,20,20
38,94,3,3,31,28
38,94,4,1,24,23
38,94,5,2,30,28
38,94,6,0,35,35
38,95,0,1,19,18
38,95,1,1,20,19
38,95,2,2,29,27
38,95,3,2,21,19
38,95,4,0,29,29
38,95,5,1,40,39
38,95,6,7,45,38
38,96,0,1,34,33
38,96,1,0,15,15
38,96,2,0,23,23
38,96,3,0,20,20
38,96,4,3,28,25
38,96,5,2,34,32
38,96,6,7,40,33
38,97,0,0,36,36
38,97,1,0,12,12
38,97,2,1,19,18
38,97,3,1,26,25
38,97,4,4,35,31
38,97,5,1,33,32
38,97,6,1,38,37
38,98,0,1,35,34
38,98,1,1,31,30
38,98,2,1,28,27
38,98,3,2,29,27
38,98,4,3,34,31
38,98,5,0,33,33
38,98,6,0,28,28
38,99,0,3,30,27
38,99,1,0,24,24
38,99,2,0,29,29
38,99,3,2,33,31
38,99,4,5,32,27
38,99,5,0,23,23
38,99,6,1,23,22
38,100,0,2,32,30
38,100,1,0,24,24
38,100,2,0,27,27
38,100,3,2,24,22
38,100,4,3,31,28
38,100,5,3,34,31
38,100,6,1,39,38
38,101,0,3,40,37
38,101,1,1,28,27
38,101,2,1,33,32
38,101,3,3,26,23
38,101,4,1,27,26
38,101,5,4,40,36
38,101,6,0,32,32
38,102,0,1,31,30
38,102,1,1,29,28
38,102,2,1,31,30
38,102,3,2,28,26
38,102,4,1,24,23
38,102,5,2,42,40
38,102,6,1,40,39
38,103,0,4,36,32
38,103,1,0,32,32
38,103,2,2,28,26
38,103,3,1,33,32
38,103,4,1,29,28
38,103,5,0,33,33
38,103,6,1,38,37
38,104,0,2,53,51
38,104,1,1,37,36
38,104,2,2,42,40
38,104,3,2,32,30
38,104,4,4,45,41
38,104,5,1,40,39
38,104,6,4,47,43
38,105,0,5,36,31
38,105,1,1,38,37
38,105,2,2,29,27
38,105,3,1,31,30
38,105,4,6,38,32
38,105,5,1,42,41
38,105,6,0,40,40
38,106,0,0,21,21
38,106,1,0,19,19
38,106,2,0,36,36
38,106,3,6,41,35
38,106,4,6,29,23
38,106,5,0,43,43
38,106,6,1,44,43
38,107,0,0,20,20
38,107,1,3,24,21
38,107,2,0,28,28
38,107,3,0,26,26
38,107,4,5,30,25
38,107,5,1,25,24
38,107,6,2,34,32
38,108,0,3,29,26
38,108,1,4,28,24
38,108,2,2,32,30
38,108,3,3,35,32
38,108,4,8,44,36
38,108,5,1,37,36
38,108,6,0,29,29
38,109,0,2,37,35
38,109,1,2,25,23
38,109,2,0,34,34
38,109,3,0,24,24
38,109,4,1,31,30
38,109,5,1,31,30
38,109,6,0,28,28
38,110,0,1,20,19
38,110,1,0,23,23
38,110,2,1,26,25
38,110,3,2,29,27
38,110,4,4,35,31
38,110,5,0,36,36
38,110,6,1,31,30
38,111,0,5,34,29
38,111,1,0,18,18
38,111,2,1,24,23
38,111,3,2,36,34
38,111,4,0,31,31
38,111,5,0,35,35
38,111,6,0,23,23
38,112,0,7,32,25
38,112,1,2,28,26
38,112,2,0,32,32
38,112,3,2,27,25
38,112,4,1,25,24
38,112,5,1,30,29
38,112,6,1,44,43
38,113,0,0,19,19
38,113,1,1,30,29
38,113,2,4,34,30
38,113,3,3,37,34
38,113,4,3,31,28
38,113,5,3,35,32
38,113,6,3,23,20
38,114,0,0,20,20
38,114,1,2,30,28
38,114,2,2,29,27
38,114,3,0,28,28
38,114,4,1,30,29
38,114,5,1,23,22
38,114,6,2,29,27
38,115,0,0,18,18
38,115,1,1,22,21
38,115,2,2,24,22
38,115,3,0,22,22
38,115,4,2,28,26
38,115,5,3,30,27
38,115,6,5,38,33
38,116,0,0,24,24
38,116,1,1,24,23
38,116,2,1,27,26
38,116,3,1,25,24
38,116,4,2,21,19
38,116,5,5,34,29
38,116,6,4,31,27
38,117,0,0,20,20
38,117,1,2,27,25
38,117,2,4,23,19
38,117,3,2,14,12
38,117,4,2,36,34
38,117,5,3,37,34
38,117,6,2,41,39
38,118,0,1,19,18
38,118,1,0,32,32
38,118,2,3,25,22
38,118,3,2,24,22
38,118,4,1,24,23
38,118,5,2,27,25
38,118,6,2,34,32
38,119,0,0,25,25
38,119,1,0,23,23
38,119,2,3,20,17
38,119,3,1,25,24
38,119,4,2,39,37
38,119,5,0,22,22
38,119,6,4,25,21
38,120,0,2,21,19
38,120,1,4,41,37
38,120,2,0,18,18
38,120,3,2,28,26
38,120,4,0,36,36
38,120,5,0,37,37
38,120,6,1,17,16
38,121,0,3,26,23
38,121,1,4,30,26
38,121,2,0,23,23
38,121,3,3,22,19
38,121,4,1,35,34
38,121,5,4,36,32
38,121,6,3,30,27
38,122,0,0,20,20
38,122,1,1,17,16
38,122,2,1,30,29
38,122,3,5,28,23
38,122,4,2,34,32
38,122,5,1,43,42
38,122,6,1,30,29
38,123,0,5,35,30
38,123,1,2,33,31
38,123,2,1,28,27
38,123,3,5,19,14
38,123,4,0,38,38
38,123,5,1,35,34
38,123,6,2,34,32
38,124,0,0,20,20
38,124,1,1,31,30
38,124,2,3,27,24
38,124,3,5,32,27
38,124,4,1,40,39
38,124,5,1,44,43
38,124,6,2,26,24
38,125,0,0,26,26
38,125,1,2,31,29
38,125,2,2,23,21
38,125,3,0,17,17
38,125,4,1,34,33
38,125,5,0,23,23
38,125,6,2,36,34
38,126,0,1,29,28
38,126,1,4,22,18
38,126,2,0,25,25
38,126,3,1,27,26
38,126,4,3,43,40
38,126,5,1,28,27
38,126,6,2,25,23
38,127,0,3,37,34
38,127,1,2,27,25
38,127,2,0,26,26
38,127,3,2,19,17
38,127,4,5,31,26
38,127,5,3,30,27
38,127,6,2,24,22
38,128,0,0,17,17
38,128,1,0,33,33
38,128,2,3,21,18
38,128,3,0,18,18
38,128,4,1,26,25
38,128,5,4,36,32
38,128,6,1,18,17
38,129,0,2,30,28
38,129,1,0,22,22
38,129,2,1,20,19
38,129,3,1,21,20
38,129,4,3,27,24
38,129,5,1,30,29
38,129,6,4,29,25
38,130,0,5,35,30
38,130,1,1,28,27
38,130,2,2,26,24
38,130,3,0,17,17
38,130,4,1,35,34
38,130,5,2,35,33
38,130,6,1,24,23
38,131,0,2,21,19
38,131,1,1,23,22
38,131,2,3,18,15
38,131,3,2,19,17
38,131,4,1,23,22
38,131,5,2,30,28
38,131,6,1,19,18
38,132,0,0,14,14
38,132,1,3,26,23
38,132,2,1,24,23
38,132,3,1,20,19
38,132,4,3,28,25
38,132,5,1,32,31
38,132,6,3,29,26
38,133,0,0,13,13
38,133,1,2,18,16
38,133,2,1,18,17
38,133,3,1,25,24
38,133,4,0,32,32
38,133,5,4,44,40
38,133,6,1,21,20
38,134,0,1,11,10
38,134,1,2,20,18
38,134,2,0,20,20
38,134,3,1,21,20
38,134,4,0,21,21
38,134,5,4,26,22
38,134,6,0,14,14
38,135,0,0,10,10
38,135,1,0,15,15
38,135,2,0,16,16
38,135,3,1,18,17
38,135,4,0,14,14
38,135,5,1,18,17
38,135,6,1,14,13
38,136,0,3,14,11
38,136,1,5,28,23
38,136,2,2,14,12
38,136,3,3,14,11
38,136,4,2,28,26
38,136,5,3,24,21
38,136,6,1,17,16
38,137,0,3,24,21
38,137,1,2,17,15
38,137,2,3,19,16
38,137,3,3,12,9
38,137,4,1,18,17
38,137,5,0,17,17
38,137,6,1,8,7
38,138,0,1,17,16
38,138,1,0,16,16
38,138,2,0,15,15
38,138,3,0,11,11
38,138,4,4,21,17
38,138,5,1,13,12
38,138,6,2,15,13
38,139,0,0,9,9
38,139,1,1,12,11
38,139,2,2,14,12
38,139,3,0,10,10
38,139,4,1,16,15
38,139,5,3,15,12
38,139,6,0,10,10
38,140,0,2,15,13
38,140,1,3,14,11
38,140,2,1,6,5
38,140,3,0,11,11
38,140,4,1,18,17
38,140,5,2,14,12
38,140,6,0,7,7
38,141,0,2,11,9
38,141,1,2,19,17
38,141,2,4,11,7
38,141,3,1,11,10
38,141,4,0,9,9
38,141,5,3,15,12
38,141,6,9,24,15
38,142,0,0,7,7
38,142,1,0,4,4
38,142,2,4,9,5
38,142,3,3,9,6
38,142,4,1,11,10
38,142,5,5,20,15
38,142,6,0,8,8
38,143,0,2,8,6
38,143,1,1,8,7
38,143,2,3,8,5
38,143,3,1,8,7
38,143,4,2,18,16
38,143,5,12,24,12
38,143,6,0,6,6
39,0,0,55,87,32
39,0,1,19,66,47
39,0,2,17,48,31
39,0,3,25,71,46
39,0,4,24,69,45
39,0,5,4,40,36
39,0,6,6,43,37
39,1,0,79,108,29
39,1,1,8,56,48
39,1,2,12,48,36
39,1,3,21,59,38
39,1,4,19,56,37
39,1,5,10,35,25
39,1,6,19,46,27
39,2,0,87,106,19
39,2,1,21,53,32
39,2,2,15,55,40
39,2,3,16,41,25
39,2,4,14,49,35
39,2,5,15,45,30
39,2,6,14,38,24
39,3,0,67,89,22
39,3,1,13,36,23
39,3,2,19,55,36
39,3,3,11,33,22
39,3,4,14,35,21
39,3,5,9,42,33
39,3,6,6,30,24
39,4,0,40,55,15
39,4,1,5,23,18
39,4,2,13,40,27
39,4,3,4,21,17
39,4,4,8,27,19
39,4,5,5,28,23
39,4,6,19,64,45
39,5,0,41,59,18
39,5,1,0,10,10
39,5,2,10,28,18
39,5,3,3,12,9
39,5,4,4,16,12
39,5,5,7,25,18
39,5,6,3,30,27
39,6,0,33,42,9
39,6,1,0,6,6
39,6,2,8,28,20
39,6,3,0,2,2
39,6,4,5,19,14
39,6,5,10,24,14
39,6,6,12,25,13
39,7,0,27,41,14
39,7,1,0,6,6
39,7,2,6,18,12
39,7,3,2,15,13
39,7,4,10,21,11
39,7,5,3,10,7
39,7,6,7,21,14
39,8,0,24,46,22
39,8,1,4,6,2
39,8,2,2,10,8
39,8,3,4,9,5
39,8,4,4,12,8
39,8,5,10,20,10
39,8,6,7,18,11
39,9,0,17,37,20
39,9,1,3,7,4
39,9,2,4,14,10
39,9,3,4,12,8
39,9,4,3,9,6
39,9,5,7,15,8
39,9,6,3,9,6
39,10,0,6,12,6
39,10,1,3,14,11
39,10,2,7,13,6
39,10,3,2,9,7
39,10,4,1,6,5
39,10,5,8,22,14
39,10,6,3,15,12
39,11,0,2,11,9
39,11,1,3,10,7
39,11,2,1,3,2
39,11,3,4,11,7
39,11,4,1,4,3
39,11,5,1,8,7
39,11,6,3,12,9
39,12,0,1,4,3
39,12,1,1,8,7
39,12,2,1,2,1
39,12,3,1,6,5
39,12,4,2,5,3
39,12,5,4,12,8
39,12,6,2,10,8
39,13,0,2,6,4
39,13,1,1,11,10
39,13,2,1,2,1
39,13,3,13,19,6
39,13,4,5,6,1
39,13,5,0,5,5
39,13,6,1,7,6
39,14,0,0,2,2
39,14,1,1,3,2
39,14,3,4,6,2
39,14,5,0,3,3
39,14,6,1,3,2
39,15,1,1,3,2
39,15,3,3,4,1
39,15,5,0,2,2
39,16,0,1,2,1
39,16,1,0,3,3
39,16,3,0,1,1
39,17,1,0,2,2
39,17,3,0,4,4
39,18,0,1,1,0
39,18,3,1,6,5
39,18,5,2,3,1
39,19,3,0,4,4
39,19,4,0,2,2
39,19,5,2,3,1
39,19,6,1,1,0
39,20,0,0,1,1
39,21,0,1,1,0
39,21,1,0,1,1
39,21,2,0,1,1
39,21,3,0,1,1
39,21,6,1,1,0
39,22,1,0,2,2
39,22,4,3,3,0
39,22,5,1,2,1
39,22,6,0,1,1
39,23,0,0,1,1
39,23,1,3,3,0
39,23,4,1,1,0
39,23,5,3,3,0
39,24,3,0,1,1
39,24,4,2,2,0
39,25,0,5,5,0
39,25,1,1,1,0
39,25,3,0,1,1
39,25,4,2,2,0
39,25,5,3,3,0
39,26,3,0,1,1
39,26,4,1,1,0
39,26,5,1,1,0
39,27,5,2,2,0
39,27,6,0,1,1
39,28,3,1,1,0
39,28,6,1,4,3
39,29,0,2,2,0
39,29,2,0,1,1
39,29,6,1,1,0
39,30,0,3,3,0
39,30,3,0,2,2
39,30,4,0,1,1
39,30,6,0,1,1
39,31,0,4,5,1
39,31,4,0,1,1
39,31,5,0,1,1
39,32,0,1,2,1
39,32,4,0,1,1
39,32,6,0,1,1
39,33,0,1,1,0
39,33,1,0,2,2
39,33,2,1,1,0
39,33,3,0,1,1
39,33,5,0,1,1
39,34,0,0,2,2
39,34,2,1,6,5
39,34,3,0,1,1
39,34,5,0,1,1
39,35,0,0,2,2
39,35,1,0,2,2
39,35,2,1,3,2
39,35,3,0,1,1
39,35,4,0,1,1
39,35,5,0,1,1
39,36,0,0,2,2
39,36,1,1,2,1
39,36,3,0,1,1
39,36,5,0,3,3
39,36,6,0,3,3
39,37,0,0,4,4
39,37,1,2,2,0
39,37,2,0,1,1
39,37,3,0,3,3
39,37,4,0,4,4
39,37,5,0,2,2
39,37,6,3,4,1
39,38,1,0,3,3
39,38,2,1,3,2
39,38,3,0,3,3
39,38,4,1,3,2
39,38,5,1,3,2
39,38,6,1,3,2
39,39,0,4,6,2
39,39,1,0,2,2
39,39,2,1,3,2
39,39,3,0,1,1
39,39,4,0,4,4
39,39,5,1,1,0
39,39,6,0,6,6
39,40,0,1,3,2
39,40,1,1,2,1
39,40,2,0,2,2
39,40,3,6,14,8
39,40,4,5,6,1
39,40,5,0,3,3
39,40,6,2,5,3
39,41,0,1,8,7
39,41,1,0,3,3
39,41,2,0,6,6
39,41,3,5,9,4
39,41,4,0,3,3
39,41,5,0,4,4
39,41,6,1,3,2
39,42,0,1,9,8
39,42,1,0,4,4
39,42,2,0,3,3
39,42,3,0,2,2
39,42,4,0,3,3
39,42,5,1,5,4
39,42,6,2,6,4
39,43,0,0,5,5
39,43,1,3,7,4
39,43,2,0,5,5
39,43,3,0,5,5
39,43,4,0,3,3
39,43,5,1,4,3
39,43,6,2,6,4
39,44,0,2,8,6
39,44,1,0,3,3
39,44,2,1,6,5
39,44,3,0,2,2
39,44,4,0,2,2
39,44,5,0,1,1
39,44,6,1,7,6
39,45,0,1,4,3
39,45,1,2,4,2
39,45,2,1,6,5
39,45,3,1,3,2
39,45,4,4,5,1
39,45,5,3,6,3
39,45,6,0,2,2
39,46,0,1,2,1
39,46,1,2,8,6
39,46,2,0,1,1
39,46,3,0,2,2
39,46,4,1,5,4
39,46,5,0,3,3
39,46,6,1,5,4
39,47,0,2,6,4
39,47,1,1,2,1
39,47,2,0,5,5
39,47,3,0,6,6
39,47,4,1,4,3
39,47,5,0,4,4
39,47,6,0,1,1
39,48,0,2,5,3
39,48,1,1,8,7
39,48,2,2,5,3
39,48,3,1,4,3
39,48,4,0,2,2
39,48,5,2,10,8
39,48,6,4,6,2
39,49,0,2,9,7
39,49,1,1,3,2
39,49,2,3,5,2
39,49,3,0,4,4
39,49,4,0,8,8
39,49,5,0,6,6
39,49,6,3,8,5
39,50,0,4,22,18
39,50,1,4,13,9
39,50,2,3,15,12
39,50,3,1,12,11
39,50,4,1,6,5
39,50,5,4,12,8
39,50,6,3,11,8
39,51,0,2,24,22
39,51,1,2,15,13
39,51,2,0,11,11
39,51,3,1,16,15
39,51,4,3,21,18
39,51,5,8,22,14
39,51,6,1,13,12
39,52,0,5,33,28
39,52,1,0,11,11
39,52,2,2,22,20
39,52,3,5,18,13
39,52,4,5,28,23
39,52,5,6,20,14
39,52,6,3,22,19
39,53,0,2,22,20
39,53,1,2,8,6
39,53,2,3,22,19
39,53,3,2,11,9
39,53,4,7,25,18
39,53,5,1,5,4
39,53,6,4,22,18
39,54,0,2,20,18
39,54,1,4,23,19
39,54,2,2,18,16
39,54,3,3,15,12
39,54,4,5,18,13
39,54,5,1,11,10
39,54,6,2,17,15
39,55,0,8,27,19
39,55,1,0,24,24
39,55,2,1,17,16
39,55,3,2,24,22
39,55,4,2,18,16
39,55,5,5,13,8
39,55,6,1,14,13
39,56,0,0,18,18
39,56,1,2,11,9
39,56,2,4,20,16
39,56,3,0,16,16
39,56,4,3,29,26
39,56,5,3,17,14
39,56,6,1,19,18
39,57,0,3,42,39
39,57,1,5,23,18
39,57,2,0,17,17
39,57,3,0,16,16
39,57,4,1,25,24
39,57,5,0,15,15
39,57,6,6,27,21
39,58,0,5,33,28
39,58,1,0,28,28
39,58,2,2,32,30
39,58,3,4,15,11
39,58,4,6,37,31
39,58,5,2,14,12
39,58,6,0,14,14
39,59,0,5,40,35
39,59,1,1,43,42
39,59,2,0,28,28
39,59,3,1,16,15
39,59,4,1,33,32
39,59,5,7,22,15
39,59,6,2,17,15
39,60,0,5,39,34
39,60,1,2,25,23
39,60,2,2,30,28
39,60,3,2,28,26
39,60,4,6,35,29
39,60,5,1,21,20
39,60,6,3,18,15
39,61,0,2,42,40
39,61,1,6,28,22
39,61,2,4,31,27
39,61,3,4,37,33
39,61,4,7,31,24
39,61,5,1,18,17
39,61,6,4,30,26
39,62,0,1,39,38
39,62,1,3,24,21
39,62,2,0,39,39
39,62,3,2,30,28
39,62,4,2,37,35
39,62,5,2,13,11
39,62,6,0,20,20
39,63,0,4,41,37
39,63,1,5,27,22
39,63,2,3,46,43
39,63,3,8,40,32
39,63,4,8,43,35
39,63,5,11,28,17
39,63,6,3,36,33
39,64,0,3,37,34
39,64,1,2,28,26
39,64,2,3,23,20
39,64,3,4,30,26
39,64,4,3,35,32
39,64,5,2,15,13
39,64,6,3,36,33
39,65,0,2,35,33
39,65,1,2,34,32
39,65,2,3,33,30
39,65,3,1,28,27
39,65,4,3,31,28
39,65,5,0,13,13
39,65,6,3,32,29
39,66,0,0,28,28
39,66,1,5,22,17
39,66,2,5,29,24
39,66,3,2,17,15
39,66,4,3,24,21
39,66,5,1,21,20
39,66,6,2,31,29
39,67,0,0,26,26
39,67,1,5,20,15
39,67,2,5,22,17
39,67,3,3,25,22
39,67,4,3,26,23
39,67,5,3,15,12
39,67,6,2,52,50
39,68,0,2,26,24
39,68,1,3,22,19
39,68,2,3,24,21
39,68,3,0,31,31
39,68,4,7,23,16
39,68,5,0,19,19
39,68,6,2,33,31
39,69,0,4,22,18
39,69,1,2,19,17
39,69,2,3,32,29
39,69,3,4,23,19
39,69,4,2,31,29
39,69,5,2,26,24
39,69,6,1,24,23
39,70,0,3,27,24
39,70,1,5,24,19
39,70,2,1,18,17
39,70,3,14,28,14
39,70,4,2,27,25
39,70,5,0,24,24
39,70,6,6,27,21
39,71,0,3,15,12
39,71,1,0,10,10
39,71,2,1,22,21
39,71,3,1,21,20
39,71,4,2,18,16
39,71,5,1,14,13
39,71,6,0,22,22
39,72,0,7,23,16
39,72,1,0,6,6
39,72,2,1,11,10
39,72,3,2,13,11
39,72,4,0,12,12
39,72,5,9,24,15
39,72,6,2,10,8
39,73,0,2,20,18
39,73,1,0,14,14
39,73,2,4,17,13
39,73,3,6,22,16
39,73,4,0,12,12
39,73,5,7,30,23
39,73,6,4,22,18
39,74,0,1,25,24
39,74,1,1,19,18
39,74,2,2,21,19
39,74,3,5,13,8
39,74,4,2,9,7
39,74,5,3,19,16
39,74,6,1,12,11
39,75,0,2,15,13
39,75,1,1,18,17
39,75,2,2,21,19
39,75,3,4,16,12
39,75,4,4,23,19
39,75,5,4,27,23
39,75,6,7,30,23
39,76,0,1,14,13
39,76,1,0,15,15
39,76,2,6,21,15
39,76,3,1,11,10
39,76,4,12,33,21
39,76,5,6,29,23
39,76,6,3,27,24
39,77,0,2,26,24
39,77,1,3,18,15
39,77,2,13,28,15
39,77,3,10,25,15
39,77,4,12,31,19
39,77,5,0,18,18
39,77,6,4,42,38
39,78,0,8,34,26
39,78,1,4,21,17
39,78,2,3,18,15
39,78,3,6,18,12
39,78,4,9,26,17
39,78,5,1,25,24
39,78,6,10,36,26
39,79,0,1,30,29
39,79,1,7,30,23
39,79,2,1,20,19
39,79,3,2,17,15
39,79,4,4,19,15
39,79,5,2,22,20
39,79,6,4,33,29
39,80,0,3,23,20
39,80,1,2,20,18
39,80,2,13,30,17
39,80,3,5,28,23
39,80,4,3,14,11
39,80,5,7,34,27
39,80,6,6,24,18
39,81,0,3,27,24
39,81,1,2,24,22
39,81,2,5,23,18
39,81,3,8,28,20
39,81,4,2,12,10
39,81,5,6,24,18
39,81,6,4,31,27
39,82,0,4,17,13
39,82,1,4,19,15
39,82,2,1,19,18
39,82,3,2,23,21
39,82,4,2,25,23
39,82,5,3,32,29
39,82,6,0,19,19
39,83,0,3,27,24
39,83,1,2,22,20
39,83,2,7,27,20
39,83,3,4,16,12
39,83,4,8,29,21
39,83,5,1,21,20
39,83,6,0,29,29
39,84,0,0,13,13
39,84,1,3,26,23
39,84,2,2,18,16
39,84,3,9,23,14
39,84,4,1,17,16
39,84,5,8,33,25
39,84,6,3,18,15
39,85,0,0,19,19
39,85,1,8,36,28
39,85,2,3,22,19
39,85,3,8,29,21
39,85,4,1,13,12
39,85,5,3,19,16
39,85,6,5,39,34
39,86,0,1,25,24
39,86,1,6,24,18
39,86,2,2,18,16
39,86,3,1,24,23
39,86,4,4,27,23
39,86,5,1,17,16
39,86,6,2,26,24
39,87,0,2,21,19
39,87,1,6,24,18
39,87,2,4,16,12
39,87,3,3,25,22
39,87,4,5,15,10
39,87,5,4,30,26
39,87,6,2,19,17
39,88,0,3,27,24
39,88,1,1,23,22
39,88,2,5,15,10
39,88,3,0,23,23
39,88,4,3,24,21
39,88,5,7,31,24
39,88,6,1,24,23
39,89,0,6,25,19
39,89,1,3,15,12
39,89,2,1,25,24
39,89,3,7,28,21
39,89,4,6,27,21
39,89,5,1,14,13
39,89,6,1,29,28
39,90,0,1,30,29
39,90,1,6,31,25
39,90,2,0,19,19
39,90,3,0,21,21
39,90,4,2,35,33
39,90,5,4,34,30
39,90,6,3,34,31
39,91,0,4,26,22
39,91,1,3,31,28
39,91,2,1,23,22
39,91,3,8,38,30
39,91,4,1,32,31
39,91,5,2,33,31
39,91,6,5,38,33
39,92,0,1,22,21
39,92,1,6,28,22
39,92,2,2,24,22
39,92,3,6,42,36
39,92,4,6,26,20
39,92,5,3,22,19
39,92,6,3,35,32
39,93,0,1,19,18
39,93,1,0,25,25
39,93,2,2,27,25
39,93,3,5,27,22
39,93,4,5,24,19
39,93,5,4,29,25
39,93,6,8,38,30
39,94,0,4,25,21
39,94,1,2,17,15
39,94,2,5,25,20
39,94,3,11,32,21
39,94,4,14,32,18
39,94,5,4,14,10
39,94,6,5,22,17
39,95,0,1,23,22
39,95,1,3,21,18
39,95,2,1,23,22
39,95,3,6,28,22
39,95,4,5,32,27
39,95,5,6,24,18
39,95,6,4,39,35
39,96,0,5,38,33
39,96,1,0,20,20
39,96,2,0,17,17
39,96,3,16,48,32
39,96,4,4,30,26
39,96,5,3,27,24
39,96,6,1,32,31
39,97,0,3,42,39
39,97,1,1,16,15
39,97,2,4,28,24
39,97,3,10,36,26
39,97,4,5,35,30
39,97,5,1,19,18
39,97,6,6,48,42
39,98,0,8,42,34
39,98,1,1,32,31
39,98,2,2,33,31
39,98,3,4,31,27
39,98,4,8,36,28
39,98,5,5,32,27
39,98,6,3,37,34
39,99,0,3,27,24
39,99,1,2,30,28
39,99,2,10,49,39
39,99,3,5,39,34
39,99,4,1,24,23
39,99,5,1,37,36
39,99,6,9,52,43
39,100,0,7,32,25
39,100,1,1,32,31
39,100,2,6,31,25
39,100,3,0,27,27
39,100,4,1,27,26
39,100,5,3,35,32
39,100,6,1,45,44
39,101,0,4,30,26
39,101,1,5,25,20
39,101,2,1,30,29
39,101,3,10,30,20
39,101,4,6,37,31
39,101,5,3,26,23
39,101,6,2,43,41
39,102,0,5,37,32
39,102,1,5,32,27
39,102,2,2,25,23
39,102,3,1,24,23
39,102,4,5,28,23
39,102,5,3,26,23
39,102,6,9,46,37
39,103,0,2,22,20
39,103,1,8,41,33
39,103,2,9,30,21
39,103,3,2,18,16
39,103,4,0,20,20
39,103,5,2,31,29
39,103,6,5,27,22
39,104,0,17,30,13
39,104,1,12,40,28
39,104,2,5,29,24
39,104,3,2,36,34
39,104,4,1,32,31
39,104,5,8,42,34
39,104,6,3,37,34
39,105,0,8,37,29
39,105,1,5,28,23
39,105,2,4,28,24
39,105,3,3,30,27
39,105,4,7,35,28
39,105,5,13,43,30
39,105,6,6,43,37
39,106,0,2,26,24
39,106,1,5,30,25
39,106,2,4,34,30
39,106,3,7,24,17
39,106,4,6,21,15
39,106,5,15,49,34
39,106,6,5,33,28
39,107,0,6,28,22
39,107,1,3,29,26
39,107,2,0,13,13
39,107,3,1,22,21
39,107,4,3,24,21
39,107,5,1,23,22
39,107,6,3,42,39
39,108,0,3,35,32
39,108,1,1,26,25
39,108,2,6,27,21
39,108,3,4,23,19
39,108,4,6,30,24
39,108,5,5,30,25
39,108,6,2,35,33
39,109,0,3,25,22
39,109,1,3,28,25
39,109,2,4,19,15
39,109,3,8,32,24
39,109,4,0,22,22
39,109,5,3,40,37
39,109,6,0,31,31
39,110,0,1,23,22
39,110,1,2,29,27
39,110,2,9,35,26
39,110,3,4,30,26
39,110,4,3,25,22
39,110,5,10,55,45
39,110,6,4,30,26
39,111,0,2,21,19
39,111,1,6,26,20
39,111,2,17,42,25
39,111,3,2,25,23
39,111,4,9,36,27
39,111,5,4,39,35
39,111,6,4,34,30
39,112,0,1,21,20
39,112,1,5,18,13
39,112,2,10,42,32
39,112,3,5,32,27
39,112,4,7,36,29
39,112,5,2,28,26
39,112,6,4,28,24
39,113,0,3,27,24
39,113,1,2,23,21
39,113,2,5,29,24
39,113,3,8,28,20
39,113,4,5,29,24
39,113,5,0,16,16
39,113,6,4,45,41
39,114,0,5,29,24
39,114,1,3,35,32
39,114,2,4,31,27
39,114,3,2,25,23
39,114,4,3,35,32
39,114,5,3,21,18
39,114,6,1,43,42
39,115,0,4,38,34
39,115,1,5,33,28
39,115,2,5,40,35
39,115,3,1,21,20
39,115,4,5,39,34
39,115,5,1,22,21
39,115,6,10,53,43
39,116,0,6,32,26
39,116,1,0,26,26
39,116,2,21,48,27
39,116,3,2,38,36
39,116,4,10,42,32
39,116,5,5,37,32
39,116,6,12,67,55
39,117,0,5,53,48
39,117,1,5,27,22
39,117,2,6,53,47
39,117,3,4,32,28
39,117,4,3,39,36
39,117,5,8,50,42
39,117,6,32,82,50
39,118,0,5,40,35
39,118,1,6,26,20
39,118,2,2,38,36
39,118,3,5,32,27
39,118,4,6,26,20
39,118,5,0,25,25
39,118,6,3,32,29
39,119,0,5,36,31
39,119,1,12,54,42
39,119,2,2,31,29
39,119,3,4,40,36
39,119,4,7,35,28
39,119,5,5,39,34
39,119,6,7,36,29
39,120,0,4,42,38
39,120,1,3,40,37
39,120,2,7,53,46
39,120,3,6,40,34
39,120,4,4,37,33
39,120,5,3,36,33
39,120,6,10,52,42
39,121,0,3,39,36
39,121,1,6,41,35
39,121,2,5,40,35
39,121,3,3,29,26
39,121,4,6,41,35
39,121,5,2,26,24
39,121,6,42,90,48
39,122,0,2,43,41
39,122,1,10,33,23
39,122,2,5,43,38
39,122,3,6,30,24
39,122,4,4,39,35
39,122,5,0,16,16
39,122,6,36,101,65
39,123,0,2,26,24
39,123,1,7,45,38
39,123,2,1,33,32
39,123,3,5,33,28
39,123,4,2,39,37
39,123,5,7,33,26
39,123,6,22,85,63
39,124,0,2,25,23
39,124,1,4,23,19
39,124,2,3,34,31
39,124,3,2,27,25
39,124,4,5,30,25
39,124,5,0,16,16
39,124,6,26,62,36
39,125,0,11,34,23
39,125,1,1,26,25
39,125,2,7,34,27
39,125,3,7,39,32
39,125,4,4,21,17
39,125,5,6,32,26
39,125,6,52,87,35
39,126,0,17,49,32
39,126,1,2,30,28
39,126,2,3,35,32
39,126,3,1,25,24
39,126,4,3,36,33
39,126,5,5,31,26
39,126,6,35,83,48
39,127,0,46,81,35
39,127,1,2,39,37
39,127,2,11,64,53
39,127,3,2,30,28
39,127,4,2,29,27
39,127,5,12,45,33
39,127,6,33,69,36
39,128,0,40,71,31
39,128,1,6,44,38
39,128,2,0,29,29
39,128,3,7,27,20
39,128,4,3,29,26
39,128,5,5,25,20
39,128,6,81,106,25
39,129,0,33,57,24
39,129,1,19,50,31
39,129,2,11,47,36
39,129,3,3,29,26
39,129,4,0,18,18
39,129,5,7,36,29
39,129,6,60,89,29
39,130,0,19,34,15
39,130,1,6,19,13
39,130,2,8,32,24
39,130,3,11,43,32
39,130,4,0,11,11
39,130,5,2,25,23
39,130,6,50,70,20
39,131,0,9,26,17
39,131,1,7,38,31
39,131,2,5,21,16
39,131,3,6,34,28
39,131,4,2,28,26
39,131,5,9,30,21
39,131,6,44,65,21
39,132,0,18,38,20
39,132,1,5,29,24
39,132,2,5,27,22
39,132,3,2,14,12
39,132,4,2,27,25
39,132,5,5,33,28
39,132,6,26,46,20
39,133,0,15,27,12
39,133,1,8,35,27
39,133,2,18,51,33
39,133,3,2,25,23
39,133,4,2,22,20
39,133,5,6,31,25
39,133,6,42,69,27
39,134,0,14,35,21
39,134,1,15,38,23
39,134,2,13,43,30
39,134,3,6,34,28
39,134,4,5,33,28
39,134,5,2,36,34
39,134,6,51,77,26
39,135,0,23,38,15
39,135,1,11,42,31
39,135,2,10,37,27
39,135,3,5,33,28
39,135,4,9,42,33
39,135,5,9,52,43
39,135,6,75,97,22
39,136,0,23,49,26
39,136,1,23,55,32
39,136,2,21,43,22
39,136,3,2,26,24
39,136,4,5,30,25
39,136,5,17,54,37
39,136,6,101,125,24
39,137,0,15,35,20
39,137,1,13,36,23
39,137,2,8,34,26
39,137,3,7,33,26
39,137,4,4,39,35
39,137,5,13,32,19
39,137,6,68,98,30
39,138,0,9,30,21
39,138,1,17,47,30
39,138,2,3,28,25
39,138,3,8,33,25
39,138,4,6,29,23
39,138,5,10,40,30
39,138,6,32,72,40
39,139,0,27,50,23
39,139,1,12,41,29
39,139,2,10,33,23
39,139,3,7,34,27
39,139,4,7,40,33
39,139,5,6,35,29
39,139,6,28,70,42
39,140,0,6,22,16
39,140,1,9,21,12
39,140,2,21,50,29
39,140,3,8,29,21
39,140,4,6,26,20
39,140,5,10,34,24
39,140,6,12,44,32
39,141,0,7,40,33
39,141,1,9,30,21
39,141,2,36,71,35
39,141,3,5,36,31
39,141,4,6,26,20
39,141,5,19,34,15
39,141,6,30,56,26
39,142,0,13,49,36
39,142,1,26,49,23
39,142,2,37,76,39
39,142,3,15,42,27
39,142,4,11,31,20
39,142,5,15,36,21
39,142,6,25,56,31
39,143,0,6,42,36
39,143,1,10,42,32
39,143,2,22,56,34
39,143,3,18,43,25
39,143,4,9,34,25
39,143,5,6,29,23
39,143,6,31,68,37
40,0,0,0,2,2
40,0,1,9,13,4
40,0,2,3,5,2
40,0,3,2,6,4
40,0,4,1,10,9
40,0,5,1,3,2
40,0,6,1,10,9
40,1,0,2,7,5
40,1,1,11,13,2
40,1,2,2,4,2
40,1,3,4,11,7
40,1,4,1,11,10
40,1,5,0,5,5
40,1,6,1,1,0
40,2,0,0,4,4
40,2,1,2,7,5
40,2,2,3,6,3
40,2,3,0,2,2
40,2,4,3,14,11
40,2,5,0,3,3
40,2,6,1,2,1
40,3,0,2,6,4
40,3,1,0,3,3
40,3,3,0,1,1
40,3,4,1,11,10
40,3,5,0,1,1
40,3,6,0,3,3
40,4,0,1,2,1
40,4,1,0,2,2
40,4,2,3,5,2
40,4,3,0,1,1
40,4,4,0,5,5
40,4,6,1,2,1
40,5,0,0,1,1
40,5,1,0,1,1
40,5,3,0,1,1
40,5,4,1,3,2
40,5,5,0,3,3
40,5,6,1,5,4
40,6,0,1,3,2
40,6,2,0,2,2
40,6,3,1,3,2
40,6,4,1,2,1
40,6,5,2,2,0
40,6,6,1,1,0
40,7,0,0,1,1
40,7,3,2,3,1
40,7,4,0,1,1
40,7,5,0,1,1
40,7,6,8,11,3
40,8,0,1,1,0
40,8,1,3,5,2
40,8,2,0,1,1
40,8,3,1,2,1
40,8,4,0,1,1
40,8,5,2,3,1
40,8,6,1,1,0
40,9,0,0,1,1
40,9,1,3,7,4
40,9,2,0,4,4
40,9,3,2,2,0
40,9,4,0,1,1
40,9,5,1,3,2
40,9,6,0,2,2
40,10,0,3,5,2
40,10,1,1,1,0
40,10,4,0,1,1
40,10,5,2,2,0
40,11,0,1,1,0
40,11,2,6,7,1
40,11,5,1,2,1
40,12,0,0,1,1
40,12,1,0,1,1
40,12,3,2,3,1
40,12,4,1,3,2
40,12,5,1,1,0
40,13,1,1,2,1
40,13,2,1,2,1
40,13,3,1,1,0
40,13,4,1,1,0
40,14,0,1,1,0
40,14,3,3,4,1
40,14,4,2,4,2
40,15,3,0,1,1
40,15,4,2,3,1
40,15,6,1,2,1
40,16,1,1,1,0
40,16,2,0,1,1
40,16,4,2,2,0
40,16,6,1,1,0
40,17,2,3,4,1
40,17,3,0,1,1
40,17,6,1,2,1
40,18,1,1,1,0
40,18,4,0,1,1
40,18,6,0,1,1
40,19,2,2,2,0
40,19,5,0,1,1
40,19,6,1,1,0
40,20,1,1,1,0
40,20,4,0,1,1
40,20,5,0,1,1
40,20,6,1,2,1
40,21,4,0,3,3
40,21,6,0,1,1
40,22,0,1,1,0
40,22,2,0,1,1
40,22,4,0,1,1
40,23,0,2,2,0
40,23,2,0,1,1
40,23,6,2,2,0
40,24,0,0,1,1
40,24,4,0,1,1
40,25,3,0,1,1
40,26,0,1,1,0
40,27,0,1,1,0
40,27,3,1,1,0
40,28,5,2,2,0
40,29,1,0,1,1
40,29,4,0,1,1
40,30,4,1,1,0
40,30,5,0,1,1
40,30,6,0,1,1
40,31,0,1,1,0
40,31,2,1,2,1
40,32,2,0,1,1
40,32,4,0,3,3
40,32,5,0,1,1
40,33,0,1,2,1
40,33,1,1,2,1
40,33,4,1,1,0
40,33,5,1,1,0
40,33,6,1,1,0
40,34,0,0,2,2
40,34,1,1,1,0
40,34,4,5,5,0
40,34,5,1,1,0
40,34,6,1,1,0
40,35,0,1,2,1
40,35,4,1,2,1
40,35,5,1,1,0
40,35,6,1,2,1
40,36,0,0,2,2
40,36,1,0,1,1
40,36,2,3,3,0
40,36,3,0,1,1
40,36,4,2,3,1
40,36,5,1,1,0
40,37,0,2,3,1
40,37,1,3,4,1
40,37,2,1,2,1
40,37,4,1,2,1
40,37,5,3,4,1
40,38,0,1,4,3
40,38,1,3,5,2
40,38,2,1,2,1
40,38,3,0,2,2
40,38,4,1,1,0
40,38,5,4,4,0
40,38,6,2,3,1
40,39,0,0,4,4
40,39,1,3,9,6
40,39,2,0,4,4
40,39,3,0,6,6
40,39,4,1,4,3
40,39,5,2,5,3
40,39,6,0,1,1
40,40,0,0,13,13
40,40,1,0,4,4
40,40,2,0,5,5
40,40,3,0,4,4
40,40,4,0,4,4
40,40,6,0,3,3
40,41,0,0,18,18
40,41,1,4,17,13
40,41,2,0,7,7
40,41,3,2,17,15
40,41,4,0,9,9
40,41,5,0,3,3
40,41,6,3,4,1
40,42,0,0,12,12
40,42,1,1,8,7
40,42,2,0,10,10
40,42,3,5,17,12
40,42,4,0,10,10
40,42,5,1,9,8
40,42,6,3,6,3
40,43,0,3,17,14
40,43,1,1,16,15
40,43,2,0,16,16
40,43,3,1,14,13
40,43,4,0,12,12
40,43,5,1,10,9
40,43,6,0,3,3
40,44,0,15,38,23
40,44,1,1,16,15
40,44,2,1,23,22
40,44,3,2,22,20
40,44,4,3,14,11
40,44,5,5,12,7
40,44,6,8,14,6
40,45,0,5,23,18
40,45,1,0,22,22
40,45,2,1,26,25
40,45,3,3,24,21
40,45,4,4,8,4
40,45,5,4,13,9
40,45,6,7,17,10
40,46,0,10,32,22
40,46,1,2,27,25
40,46,2,3,24,21
40,46,3,5,29,24
40,46,4,3,23,20
40,46,5,2,7,5
40,46,6,3,9,6
40,47,0,11,42,31
40,47,1,3,32,29
40,47,2,7,19,12
40,47,3,2,22,20
40,47,4,8,26,18
40,47,5,0,9,9
40,47,6,7,18,11
40,48,0,10,24,14
40,48,1,9,40,31
40,48,2,22,42,20
40,48,3,13,46,33
40,48,4,3,24,21
40,48,5,2,20,18
40,48,6,0,13,13
40,49,0,8,21,13
40,49,1,9,33,24
40,49,2,16,46,30
40,49,3,11,37,26
40,49,4,13,32,19
40,49,5,6,19,13
40,49,6,2,17,15
40,50,0,14,39,25
40,50,1,14,29,15
40,50,2,20,37,17
40,50,3,17,46,29
40,50,4,21,47,26
40,50,5,7,29,22
40,50,6,2,24,22
40,51,0,27,54,27
40,51,1,17,53,36
40,51,2,13,50,37
40,51,3,15,53,38
40,51,4,19,44,25
40,51,5,7,27,20
40,51,6,5,22,17
40,52,0,16,43,27
40,52,1,13,44,31
40,52,2,11,33,22
40,52,3,19,55,36
40,52,4,9,21,12
40,52,5,8,26,18
40,52,6,5,26,21
40,53,0,14,44,30
40,53,1,13,36,23
40,53,2,17,49,32
40,53,3,1,39,38
40,53,4,11,34,23
40,53,5,3,26,23
40,53,6,3,19,16
40,54,0,15,41,26
40,54,1,6,35,29
40,54,2,13,36,23
40,54,3,9,35,26
40,54,4,6,27,21
40,54,5,3,13,10
40,54,6,0,9,9
40,55,0,20,33,13
40,55,1,7,28,21
40,55,2,8,34,26
40,55,3,6,27,21
40,55,4,8,29,21
40,55,5,2,23,21
40,55,6,6,26,20
40,56,0,17,38,21
40,56,1,4,20,16
40,56,2,18,32,14
40,56,3,4,23,19
40,56,4,14,30,16
40,56,5,2,17,15
40,56,6,8,20,12
40,57,0,13,24,11
40,57,1,4,17,13
40,57,2,20,33,13
40,57,3,8,22,14
40,57,4,19,32,13
40,57,5,4,28,24
40,57,6,4,21,17
40,58,0,8,33,25
40,58,1,5,19,14
40,58,2,6,24,18
40,58,3,7,19,12
40,58,4,18,33,15
40,58,5,12,28,16
40,58,6,2,20,18
40,59,0,8,17,9
40,59,1,10,25,15
40,59,2,6,16,10
40,59,3,11,19,8
40,59,4,11,26,15
40,59,5,10,33,23
40,59,6,4,24,20
40,60,0,11,22,11
40,60,1,7,23,16
40,60,2,7,25,18
40,60,3,4,17,13
40,60,4,11,22,11
40,60,5,9,23,14
40,60,6,8,22,14
40,61,0,12,26,14
40,61,1,8,21,13
40,61,2,8,23,15
40,61,3,11,28,17
40,61,4,10,14,4
40,61,5,2,19,17
40,61,6,4,25,21
40,62,0,4,18,14
40,62,1,7,19,12
40,62,2,4,15,11
40,62,3,6,18,12
40,62,4,6,23,17
40,62,5,4,13,9
40,62,6,11,26,15
40,63,0,9,18,9
40,63,1,10,17,7
40,63,2,11,20,9
40,63,3,2,13,11
40,63,4,7,17,10
40,63,5,6,26,20
40,63,6,7,18,11
40,64,0,7,20,13
40,64,1,6,14,8
40,64,2,5,13,8
40,64,3,6,19,13
40,64,4,3,8,5
40,64,5,7,22,15
40,64,6,1,17,16
40,65,0,11,24,13
40,65,1,4,16,12
40,65,2,4,14,10
40,65,3,3,11,8
40,65,4,9,14,5
40,65,5,8,27,19
40,65,6,4,18,14
40,66,0,10,22,12
40,66,1,4,7,3
40,66,2,11,23,12
40,66,3,1,10,9
40,66,4,14,20,6
40,66,5,3,9,6
40,66,6,6,21,15
40,67,0,10,23,13
40,67,1,0,11,11
40,67,2,9,23,14
40,67,3,7,14,7
40,67,4,7,15,8
40,67,5,6,14,8
40,67,6,10,24,14
40,68,0,5,16,11
40,68,1,6,18,12
40,68,2,8,18,10
40,68,3,4,13,9
40,68,4,3,18,15
40,68,5,2,14,12
40,68,6,9,25,16
40,69,0,10,22,12
40,69,1,4,14,10
40,69,2,6,14,8
40,69,3,5,16,11
40,69,4,8,18,10
40,69,5,7,29,22
40,69,6,1,14,13
40,70,0,6,14,8
40,70,1,12,35,23
40,70,2,13,25,12
40,70,3,13,23,10
40,70,4,3,10,7
40,70,5,4,18,14
40,70,6,4,20,16
40,71,0,4,18,14
40,71,1,13,23,10
40,71,2,15,24,9
40,71,3,10,18,8
40,71,4,9,16,7
40,71,5,3,17,14
40,71,6,6,29,23
40,72,0,9,22,13
40,72,1,4,17,13
40,72,2,11,31,20
40,72,3,7,22,15
40,72,4,4,20,16
40,72,5,2,12,10
40,72,6,4,18,14
40,73,0,10,22,12
40,73,1,9,23,14
40,73,2,13,29,16
40,73,3,16,35,19
40,73,4,9,19,10
40,73,5,7,22,15
40,73,6,5,22,17
40,74,0,3,13,10
40,74,1,5,16,11
40,74,2,10,24,14
40,74,3,15,36,21
40,74,4,12,27,15
40,74,5,6,19,13
40,74,6,5,25,20
40,75,0,6,16,10
40,75,1,6,14,8
40,75,2,9,32,23
40,75,3,2,13,11
40,75,4,6,23,17
40,75,5,4,26,22
40,75,6,13,33,20
40,76,0,8,19,11
40,76,1,10,23,13
40,76,2,11,24,13
40,76,3,3,17,14
40,76,4,10,27,17
40,76,5,12,31,19
40,76,6,15,31,16
40,77,0,8,23,15
40,77,1,24,36,12
40,77,2,7,18,11
40,77,3,6,22,16
40,77,4,6,20,14
40,77,5,10,25,15
40,77,6,8,34,26
40,78,0,5,20,15
40,78,1,16,30,14
40,78,2,16,33,17
40,78,3,11,21,10
40,78,4,5,23,18
40,78,5,14,31,17
40,78,6,5,20,15
40,79,0,7,23,16
40,79,1,10,27,17
40,79,2,2,21,19
40,79,3,8,27,19
40,79,4,15,29,14
40,79,5,12,34,22
40,79,6,9,37,28
40,80,0,5,20,15
40,80,1,13,24,11
40,80,2,5,16,11
40,80,3,8,23,15
40,80,4,11,27,16
40,80,5,11,37,26
40,80,6,11,32,21
40,81,0,2,12,10
40,81,1,6,26,20
40,81,2,4,20,16
40,81,3,2,16,14
40,81,4,14,28,14
40,81,5,15,31,16
40,81,6,9,29,20
40,82,0,1,18,17
40,82,1,8,22,14
40,82,2,4,20,16
40,82,3,4,14,10
40,82,4,4,22,18
40,82,5,15,38,23
40,82,6,9,29,20
40,83,0,4,16,12
40,83,1,3,18,15
40,83,2,6,20,14
40,83,3,10,24,14
40,83,4,3,18,15
40,83,5,9,23,14
40,83,6,3,28,25
40,84,0,11,29,18
40,84,1,3,13,10
40,84,2,10,23,13
40,84,3,12,23,11
40,84,4,9,25,16
40,84,5,6,21,15
40,84,6,3,21,18
40,85,0,10,25,15
40,85,1,7,22,15
40,85,2,4,11,7
40,85,3,8,17,9
40,85,4,4,23,19
40,85,5,12,27,15
40,85,6,7,27,20
40,86,0,4,19,15
40,86,1,5,19,14
40,86,2,7,29,22
40,86,3,6,26,20
40,86,4,7,27,20
40,86,5,8,31,23
40,86,6,12,40,28
40,87,0,7,26,19
40,87,1,6,15,9
40,87,2,5,16,11
40,87,3,3,18,15
40,87,4,15,33,18
40,87,5,11,27,16
40,87,6,16,46,30
40,88,0,5,16,11
40,88,1,4,16,12
40,88,2,4,23,19
40,88,3,6,18,12
40,88,4,4,19,15
40,88,5,9,27,18
40,88,6,10,27,17
40,89,0,10,23,13
40,89,1,4,11,7
40,89,2,2,16,14
40,89,3,5,28,23
40,89,4,4,19,15
40,89,5,2,15,13
40,89,6,13,34,21
40,90,0,1,17,16
40,90,1,3,16,13
40,90,2,3,20,17
40,90,3,4,18,14
40,90,4,4,26,22
40,90,5,4,18,14
40,90,6,4,20,16
40,91,0,6,21,15
40,91,1,2,17,15
40,91,2,1,11,10
40,91,3,4,20,16
40,91,4,3,22,19
40,91,5,5,29,24
40,91,6,5,43,38
40,92,0,11,25,14
40,92,1,7,24,17
40,92,2,6,20,14
40,92,3,5,20,15
40,92,4,5,28,23
40,92,5,12,54,42
40,92,6,5,34,29
40,93,0,1,22,21
40,93,1,1,22,21
40,93,2,9,34,25
40,93,3,0,17,17
40,93,4,2,23,21
40,93,5,2,18,16
40,93,6,2,33,31
40,94,0,2,22,20
40,94,1,0,11,11
40,94,2,2,28,26
40,94,3,0,19,19
40,94,4,0,33,33
40,94,5,6,34,28
40,94,6,3,40,37
40,95,0,3,23,20
40,95,1,0,15,15
40,95,2,3,18,15
40,95,3,2,24,22
40,95,4,0,21,21
40,95,5,4,37,33
40,95,6,9,47,38
40,96,0,2,10,8
40,96,1,0,14,14
40,96,2,3,19,16
40,96,3,1,19,18
40,96,4,8,32,24
40,96,5,3,34,31
40,96,6,4,34,30
40,97,0,0,20,20
40,97,1,0,17,17
40,97,2,2,20,18
40,97,3,1,17,16
40,97,4,0,26,26
40,97,5,0,33,33
40,97,6,0,21,21
40,98,0,1,20,19
40,98,1,1,22,21
40,98,2,2,25,23
40,98,3,0,20,20
40,98,4,3,20,17
40,98,5,1,46,45
40,98,6,0,37,37
40,99,0,1,12,11
40,99,1,0,24,24
40,99,2,2,21,19
40,99,3,1,27,26
40,99,4,3,24,21
40,99,5,1,37,36
40,99,6,1,36,35
40,100,0,1,10,9
40,100,1,1,13,12
40,100,2,2,22,20
40,100,3,0,19,19
40,100,4,0,15,15
40,100,5,1,28,27
40,100,6,3,33,30
40,101,0,0,16,16
40,101,1,0,13,13
40,101,2,3,26,23
40,101,3,2,18,16
40,101,4,1,24,23
40,101,5,1,35,34
40,101,6,1,34,33
40,102,0,0,23,23
40,102,1,0,24,24
40,102,2,6,36,30
40,102,3,3,27,24
40,102,4,3,23,20
40,102,5,1,30,29
40,102,6,2,41,39
40,103,0,0,25,25
40,103,1,1,28,27
40,103,2,2,20,18
40,103,3,0,22,22
40,103,4,6,25,19
40,103,5,0,27,27
40,103,6,3,34,31
40,104,0,1,18,17
40,104,1,7,32,25
40,104,2,4,24,20
40,104,3,0,15,15
40,104,4,11,34,23
40,104,5,5,29,24
40,104,6,2,23,21
40,105,0,1,19,18
40,105,1,2,23,21
40,105,2,1,24,23
40,105,3,0,19,19
40,105,4,6,35,29
40,105,5,2,32,30
40,105,6,1,29,28
40,106,0,2,29,27
40,106,1,0,20,20
40,106,2,2,23,21
40,106,3,4,19,15
40,106,4,6,19,13
40,106,5,1,31,30
40,106,6,4,31,27
40,107,0,0,17,17
40,107,1,0,21,21
40,107,2,2,20,18
40,107,3,0,25,25
40,107,4,1,16,15
40,107,5,0,23,23
40,107,6,15,42,27
40,108,0,2,23,21
40,108,1,3,26,23
40,108,2,2,19,17
40,108,3,1,24,23
40,108,4,4,19,15
40,108,5,2,34,32
40,108,6,4,42,38
40,109,0,3,18,15
40,109,1,2,27,25
40,109,2,2,26,24
40,109,3,1,22,21
40,109,4,3,24,21
40,109,5,4,37,33
40,109,6,1,28,27
40,110,0,1,15,14
40,110,1,1,17,16
40,110,2,3,25,22
40,110,3,1,19,18
40,110,4,2,33,31
40,110,5,3,31,28
40,110,6,0,22,22
40,111,0,3,18,15
40,111,1,2,26,24
40,111,2,1,20,19
40,111,3,0,18,18
40,111,4,2,24,22
40,111,5,2,21,19
40,111,6,4,30,26
40,112,0,0,13,13
40,112,1,0,23,23
40,112,2,3,30,27
40,112,3,3,30,27
40,112,4,1,18,17
40,112,5,2,28,26
40,112,6,2,24,22
40,113,0,3,26,23
40,113,1,2,23,21
40,113,2,2,22,20
40,113,3,2,19,17
40,113,4,1,22,21
40,113,5,0,39,39
40,113,6,0,27,27
40,114,0,0,21,21
40,114,1,1,19,18
40,114,2,3,23,20
40,114,3,3,15,12
40,114,4,1,29,28
40,114,5,1,32,31
40,114,6,0,36,36
40,115,0,1,18,17
40,115,1,1,23,22
40,115,2,1,17,16
40,115,3,6,30,24
40,115,4,3,32,29
40,115,5,2,21,19
40,115,6,2,28,26
40,116,0,2,21,19
40,116,1,1,23,22
40,116,2,3,30,27
40,116,3,1,17,16
40,116,4,1,20,19
40,116,5,1,16,15
40,116,6,3,30,27
40,117,0,4,28,24
40,117,1,0,12,12
40,117,2,2,35,33
40,117,3,1,21,20
40,117,4,1,27,26
40,117,5,1,36,35
40,117,6,4,18,14
40,118,0,3,24,21
40,118,1,3,16,13
40,118,2,2,17,15
40,118,3,1,22,21
40,118,4,2,26,24
40,118,5,4,27,23
40,118,6,9,39,30
40,119,0,0,18,18
40,119,1,1,11,10
40,119,2,2,19,17
40,119,3,1,16,15
40,119,4,5,31,26
40,119,5,2,21,19
40,119,6,3,26,23
40,120,0,0,23,23
40,120,1,1,15,14
40,120,2,6,31,25
40,120,3,3,21,18
40,120,4,3,24,21
40,120,5,6,30,24
40,120,6,12,33,21
40,121,0,0,14,14
40,121,1,1,23,22
40,121,2,8,38,30
40,121,3,1,22,21
40,121,4,2,39,37
40,121,5,1,26,25
40,121,6,9,27,18
40,122,0,1,17,16
40,122,1,2,23,21
40,122,2,2,21,19
40,122,3,3,34,31
40,122,4,3,28,25
40,122,5,2,22,20
40,122,6,2,19,17
40,123,0,0,19,19
40,123,1,3,22,19
40,123,2,4,26,22
40,123,3,2,16,14
40,123,4,3,35,32
40,123,5,8,31,23
40,123,6,3,20,17
40,124,0,1,8,7
40,124,1,0,15,15
40,124,2,3,19,16
40,124,3,0,15,15
40,124,4,2,31,29
40,124,5,2,31,29
40,124,6,3,20,17
40,125,0,0,15,15
40,125,1,6,19,13
40,125,2,3,21,18
40,125,3,1,19,18
40,125,4,3,22,19
40,125,5,3,22,19
40,125,6,4,31,27
40,126,0,3,16,13
40,126,1,7,30,23
40,126,2,5,28,23
40,126,3,4,24,20
40,126,4,4,30,26
40,126,5,4,20,16
40,126,6,13,37,24
40,127,0,6,23,17
40,127,1,1,23,22
40,127,2,3,23,20
40,127,3,4,17,13
40,127,4,6,37,31
40,127,5,4,31,27
40,127,6,7,31,24
40,128,0,4,19,15
40,128,1,0,16,16
40,128,2,0,19,19
40,128,3,4,9,5
40,128,4,2,40,38
40,128,5,8,33,25
40,128,6,8,35,27
40,129,0,1,15,14
40,129,1,2,22,20
40,129,2,4,21,17
40,129,3,2,15,13
40,129,4,4,28,24
40,129,5,10,42,32
40,129,6,0,15,15
40,130,0,1,16,15
40,130,1,1,13,12
40,130,2,0,16,16
40,130,3,0,10,10
40,130,4,3,28,25
40,130,5,3,30,27
40,130,6,2,32,30
40,131,0,6,17,11
40,131,1,3,24,21
40,131,2,1,16,15
40,131,3,1,16,15
40,131,4,5,36,31
40,131,5,4,38,34
40,131,6,1,23,22
40,132,0,10,33,23
40,132,1,0,22,22
40,132,2,3,22,19
40,132,3,10,42,32
40,132,4,3,29,26
40,132,5,5,48,43
40,132,6,1,20,19
40,133,0,1,17,16
40,133,1,3,21,18
40,133,2,7,29,22
40,133,3,1,22,21
40,133,4,6,33,27
40,133,5,9,33,24
40,133,6,3,20,17
40,134,0,2,12,10
40,134,1,1,13,12
40,134,2,0,17,17
40,134,3,3,19,16
40,134,4,2,23,21
40,134,5,3,23,20
40,134,6,1,13,12
40,135,0,1,12,11
40,135,1,0,5,5
40,135,2,0,14,14
40,135,3,3,14,11
40,135,4,1,18,17
40,135,5,3,17,14
40,135,6,5,17,12
40,136,0,2,7,5
40,136,1,6,15,9
40,136,2,3,13,10
40,136,3,1,9,8
40,136,4,3,15,12
40,136,5,0,7,7
40,136,6,1,8,7
40,137,0,6,13,7
40,137,1,1,11,10
40,137,2,1,8,7
40,137,3,2,9,7
40,137,4,2,13,11
40,137,5,0,7,7
40,137,6,0,5,5
40,138,0,0,3,3
40,138,1,4,12,8
40,138,2,1,8,7
40,138,3,2,12,10
40,138,4,0,5,5
40,138,5,1,9,8
40,138,6,2,9,7
40,139,0,2,8,6
40,139,1,0,6,6
40,139,2,0,4,4
40,139,3,0,9,9
40,139,4,0,1,1
40,139,5,4,9,5
40,139,6,5,8,3
40,140,0,1,4,3
40,140,1,0,5,5
40,140,2,2,10,8
40,140,3,1,3,2
40,140,4,0,6,6
40,140,5,5,18,13
40,140,6,5,11,6
40,141,0,0,2,2
40,141,1,1,9,8
40,141,2,0,7,7
40,141,3,0,4,4
40,141,4,1,9,8
40,141,5,2,4,2
40,141,6,4,9,5
40,142,0,0,2,2
40,142,1,3,5,2
40,142,2,4,6,2
40,142,3,0,2,2
40,142,4,2,6,4
40,142,5,5,9,4
40,142,6,3,11,8
40,143,0,1,6,5
40,143,1,1,5,4
40,143,2,3,6,3
40,143,3,0,2,2
40,143,4,0,5,5
40,143,5,6,12,6
40,143,6,2,8,6
41,0,0,4,5,1
41,0,1,0,3,3
41,0,2,1,3,2
41,0,3,1,4,3
41,0,4,1,6,5
41,0,5,1,5,4
41,0,6,0,7,7
41,1,0,3,6,3
41,1,1,0,5,5
41,1,2,5,9,4
41,1,3,1,2,1
41,1,4,1,10,9
41,1,5,0,7,7
41,1,6,0,6,6
41,2,0,7,10,3
41,2,1,0,2,2
41,2,2,6,9,3
41,2,3,2,4,2
41,2,4,1,9,8
41,2,5,3,6,3
41,2,6,2,6,4
41,3,0,3,8,5
41,3,1,3,8,5
41,3,2,4,6,2
41,3,3,3,6,3
41,3,4,0,5,5
41,3,5,2,9,7
41,3,6,0,8,8
41,4,0,0,2,2
41,4,1,7,9,2
41,4,2,1,3,2
41,4,3,1,4,3
41,4,4,0,3,3
41,4,5,0,5,5
41,4,6,1,3,2
41,5,0,2,2,0
41,5,1,1,4,3
41,5,2,1,2,1
41,5,3,0,6,6
41,5,4,2,5,3
41,5,5,1,3,2
41,5,6,0,1,1
41,6,0,1,3,2
41,6,1,2,5,3
41,6,4,0,2,2
41,6,5,0,2,2
41,6,6,1,4,3
41,7,0,4,6,2
41,7,1,1,5,4
41,7,2,0,1,1
41,7,3,2,3,1
41,7,4,0,3,3
41,7,5,0,1,1
41,7,6,2,3,1
41,8,0,2,5,3
41,8,1,3,5,2
41,8,3,2,5,3
41,8,4,0,2,2
41,8,5,0,1,1
41,8,6,2,7,5
41,9,0,3,3,0
41,9,1,6,6,0
41,9,2,0,1,1
41,9,3,2,5,3
41,9,4,0,2,2
41,9,5,4,5,1
41,9,6,0,1,1
41,10,1,0,1,1
41,10,2,1,3,2
41,10,3,0,3,3
41,10,4,0,1,1
41,10,6,6,8,2
41,11,0,0,1,1
41,11,1,2,3,1
41,11,2,0,4,4
41,11,4,0,1,1
41,11,5,3,6,3
41,11,6,7,7,0
41,12,1,2,2,0
41,12,2,1,1,0
41,12,4,0,7,7
41,12,5,1,1,0
41,12,6,6,8,2
41,13,0,1,1,0
41,13,1,1,3,2
41,13,2,2,3,1
41,13,3,5,7,2
41,13,4,0,1,1
41,13,5,1,2,1
41,13,6,6,8,2
41,14,0,2,3,1
41,14,2,7,8,1
41,14,3,3,3,0
41,14,4,0,1,1
41,14,6,3,4,1
41,15,1,0,1,1
41,15,4,0,2,2
41,15,5,0,2,2
41,15,6,0,1,1
41,16,0,2,4,2
41,16,1,2,3,1
41,16,4,1,2,1
41,16,5,0,1,1
41,16,6,1,1,0
41,17,0,0,1,1
41,17,1,0,1,1
41,17,3,0,1,1
41,17,4,0,1,1
41,17,6,1,1,0
41,18,1,0,1,1
41,18,2,2,3,1
41,18,3,2,2,0
41,18,4,1,1,0
41,18,6,0,1,1
41,19,3,5,6,1
41,19,5,0,1,1
41,20,0,1,2,1
41,20,3,1,1,0
41,20,4,1,2,1
41,20,5,0,1,1
41,21,0,2,2,0
41,21,3,1,1,0
41,23,0,2,3,1
41,23,1,2,2,0
41,23,3,0,1,1
41,23,6,1,1,0
41,24,2,0,1,1
41,24,6,1,1,0
41,25,3,1,1,0
41,25,4,2,3,1
41,25,6,1,1,0
41,26,4,2,2,0
41,27,0,0,1,1
41,27,2,1,1,0
41,27,3,1,1,0
41,27,5,1,1,0
41,28,3,0,1,1
41,28,4,3,3,0
41,29,2,1,1,0
41,29,3,0,2,2
41,29,6,0,1,1
41,30,3,2,3,1
41,31,0,1,1,0
41,31,3,2,2,0
41,31,4,0,1,1
41,31,5,0,1,1
41,32,0,3,3,0
41,32,1,2,2,0
41,32,3,0,1,1
41,32,4,5,6,1
41,33,0,1,1,0
41,33,2,1,2,1
41,33,3,0,1,1
41,33,4,5,6,1
41,33,5,6,7,1
41,33,6,1,2,1
41,34,0,5,5,0
41,34,1,0,1,1
41,34,2,1,1,0
41,34,3,1,1,0
41,34,4,1,1,0
41,34,5,7,8,1
41,34,6,1,1,0
41,35,0,1,1,0
41,35,2,2,2,0
41,35,4,2,4,2
41,35,5,3,4,1
41,35,6,1,2,1
41,36,2,1,1,0
41,36,3,1,3,2
41,36,4,1,1,0
41,36,5,0,1,1
41,36,6,1,1,0
41,37,0,4,4,0
41,37,1,0,1,1
41,37,2,0,1,1
41,37,4,1,2,1
41,37,6,2,3,1
41,38,0,4,6,2
41,38,1,0,2,2
41,38,2,2,3,1
41,38,3,2,6,4
41,38,4,2,6,4
41,38,5,1,2,1
41,38,6,1,3,2
41,39,0,2,9,7
41,39,1,1,7,6
41,39,2,2,6,4
41,39,3,1,7,6
41,39,4,2,6,4
41,39,5,1,8,7
41,39,6,1,7,6
41,40,0,1,10,9
41,40,1,1,11,10
41,40,2,2,18,16
41,40,3,0,11,11
41,40,4,3,11,8
41,40,5,6,11,5
41,41,0,1,18,17
41,41,1,0,12,12
41,41,2,0,18,18
41,41,3,2,20,18
41,41,4,3,13,10
41,41,5,6,13,7
41,41,6,2,7,5
41,42,0,1,25,24
41,42,1,0,22,22
41,42,2,2,22,20
41,42,3,1,26,25
41,42,4,1,20,19
41,42,5,5,8,3
41,42,6,4,9,5
41,43,0,3,30,27
41,43,1,0,31,31
41,43,2,0,27,27
41,43,3,0,22,22
41,43,4,3,18,15
41,43,5,0,11,11
41,43,6,3,16,13
41,44,0,5,36,31
41,44,1,0,29,29
41,44,2,0,36,36
41,44,3,0,30,30
41,44,4,3,28,25
41,44,5,2,26,24
41,44,6,8,24,16
41,45,0,7,44,37
41,45,1,1,38,37
41,45,2,4,37,33
41,45,3,1,37,36
41,45,4,9,37,28
41,45,5,3,20,17
41,45,6,1,17,16
41,46,0,3,53,50
41,46,1,1,43,42
41,46,2,1,31,30
41,46,3,2,39,37
41,46,4,5,27,22
41,46,5,0,20,20
41,46,6,3,22,19
41,47,0,0,45,45
41,47,1,2,38,36
41,47,2,4,51,47
41,47,3,2,38,36
41,47,4,1,39,38
41,47,5,0,28,28
41,47,6,1,24,23
41,48,0,20,70,50
41,48,1,3,60,57
41,48,2,3,54,51
41,48,3,2,49,47
41,48,4,1,42,41
41,48,5,1,26,25
41,48,6,9,41,32
41,49,0,21,75,54
41,49,1,0,69,69
41,49,2,2,66,64
41,49,3,3,54,51
41,49,4,1,42,41
41,49,5,8,40,32
41,49,6,9,36,27
41,50,0,17,62,45
41,50,1,2,51,49
41,50,2,3,49,46
41,50,3,8,52,44
41,50,4,3,40,37
41,50,5,4,34,30
41,50,6,3,27,24
41,51,0,17,70,53
41,51,1,12,60,48
41,51,2,9,53,44
41,51,3,6,53,47
41,51,4,8,40,32
41,51,5,3,33,30
41,51,6,7,33,26
41,52,0,19,71,52
41,52,1,8,67,59
41,52,2,4,65,61
41,52,3,5,55,50
41,52,4,6,43,37
41,52,5,9,39,30
41,52,6,6,25,19
41,53,0,18,70,52
41,53,1,7,52,45
41,53,2,4,60,56
41,53,3,6,50,44
41,53,4,7,40,33
41,53,5,7,37,30
41,53,6,7,36,29
41,54,0,13,55,42
41,54,1,6,48,42
41,54,2,9,53,44
41,54,3,11,50,39
41,54,4,3,37,34
41,54,5,4,32,28
41,54,6,2,30,28
41,55,0,6,51,45
41,55,1,9,45,36
41,55,2,9,56,47
41,55,3,7,51,44
41,55,4,8,44,36
41,55,5,2,22,20
41,55,6,7,32,25
41,56,0,10,47,37
41,56,1,8,50,42
41,56,2,6,42,36
41,56,3,14,47,33
41,56,4,3,29,26
41,56,5,4,27,23
41,56,6,11,33,22
41,57,0,10,30,20
41,57,1,5,35,30
41,57,2,0,25,25
41,57,3,20,59,39
41,57,4,15,46,31
41,57,5,3,24,21
41,57,6,7,44,37
41,58,0,17,49,32
41,58,1,2,20,18
41,58,2,7,35,28
41,58,3,8,42,34
41,58,4,15,27,12
41,58,5,0,35,35
41,58,6,5,28,23
41,59,0,5,23,18
41,59,1,5,32,27
41,59,2,7,31,24
41,59,3,17,40,23
41,59,4,16,44,28
41,59,5,8,26,18
41,59,6,10,35,25
41,60,0,13,33,20
41,60,1,1,36,35
41,60,2,2,27,25
41,60,3,5,29,24
41,60,4,17,41,24
41,60,5,6,32,26
41,60,6,10,33,23
41,61,0,22,43,21
41,61,1,3,30,27
41,61,2,2,27,25
41,61,3,6,29,23
41,61,4,15,45,30
41,61,5,6,33,27
41,61,6,12,36,24
41,62,0,2,15,13
41,62,1,2,25,23
41,62,2,8,33,25
41,62,3,7,31,24
41,62,4,29,50,21
41,62,5,2,23,21
41,62,6,9,39,30
41,63,0,2,22,20
41,63,1,1,21,20
41,63,2,2,24,22
41,63,3,10,26,16
41,63,4,21,41,20
41,63,5,1,29,28
41,63,6,5,28,23
41,64,0,1,14,13
41,64,1,1,29,28
41,64,2,3,29,26
41,64,3,14,37,23
41,64,4,24,39,15
41,64,5,3,25,22
41,64,6,7,37,30
41,65,0,4,28,24
41,65,1,2,22,20
41,65,2,5,22,17
41,65,3,10,28,18
41,65,4,18,32,14
41,65,5,4,21,17
41,65,6,12,39,27
41,66,0,4,29,25
41,66,1,4,24,20
41,66,2,4,17,13
41,66,3,3,22,19
41,66,4,12,27,15
41,66,5,6,32,26
41,66,6,3,28,25
41,67,0,3,20,17
41,67,1,1,24,23
41,67,2,10,27,17
41,67,3,3,22,19
41,67,4,15,37,22
41,67,5,1,19,18
41,67,6,12,34,22
41,68,0,5,23,18
41,68,1,1,25,24
41,68,2,11,29,18
41,68,3,9,36,27
41,68,4,13,35,22
41,68,5,1,25,24
41,68,6,14,36,22
41,69,0,7,35,28
41,69,1,7,39,32
41,69,2,4,21,17
41,69,3,4,30,26
41,69,4,30,55,25
41,69,5,0,32,32
41,69,6,10,29,19
41,70,0,9,24,15
41,70,1,2,26,24
41,70,2,5,25,20
41,70,3,7,29,22
41,70,4,20,49,29
41,70,5,2,37,35
41,70,6,12,37,25
41,71,0,5,23,18
41,71,1,15,46,31
41,71,2,13,44,31
41,71,3,7,33,26
41,71,4,11,28,17
41,71,5,3,22,19
41,71,6,6,38,32
41,72,0,5,26,21
41,72,1,7,20,13
41,72,2,13,40,27
41,72,3,20,40,20
41,72,4,27,50,23
41,72,5,5,37,32
41,72,6,9,35,26
41,73,0,8,31,23
41,73,1,18,34,16
41,73,2,8,34,26
41,73,3,14,42,28
41,73,4,30,62,32
41,73,5,5,25,20
41,73,6,7,43,36
41,74,0,8,25,17
41,74,1,14,45,31
41,74,2,17,39,22
41,74,3,28,62,34
41,74,4,10,39,29
41,74,5,7,44,37
41,74,6,6,38,32
41,75,0,17,38,21
41,75,1,6,26,20
41,75,2,15,34,19
41,75,3,14,41,27
41,75,4,12,40,28
41,75,5,3,29,26
41,75,6,3,46,43
41,76,0,6,33,27
41,76,1,5,36,31
41,76,2,30,60,30
41,76,3,10,24,14
41,76,4,7,37,30
41,76,5,0,33,33
41,76,6,7,34,27
41,77,0,6,38,32
41,77,1,4,30,26
41,77,2,27,61,34
41,77,3,31,62,31
41,77,4,29,62,33
41,77,5,6,39,33
41,77,6,12,37,25
41,78,0,1,23,22
41,78,1,8,42,34
41,78,2,6,28,22
41,78,3,21,49,28
41,78,4,7,23,16
41,78,5,12,35,23
41,78,6,5,38,33
41,79,0,3,34,31
41,79,1,5,38,33
41,79,2,15,47,32
41,79,3,6,23,17
41,79,4,6,28,22
41,79,5,6,30,24
41,79,6,1,28,27
41,80,0,3,27,24
41,80,1,2,31,29
41,80,2,6,27,21
41,80,3,5,40,35
41,80,4,2,32,30
41,80,5,8,38,30
41,80,6,3,36,33
41,81,0,1,22,21
41,81,1,3,27,24
41,81,2,8,33,25
41,81,3,5,37,32
41,81,4,1,23,22
41,81,5,5,25,20
41,81,6,6,38,32
41,82,0,1,23,22
41,82,1,5,30,25
41,82,2,5,27,22
41,82,3,13,32,19
41,82,4,3,20,17
41,82,5,10,44,34
41,82,6,5,35,30
41,83,0,4,29,25
41,83,1,10,30,20
41,83,2,5,27,22
41,83,3,16,42,26
41,83,4,9,37,28
41,83,5,7,33,26
41,83,6,4,31,27
41,84,0,1,19,18
41,84,1,6,33,27
41,84,2,4,29,25
41,84,3,4,22,18
41,84,4,12,28,16
41,84,5,8,35,27
41,84,6,2,26,24
41,85,0,1,22,21
41,85,1,2,22,20
41,85,2,1,29,28
41,85,3,2,19,17
41,85,4,1,27,26
41,85,5,5,25,20
41,85,6,2,28,26
41,86,0,3,20,17
41,86,1,6,26,20
41,86,2,0,20,20
41,86,3,0,21,21
41,86,4,0,27,27
41,86,5,2,19,17
41,86,6,1,18,17
41,87,0,0,17,17
41,87,1,1,15,14
41,87,2,1,23,22
41,87,3,1,15,14
41,87,4,1,15,14
41,87,5,7,26,19
41,87,6,5,25,20
41,88,0,5,25,20
41,88,1,1,19,18
41,88,2,0,19,19
41,88,3,0,19,19
41,88,4,3,14,11
41,88,5,5,29,24
41,88,6,4,24,20
41,89,0,1,17,16
41,89,1,1,33,32
41,89,2,2,18,16
41,89,3,2,28,26
41,89,4,3,29,26
41,89,5,1,24,23
41,89,6,3,26,23
41,90,0,0,28,28
41,90,1,4,20,16
41,90,2,6,23,17
41,90,3,1,21,20
41,90,4,4,28,24
41,90,5,3,29,26
41,90,6,2,20,18
41,91,0,3,22,19
41,91,1,3,24,21
41,91,2,4,24,20
41,91,3,2,19,17
41,91,4,3,29,26
41,91,5,1,25,24
41,91,6,3,24,21
41,92,0,1,23,22
41,92,1,0,13,13
41,92,2,5,24,19
41,92,3,1,26,25
41,92,4,6,25,19
41,92,5,1,19,18
41,92,6,2,23,21
41,93,0,0,16,16
41,93,1,1,23,22
41,93,2,0,28,28
41,93,3,0,26,26
41,93,4,6,33,27
41,93,5,4,24,20
41,93,6,1,32,31
41,94,0,1,24,23
41,94,1,1,20,19
41,94,2,2,24,22
41,94,3,1,32,31
41,94,4,0,31,31
41,94,5,2,26,24
41,94,6,4,36,32
41,95,0,0,22,22
41,95,1,1,33,32
41,95,2,3,44,41
41,95,3,0,25,25
41,95,4,1,20,19
41,95,5,2,18,16
41,95,6,2,25,23
41,96,0,0,28,28
41,96,1,2,25,23
41,96,2,0,23,23
41,96,3,0,20,20
41,96,4,0,25,25
41,96,5,2,26,24
41,96,6,3,35,32
41,97,0,1,33,32
41,97,1,1,35,34
41,97,2,1,28,27
41,97,3,1,24,23
41,97,4,1,19,18
41,97,5,5,34,29
41,97,6,0,23,23
41,98,0,2,34,32
41,98,1,1,34,33
41,98,2,1,40,39
41,98,3,1,35,34
41,98,4,4,25,21
41,98,5,0,20,20
41,98,6,1,22,21
41,99,0,0,25,25
41,99,1,0,28,28
41,99,2,6,34,28
41,99,3,2,29,27
41,99,4,1,18,17
41,99,5,1,30,29
41,99,6,1,30,29
41,100,0,0,27,27
41,100,1,4,40,36
41,100,2,1,33,32
41,100,3,5,44,39
41,100,4,1,31,30
41,100,5,5,37,32
41,100,6,1,32,31
41,101,0,0,37,37
41,101,1,1,41,40
41,101,2,1,43,42
41,101,3,0,32,32
41,101,4,2,29,27
41,101,5,3,38,35
41,101,6,2,30,28
41,102,0,4,37,33
41,102,1,58,115,57
41,102,2,6,48,42
41,102,3,1,40,39
41,102,4,1,40,39
41,102,5,1,46,45
41,102,6,1,34,33
41,103,0,2,32,30
41,103,1,35,76,41
41,103,2,6,53,47
41,103,3,1,39,38
41,103,4,2,51,49
41,103,5,2,42,40
41,103,6,0,31,31
41,104,0,1,31,30
41,104,1,15,54,39
41,104,2,7,54,47
41,104,3,1,30,29
41,104,4,4,42,38
41,104,5,0,32,32
41,104,6,0,29,29
41,105,0,1,42,41
41,105,1,3,54,51
41,105,2,4,54,50
41,105,3,4,46,42
41,105,4,2,39,37
41,105,5,1,29,28
41,105,6,2,38,36
41,106,0,2,52,50
41,106,1,3,36,33
41,106,2,6,61,55
41,106,3,5,41,36
41,106,4,3,41,38
41,106,5,2,25,23
41,106,6,2,44,42
41,107,0,1,37,36
41,107,1,2,27,25
41,107,2,1,41,40
41,107,3,0,28,28
41,107,4,1,30,29
41,107,5,0,39,39
41,107,6,5,51,46
41,108,0,0,25,25
41,108,1,1,42,41
41,108,2,2,45,43
41,108,3,0,48,48
41,108,4,1,44,43
41,108,5,3,25,22
41,108,6,1,37,36
41,109,0,1,44,43
41,109,1,1,38,37
41,109,2,2,37,35
41,109,3,1,45,44
41,109,4,0,42,42
41,109,5,1,32,31
41,109,6,2,23,21
41,110,0,0,34,34
41,110,1,1,41,40
41,110,2,2,37,35
41,110,3,1,44,43
41,110,4,2,36,34
41,110,5,0,19,19
41,110,6,1,43,42
41,111,0,2,47,45
41,111,1,4,41,37
41,111,2,0,29,29
41,111,3,4,36,32
41,111,4,2,33,31
41,111,5,0,27,27
41,111,6,0,33,33
41,112,0,0,33,33
41,112,1,0,37,37
41,112,2,0,27,27
41,112,3,5,45,40
41,112,4,2,37,35
41,112,5,0,26,26
41,112,6,0,25,25
41,113,0,0,38,38
41,113,1,1,38,37
41,113,2,5,45,40
41,113,3,0,22,22
41,113,4,1,26,25
41,113,5,3,29,26
41,113,6,3,39,36
41,114,0,1,22,21
41,114,1,1,26,25
41,114,2,2,29,27
41,114,3,1,35,34
41,114,4,2,36,34
41,114,5,0,21,21
41,114,6,1,19,18
41,115,0,1,26,25
41,115,1,0,13,13
41,115,2,3,25,22
41,115,3,1,25,24
41,115,4,0,22,22
41,115,5,2,26,24
41,115,6,1,21,20
41,116,0,0,20,20
41,116,1,0,22,22
41,116,2,2,26,24
41,116,3,3,26,23
41,116,4,2,28,26
41,116,5,0,14,14
41,116,6,4,28,24
41,117,0,2,21,19
41,117,1,2,22,20
41,117,2,1,24,23
41,117,3,2,22,20
41,117,4,6,32,26
41,117,5,1,15,14
41,117,6,2,24,22
41,118,0,0,14,14
41,118,1,1,19,18
41,118,2,7,27,20
41,118,3,1,33,32
41,118,4,1,29,28
41,118,5,1,24,23
41,118,6,1,25,24
41,119,0,2,15,13
41,119,1,3,21,18
41,119,2,2,18,16
41,119,3,0,25,25
41,119,4,1,16,15
41,119,5,5,25,20
41,119,6,2,24,22
41,120,0,0,15,15
41,120,1,2,18,16
41,120,2,1,20,19
41,120,3,4,30,26
41,120,4,4,31,27
41,120,5,4,21,17
41,120,6,0,19,19
41,121,0,1,21,20
41,121,1,1,23,22
41,121,2,5,23,18
41,121,3,1,11,10
41,121,4,0,23,23
41,121,5,0,26,26
41,121,6,4,15,11
41,122,0,3,19,16
41,122,1,2,23,21
41,122,2,1,24,23
41,122,3,4,24,20
41,122,4,0,18,18
41,122,5,1,18,17
41,122,6,0,14,14
41,123,0,1,21,20
41,123,1,2,21,19
41,123,2,2,21,19
41,123,3,1,19,18
41,123,4,2,23,21
41,123,5,0,23,23
41,123,6,0,17,17
41,124,0,2,20,18
41,124,1,3,23,20
41,124,2,1,11,10
41,124,3,1,22,21
41,124,4,1,18,17
41,124,5,1,19,18
41,124,6,0,19,19
41,125,0,1,20,19
41,125,1,0,18,18
41,125,2,1,20,19
41,125,3,1,17,16
41,125,4,5,24,19
41,125,5,1,15,14
41,125,6,1,15,14
41,126,0,4,24,20
41,126,1,1,22,21
41,126,2,1,19,18
41,126,3,0,11,11
41,126,4,0,18,18
41,126,5,0,9,9
41,126,6,1,15,14
41,127,0,4,24,20
41,127,1,1,20,19
41,127,2,0,27,27
41,127,3,2,14,12
41,127,4,1,21,20
41,127,5,0,16,16
41,127,6,0,14,14
41,128,0,2,16,14
41,128,1,0,13,13
41,128,2,5,25,20
41,128,3,1,11,10
41,128,4,0,7,7
41,128,5,0,15,15
41,128,6,0,7,7
41,129,0,4,16,12
41,129,1,1,16,15
41,129,2,1,9,8
41,129,3,1,13,12
41,129,4,2,15,13
41,129,5,2,17,15
41,129,6,0,10,10
41,130,0,1,16,15
41,130,1,1,17,16
41,130,2,2,23,21
41,130,3,3,21,18
41,130,4,0,14,14
41,130,5,2,16,14
41,130,6,1,16,15
41,131,0,0,10,10
41,131,1,1,20,19
41,131,2,1,16,15
41,131,3,3,21,18
41,131,4,0,11,11
41,131,5,0,18,18
41,131,6,2,20,18
41,132,0,2,11,9
41,132,1,0,10,10
41,132,2,1,18,17
41,132,3,2,24,22
41,132,4,0,10,10
41,132,5,1,14,13
41,132,6,2,18,16
41,133,0,1,16,15
41,133,1,1,12,11
41,133,2,2,13,11
41,133,3,2,14,12
41,133,4,0,5,5
41,133,5,0,14,14
41,133,6,0,10,10
41,134,0,0,7,7
41,134,1,2,9,7
41,134,2,1,9,8
41,134,3,0,8,8
41,134,4,3,13,10
41,134,5,1,15,14
41,134,6,0,10,10
41,135,0,1,15,14
41,135,1,3,18,15
41,135,2,2,13,11
41,135,3,0,10,10
41,135,4,1,14,13
41,135,5,1,16,15
41,135,6,3,18,15
41,136,0,1,9,8
41,136,1,0,11,11
41,136,2,2,9,7
41,136,3,0,9,9
41,136,4,0,14,14
41,136,5,0,5,5
41,136,6,3,13,10
41,137,0,1,7,6
41,137,1,1,11,10
41,137,2,0,14,14
41,137,3,0,6,6
41,137,4,3,10,7
41,137,5,0,10,10
41,137,6,2,13,11
41,138,0,0,6,6
41,138,1,0,5,5
41,138,2,0,4,4
41,138,3,0,9,9
41,138,4,2,11,9
41,138,5,0,4,4
41,138,6,2,5,3
41,139,0,1,15,14
41,139,1,3,19,16
41,139,2,1,9,8
41,139,3,0,11,11
41,139,4,2,7,5
41,139,5,1,8,7
41,139,6,1,8,7
41,140,0,7,14,7
41,140,1,0,9,9
41,140,2,0,6,6
41,140,3,3,7,4
41,140,4,0,4,4
41,140,5,2,7,5
41,140,6,2,11,9
41,141,0,3,8,5
41,141,1,2,9,7
41,141,2,2,6,4
41,141,3,1,10,9
41,141,4,2,10,8
41,141,5,6,15,9
41,141,6,1,7,6
41,142,0,4,10,6
41,142,1,2,10,8
41,142,2,0,7,7
41,142,3,1,11,10
41,142,4,6,10,4
41,142,5,0,12,12
41,142,6,2,7,5
41,143,0,0,9,9
41,143,1,0,7,7
41,143,2,0,9,9
41,143,3,1,6,5
41,143,4,2,10,8
41,143,5,1,4,3
41,143,6,0,7,7
42,0,0,15,116,101
42,0,1,5,105,100
42,0,2,15,97,82
42,0,3,5,111,106
42,0,4,8,165,157
42,0,5,12,114,102
42,0,6,8,150,142
42,1,0,10,89,79
42,1,1,28,113,85
42,1,2,7,94,87
42,1,3,6,91,85
42,1,4,14,142,128
42,1,5,3,103,100
42,1,6,11,110,99
42,2,0,11,94,83
42,2,1,3,69,66
42,2,2,1,63,62
42,2,3,4,83,79
42,2,4,9,135,126
42,2,5,6,91,85
42,2,6,5,112,107
42,3,0,14,101,87
42,3,1,13,82,69
42,3,2,3,92,89
42,3,3,6,102,96
42,3,4,4,116,112
42,3,5,10,121,111
42,3,6,22,120,98
42,4,0,10,79,69
42,4,1,6,66,60
42,4,2,5,47,42
42,4,3,3,75,72
42,4,4,7,110,103
42,4,5,12,95,83
42,4,6,11,84,73
42,5,0,26,108,82
42,5,1,4,68,64
42,5,2,2,77,75
42,5,3,3,82,79
42,5,4,5,111,106
42,5,5,4,99,95
42,5,6,3,73,70
42,6,0,27,92,65
42,6,1,7,74,67
42,6,2,5,76,71
42,6,3,2,69,67
42,6,4,7,104,97
42,6,5,3,79,76
42,6,6,20,107,87
42,7,0,11,75,64
42,7,1,17,64,47
42,7,2,8,76,68
42,7,3,2,57,55
42,7,4,1,86,85
42,7,5,4,83,79
42,7,6,5,70,65
42,8,0,11,60,49
42,8,1,3,51,48
42,8,2,1,46,45
42,8,3,6,72,66
42,8,4,7,92,85
42,8,5,3,68,65
42,8,6,11,83,72
42,9,0,3,55,52
42,9,1,6,54,48
42,9,2,1,46,45
42,9,3,8,51,43
42,9,4,6,70,64
42,9,5,5,60,55
42,9,6,6,63,57
42,10,0,4,29,25
42,10,1,3,34,31
42,10,2,1,40,39
42,10,3,1,42,41
42,10,4,6,72,66
42,10,5,2,50,48
42,10,6,10,71,61
42,11,0,4,42,38
42,11,1,5,46,41
42,11,2,3,43,40
42,11,3,5,51,46
42,11,4,3,61,58
42,11,5,5,71,66
42,11,6,7,66,59
42,12,0,2,36,34
42,12,1,3,43,40
42,12,2,0,39,39
42,12,3,4,53,49
42,12,4,3,63,60
42,12,5,3,47,44
42,12,6,1,49,48
42,13,0,12,47,35
42,13,1,3,45,42
42,13,2,2,35,33
42,13,3,9,46,37
42,13,4,4,49,45
42,13,5,6,58,52
42,13,6,4,60,56
42,14,0,1,30,29
42,14,1,2,40,38
42,14,2,3,26,23
42,14,3,7,41,34
42,14,4,4,63,59
42,14,5,2,38,36
42,14,6,9,49,40
42,15,0,5,41,36
42,15,1,6,32,26
42,15,2,4,34,30
42,15,3,8,50,42
42,15,4,3,48,45
42,15,5,1,38,37
42,15,6,2,30,28
42,16,0,3,34,31
42,16,1,3,32,29
42,16,2,2,25,23
42,16,3,0,30,30
42,16,4,3,52,49
42,16,5,3,29,26
42,16,6,6,34,28
42,17,0,5,39,34
42,17,1,12,38,26
42,17,2,2,27,25
42,17,3,4,31,27
42,17,4,2,29,27
42,17,5,0,31,31
42,17,6,8,34,26
42,18,0,7,29,22
42,18,1,3,25,22
42,18,2,2,29,27
42,18,3,4,31,27
42,18,4,4,29,25
42,18,5,6,30,24
42,18,6,3,40,37
42,19,0,13,46,33
42,19,1,5,36,31
42,19,2,0,24,24
42,19,3,2,23,21
42,19,4,7,34,27
42,19,5,7,33,26
42,19,6,1,26,25
42,20,0,7,25,18
42,20,1,9,28,19
42,20,2,6,28,22
42,20,3,2,18,16
42,20,4,7,29,22
42,20,5,0,22,22
42,20,6,2,27,25
42,21,0,5,29,24
42,21,1,3,24,21
42,21,2,2,27,25
42,21,3,5,31,26
42,21,4,4,28,24
42,21,5,1,18,17
42,21,6,3,20,17
42,22,0,2,12,10
42,22,1,6,22,16
42,22,2,3,23,20
42,22,3,3,15,12
42,22,4,1,18,17
42,22,5,0,21,21
42,22,6,1,28,27
42,23,0,3,27,24
42,23,1,11,29,18
42,23,2,1,11,10
42,23,3,6,19,13
42,23,4,1,21,20
42,23,5,3,17,14
42,23,6,7,37,30
42,24,0,3,22,19
42,24,1,12,35,23
42,24,2,4,26,22
42,24,3,0,24,24
42,24,4,2,23,21
42,24,5,7,33,26
42,24,6,8,28,20
42,25,0,4,17,13
42,25,1,7,25,18
42,25,2,2,16,14
42,25,3,1,10,9
42,25,4,3,27,24
42,25,5,6,28,22
42,25,6,7,25,18
42,26,0,5,19,14
42,26,1,0,8,8
42,26,2,2,16,14
42,26,3,3,17,14
42,26,4,2,21,19
42,26,5,4,16,12
42,26,6,0,16,16
42,27,0,9,24,15
42,27,1,4,15,11
42,27,2,1,17,16
42,27,3,0,15,15
42,27,4,1,21,20
42,27,5,10,20,10
42,27,6,0,18,18
42,28,0,0,18,18
42,28,1,6,18,12
42,28,2,3,18,15
42,28,3,6,21,15
42,28,4,13,32,19
42,28,5,8,18,10
42,28,6,2,14,12
42,29,0,0,12,12
42,29,1,1,17,16
42,29,2,2,14,12
42,29,3,12,21,9
42,29,4,13,28,15
42,29,5,7,21,14
42,29,6,0,14,14
42,30,0,4,18,14
42,30,1,1,14,13
42,30,2,5,19,14
42,30,3,10,25,15
42,30,4,7,20,13
42,30,5,4,18,14
42,30,6,3,24,21
42,31,0,1,16,15
42,31,1,2,23,21
42,31,2,9,21,12
42,31,3,8,19,11
42,31,4,13,29,16
42,31,5,7,18,11
42,31,6,0,16,16
42,32,0,3,17,14
42,32,1,13,24,11
42,32,2,13,25,12
42,32,3,6,19,13
42,32,4,15,31,16
42,32,5,8,25,17
42,32,6,5,18,13
42,33,0,11,25,14
42,33,1,8,26,18
42,33,2,7,15,8
42,33,3,8,17,9
42,33,4,13,28,15
42,33,5,4,19,15
42,33,6,11,33,22
42,34,0,10,24,14
42,34,1,11,33,22
42,34,2,12,25,13
42,34,3,6,20,14
42,34,4,27,50,23
42,34,5,1,15,14
42,34,6,8,24,16
42,35,0,9,20,11
42,35,1,13,25,12
42,35,2,9,27,18
42,35,3,14,28,14
42,35,4,22,43,21
42,35,5,2,18,16
42,35,6,3,25,22
42,36,0,32,60,28
42,36,1,17,39,22
42,36,2,11,35,24
42,36,3,9,29,20
42,36,4,40,59,19
42,36,5,16,36,20
42,36,6,14,33,19
42,37,0,23,46,23
42,37,1,14,45,31
42,37,2,11,28,17
42,37,3,19,48,29
42,37,4,66,90,24
42,37,5,10,35,25
42,37,6,12,29,17
42,38,0,23,61,38
42,38,1,16,56,40
42,38,2,21,59,38
42,38,3,14,46,32
42,38,4,37,80,43
42,38,5,14,45,31
42,38,6,17,52,35
42,39,0,6,89,83
42,39,1,7,84,77
42,39,2,2,63,61
42,39,3,5,65,60
42,39,4,31,93,62
42,39,5,3,44,41
42,39,6,5,51,46
42,40,0,1,78,77
42,40,1,2,95,93
42,40,2,2,95,93
42,40,3,4,78,74
42,40,4,16,95,79
42,40,5,2,57,55
42,40,6,3,62,59
42,41,0,1,124,123
42,41,1,2,118,116
42,41,2,7,122,115
42,41,3,5,112,107
42,41,4,10,105,95
42,41,5,8,81,73
42,41,6,6,63,57
42,42,0,8,202,194
42,42,1,7,164,157
42,42,2,8,190,182
42,42,3,9,179,170
42,42,4,9,152,143
42,42,5,5,117,112
42,42,6,4,81,77
42,43,0,7,227,220
42,43,1,5,215,210
42,43,2,7,241,234
42,43,3,6,216,210
42,43,4,12,188,176
42,43,5,10,126,116
42,43,6,21,129,108
42,44,0,5,277,272
42,44,1,8,251,243
42,44,2,6,264,258
42,44,3,4,248,244
42,44,4,11,248,237
42,44,5,12,140,128
42,44,6,22,140,118
42,45,0,14,355,341
42,45,1,8,333,325
42,45,2,9,361,352
42,45,3,8,362,354
42,45,4,6,224,218
42,45,5,8,178,170
42,45,6,2,149,147
42,46,0,40,404,364
42,46,1,13,369,356
42,46,2,10,341,331
42,46,3,39,408,369
42,46,4,4,257,253
42,46,5,10,215,205
42,46,6,11,169,158
42,47,0,155,555,400
42,47,1,24,431,407
42,47,2,34,464,430
42,47,3,70,503,433
42,47,4,8,342,334
42,47,5,8,202,194
42,47,6,18,192,174
42,48,0,427,821,394
42,48,1,146,612,466
42,48,2,141,563,422
42,48,3,64,535,471
42,48,4,58,389,331
42,48,5,18,278,260
42,48,6,25,205,180
42,49,0,377,770,393
42,49,1,153,585,432
42,49,2,125,524,399
42,49,3,85,501,416
42,49,4,81,406,325
42,49,5,34,294,260
42,49,6,15,217,202
42,50,0,253,671,418
42,50,1,99,531,432
42,50,2,104,548,444
42,50,3,46,510,464
42,50,4,49,392,343
42,50,5,8,255,247
42,50,6,15,226,211
42,51,0,294,728,434
42,51,1,183,593,410
42,51,2,187,628,441
42,51,3,56,518,462
42,51,4,83,420,337
42,51,5,8,304,296
42,51,6,31,243,212
42,52,0,249,631,382
42,52,1,161,578,417
42,52,2,118,503,385
42,52,3,51,447,396
42,52,4,68,389,321
42,52,5,15,281,266
42,52,6,17,231,214
42,53,0,87,439,352
42,53,1,41,347,306
42,53,2,22,331,309
42,53,3,14,315,301
42,53,4,12,253,241
42,53,5,4,190,186
42,53,6,4,194,190
42,54,0,23,363,340
42,54,1,13,306,293
42,54,2,12,286,274
42,54,3,9,324,315
42,54,4,5,228,223
42,54,5,4,163,159
42,54,6,12,187,175
42,55,0,33,325,292
42,55,1,9,279,270
42,55,2,6,275,269
42,55,3,9,321,312
42,55,4,9,233,224
42,55,5,5,187,182
42,55,6,6,162,156
42,56,0,8,259,251
42,56,1,10,254,244
42,56,2,4,288,284
42,56,3,9,266,257
42,56,4,7,241,234
42,56,5,9,207,198
42,56,6,3,169,166
42,57,0,4,215,211
42,57,1,11,230,219
42,57,2,9,230,221
42,57,3,14,235,221
42,57,4,6,194,188
42,57,5,6,192,186
42,57,6,6,176,170
42,58,0,4,210,206
42,58,1,6,215,209
42,58,2,22,238,216
42,58,3,16,220,204
42,58,4,7,199,192
42,58,5,5,181,176
42,58,6,4,163,159
42,59,0,11,206,195
42,59,1,5,221,216
42,59,2,11,202,191
42,59,3,5,201,196
42,59,4,12,237,225
42,59,5,2,161,159
42,59,6,5,183,178
42,60,0,9,199,190
42,60,1,13,207,194
42,60,2,7,176,169
42,60,3,9,187,178
42,60,4,4,188,184
42,60,5,6,204,198
42,60,6,2,150,148
42,61,0,19,215,196
42,61,1,10,178,168
42,61,2,15,194,179
42,61,3,5,193,188
42,61,4,15,207,192
42,61,5,5,182,177
42,61,6,3,174,171
42,62,0,3,178,175
42,62,1,5,188,183
42,62,2,16,206,190
42,62,3,9,192,183
42,62,4,13,199,186
42,62,5,11,220,209
42,62,6,5,188,183
42,63,0,14,178,164
42,63,1,7,158,151
42,63,2,12,181,169
42,63,3,14,176,162
42,63,4,21,193,172
42,63,5,3,174,171
42,63,6,8,171,163
42,64,0,10,172,162
42,64,1,7,166,159
42,64,2,5,165,160
42,64,3,14,174,160
42,64,4,11,173,162
42,64,5,8,179,171
42,64,6,10,155,145
42,65,0,9,170,161
42,65,1,8,164,156
42,65,2,11,158,147
42,65,3,6,157,151
42,65,4,18,204,186
42,65,5,1,142,141
42,65,6,4,187,183
42,66,0,10,168,158
42,66,1,15,196,181
42,66,2,14,165,151
42,66,3,3,175,172
42,66,4,17,156,139
42,66,5,1,176,175
42,66,6,0,181,181
42,67,0,5,177,172
42,67,1,6,178,172
42,67,2,11,168,157
42,67,3,1,178,177
42,67,4,18,173,155
42,67,5,4,175,171
42,67,6,9,210,201
42,68,0,2,156,154
42,68,1,12,161,149
42,68,2,11,176,165
42,68,3,16,243,227
42,68,4,23,205,182
42,68,5,4,189,185
42,68,6,5,216,211
42,69,0,7,183,176
42,69,1,10,188,178
42,69,2,22,221,199
42,69,3,8,212,204
42,69,4,30,195,165
42,69,5,3,170,167
42,69,6,7,214,207
42,70,0,9,189,180
42,70,1,7,173,166
42,70,2,13,186,173
42,70,3,15,212,197
42,70,4,29,187,158
42,70,5,4,195,191
42,70,6,4,219,215
42,71,0,10,180,170
42,71,1,7,173,166
42,71,2,16,209,193
42,71,3,12,188,176
42,71,4,25,189,164
42,71,5,3,176,173
42,71,6,8,224,216
42,72,0,11,206,195
42,72,1,9,193,184
42,72,2,5,176,171
42,72,3,15,220,205
42,72,4,19,203,184
42,72,5,6,199,193
42,72,6,7,205,198
42,73,0,17,185,168
42,73,1,8,168,160
42,73,2,3,185,182
42,73,3,15,201,186
42,73,4,26,229,203
42,73,5,6,195,189
42,73,6,5,233,228
42,74,0,15,207,192
42,74,1,9,206,197
42,74,2,9,212,203
42,74,3,17,219,202
42,74,4,20,202,182
42,74,5,5,214,209
42,74,6,11,218,207
42,75,0,12,182,170
42,75,1,7,213,206
42,75,2,13,212,199
42,75,3,18,208,190
42,75,4,27,231,204
42,75,5,8,211,203
42,75,6,6,222,216
42,76,0,8,186,178
42,76,1,8,198,190
42,76,2,4,189,185
42,76,3,5,193,188
42,76,4,19,206,187
42,76,5,7,198,191
42,76,6,8,231,223
42,77,0,9,202,193
42,77,1,7,192,185
42,77,2,7,189,182
42,77,3,7,224,217
42,77,4,36,231,195
42,77,5,4,232,228
42,77,6,5,235,230
42,78,0,11,204,193
42,78,1,10,200,190
42,78,2,8,217,209
42,78,3,7,208,201
42,78,4,15,198,183
42,78,5,13,233,220
42,78,6,7,252,245
42,79,0,10,215,205
42,79,1,4,175,171
42,79,2,10,219,209
42,79,3,8,224,216
42,79,4,10,194,184
42,79,5,11,255,244
42,79,6,4,262,258
42,80,0,13,208,195
42,80,1,8,177,169
42,80,2,17,238,221
42,80,3,7,226,219
42,80,4,13,184,171
42,80,5,18,225,207
42,80,6,9,241,232
42,81,0,15,199,184
42,81,1,8,190,182
42,81,2,10,191,181
42,81,3,6,200,194
42,81,4,8,192,184
42,81,5,11,224,213
42,81,6,6,204,198
42,82,0,10,198,188
42,82,1,17,212,195
42,82,2,10,191,181
42,82,3,10,201,191
42,82,4,15,206,191
42,82,5,7,236,229
42,82,6,6,215,209
42,83,0,5,182,177
42,83,1,13,177,164
42,83,2,18,191,173
42,83,3,12,217,205
42,83,4,18,224,206
42,83,5,8,179,171
42,83,6,6,207,201
42,84,0,9,225,216
42,84,1,6,189,183
42,84,2,13,209,196
42,84,3,8,195,187
42,84,4,27,234,207
42,84,5,3,194,191
42,84,6,7,241,234
42,85,0,13,200,187
42,85,1,10,186,176
42,85,2,2,178,176
42,85,3,5,184,179
42,85,4,26,200,174
42,85,5,12,199,187
42,85,6,7,260,253
42,86,0,6,198,192
42,86,1,11,208,197
42,86,2,6,197,191
42,86,3,3,193,190
42,86,4,9,209,200
42,86,5,9,224,215
42,86,6,7,199,192
42,87,0,7,171,164
42,87,1,14,205,191
42,87,2,8,178,170
42,87,3,4,180,176
42,87,4,21,230,209
42,87,5,10,203,193
42,87,6,18,248,230
42,88,0,6,210,204
42,88,1,4,169,165
42,88,2,10,211,201
42,88,3,8,203,195
42,88,4,35,246,211
42,88,5,6,187,181
42,88,6,14,273,259
42,89,0,10,190,180
42,89,1,10,197,187
42,89,2,4,196,192
42,89,3,5,187,182
42,89,4,8,243,235
42,89,5,7,231,224
42,89,6,9,255,246
42,90,0,5,217,212
42,90,1,10,175,165
42,90,2,11,228,217
42,90,3,4,179,175
42,90,4,17,214,197
42,90,5,6,184,178
42,90,6,20,272,252
42,91,0,9,194,185
42,91,1,7,200,193
42,91,2,6,199,193
42,91,3,4,206,202
42,91,4,25,243,218
42,91,5,4,182,178
42,91,6,9,278,269
42,92,0,11,203,192
42,92,1,19,220,201
42,92,2,9,207,198
42,92,3,17,232,215
42,92,4,22,223,201
42,92,5,8,207,199
42,92,6,9,254,245
42,93,0,8,212,204
42,93,1,6,172,166
42,93,2,6,237,231
42,93,3,12,209,197
42,93,4,4,226,222
42,93,5,9,221,212
42,93,6,11,246,235
42,94,0,10,219,209
42,94,1,3,204,201
42,94,2,7,214,207
42,94,3,8,244,236
42,94,4,9,244,235
42,94,5,8,223,215
42,94,6,10,301,291
42,95,0,0,195,195
42,95,1,7,193,186
42,95,2,5,204,199
42,95,3,11,210,199
42,95,4,5,218,213
42,95,5,8,215,207
42,95,6,17,278,261
42,96,0,10,219,209
42,96,1,10,231,221
42,96,2,8,194,186
42,96,3,10,216,206
42,96,4,6,234,228
42,96,5,3,245,242
42,96,6,8,272,264
42,97,0,5,202,197
42,97,1,5,197,192
42,97,2,7,179,172
42,97,3,8,233,225
42,97,4,6,217,211
42,97,5,7,214,207
42,97,6,13,286,273
42,98,0,6,218,212
42,98,1,8,239,231
42,98,2,11,229,218
42,98,3,10,232,222
42,98,4,8,239,231
42,98,5,5,247,242
42,98,6,6,290,284
42,99,0,9,225,216
42,99,1,7,229,222
42,99,2,11,237,226
42,99,3,14,224,210
42,99,4,12,259,247
42,99,5,14,257,243
42,99,6,8,279,271
42,100,0,22,263,241
42,100,1,4,226,222
42,100,2,3,232,229
42,100,3,4,258,254
42,100,4,5,267,262
42,100,5,5,244,239
42,100,6,6,300,294
42,101,0,16,277,261
42,101,1,8,288,280
42,101,2,11,276,265
42,101,3,9,267,258
42,101,4,12,274,262
42,101,5,4,271,267
42,101,6,5,285,280
42,102,0,8,320,312
42,102,1,7,319,312
42,102,2,9,312,303
42,102,3,14,313,299
42,102,4,15,326,311
42,102,5,8,340,332
42,102,6,6,325,319
42,103,0,5,304,299
42,103,1,9,272,263
42,103,2,13,353,340
42,103,3,10,324,314
42,103,4,14,319,305
42,103,5,4,301,297
42,103,6,9,322,313
42,104,0,9,310,301
42,104,1,8,339,331
42,104,2,25,356,331
42,104,3,9,327,318
42,104,4,10,328,318
42,104,5,13,304,291
42,104,6,12,356,344
42,105,0,11,424,413
42,105,1,8,408,400
42,105,2,73,518,445
42,105,3,13,475,462
42,105,4,11,383,372
42,105,5,13,401,388
42,105,6,8,380,372
42,106,0,10,339,329
42,106,1,13,368,355
42,106,2,94,485,391
42,106,3,15,375,360
42,106,4,11,344,333
42,106,5,14,325,311
42,106,6,10,292,282
42,107,0,12,328,316
42,107,1,8,349,341
42,107,2,120,475,355
42,107,3,12,368,356
42,107,4,11,331,320
42,107,5,9,299,290
42,107,6,13,325,312
42,108,0,16,391,375
42,108,1,15,399,384
42,108,2,139,538,399
42,108,3,14,365,351
42,108,4,12,356,344
42,108,5,17,317,300
42,108,6,12,282,270
42,109,0,14,394,380
42,109,1,13,418,405
42,109,2,136,533,397
42,109,3,12,370,358
42,109,4,19,388,369
42,109,5,12,309,297
42,109,6,9,281,272
42,110,0,13,326,313
42,110,1,12,345,333
42,110,2,110,500,390
42,110,3,12,332,320
42,110,4,15,333,318
42,110,5,5,270,265
42,110,6,10,269,259
42,111,0,12,330,318
42,111,1,9,322,313
42,111,2,38,385,347
42,111,3,9,330,321
42,111,4,9,301,292
42,111,5,13,273,260
42,111,6,9,261,252
42,112,0,5,282,277
42,112,1,11,289,278
42,112,2,22,335,313
42,112,3,14,272,258
42,112,4,11,302,291
42,112,5,10,269,259
42,112,6,11,254,243
42,113,0,9,275,266
42,113,1,9,264,255
42,113,2,8,294,286
42,113,3,8,279,271
42,113,4,6,266,260
42,113,5,5,246,241
42,113,6,12,280,268
42,114,0,9,257,248
42,114,1,8,261,253
42,114,2,11,262,251
42,114,3,13,237,224
42,114,4,11,272,261
42,114,5,9,220,211
42,114,6,5,253,248
42,115,0,9,269,260
42,115,1,6,245,239
42,115,2,7,257,250
42,115,3,8,280,272
42,115,4,8,252,244
42,115,5,11,230,219
42,115,6,1,213,212
42,116,0,10,247,237
42,116,1,10,245,235
42,116,2,8,258,250
42,116,3,8,234,226
42,116,4,11,248,237
42,116,5,18,246,228
42,116,6,9,237,228
42,117,0,3,223,220
42,117,1,6,248,242
42,117,2,5,231,226
42,117,3,8,236,228
42,117,4,15,276,261
42,117,5,7,206,199
42,117,6,10,254,244
42,118,0,7,228,221
42,118,1,13,262,249
42,118,2,2,224,222
42,118,3,6,230,224
42,118,4,8,262,254
42,118,5,1,212,211
42,118,6,9,251,242
42,119,0,8,218,210
42,119,1,10,248,238
42,119,2,15,279,264
42,119,3,6,273,267
42,119,4,9,269,260
42,119,5,8,228,220
42,119,6,3,251,248
42,120,0,8,249,241
42,120,1,5,238,233
42,120,2,8,269,261
42,120,3,12,272,260
42,120,4,11,262,251
42,120,5,6,211,205
42,120,6,5,253,248
42,121,0,4,254,250
42,121,1,17,276,259
42,121,2,7,250,243
42,121,3,10,242,232
42,121,4,4,240,236
42,121,5,11,240,229
42,121,6,7,238,231
42,122,0,10,211,201
42,122,1,8,228,220
42,122,2,9,297,288
42,122,3,7,231,224
42,122,4,7,255,248
42,122,5,12,225,213
42,122,6,4,214,210
42,123,0,4,254,250
42,123,1,14,286,272
42,123,2,8,263,255
42,123,3,6,250,244
42,123,4,11,289,278
42,123,5,5,244,239
42,123,6,4,226,222
42,124,0,5,229,224
42,124,1,4,228,224
42,124,2,9,254,245
42,124,3,16,268,252
42,124,4,10,258,248
42,124,5,3,260,257
42,124,6,14,251,237
42,125,0,6,213,207
42,125,1,4,250,246
42,125,2,7,275,268
42,125,3,10,246,236
42,125,4,3,263,260
42,125,5,6,245,239
42,125,6,13,231,218
42,126,0,3,233,230
42,126,1,10,272,262
42,126,2,5,269,264
42,126,3,7,270,263
42,126,4,4,270,266
42,126,5,13,250,237
42,126,6,4,248,244
42,127,0,6,268,262
42,127,1,6,279,273
42,127,2,12,269,257
42,127,3,7,239,232
42,127,4,1,258,257
42,127,5,7,215,208
42,127,6,7,254,247
42,128,0,11,270,259
42,128,1,4,245,241
42,128,2,9,247,238
42,128,3,1,237,236
42,128,4,5,259,254
42,128,5,9,249,240
42,128,6,15,226,211
42,129,0,7,258,251
42,129,1,9,265,256
42,129,2,13,304,291
42,129,3,7,227,220
42,129,4,5,234,229
42,129,5,7,249,242
42,129,6,14,243,229
42,130,0,7,249,242
42,130,1,13,231,218
42,130,2,8,229,221
42,130,3,4,206,202
42,130,4,6,223,217
42,130,5,8,214,206
42,130,6,8,183,175
42,131,0,4,199,195
42,131,1,6,208,202
42,131,2,11,232,221
42,131,3,10,199,189
42,131,4,6,200,194
42,131,5,9,253,244
42,131,6,6,190,184
42,132,0,11,241,230
42,132,1,6,222,216
42,132,2,6,218,212
42,132,3,5,193,188
42,132,4,8,259,251
42,132,5,15,237,222
42,132,6,9,190,181
42,133,0,6,176,170
42,133,1,6,185,179
42,133,2,2,176,174
42,133,3,11,196,185
42,133,4,5,190,185
42,133,5,20,231,211
42,133,6,14,195,181
42,134,0,5,175,170
42,134,1,7,201,194
42,134,2,7,183,176
42,134,3,4,180,176
42,134,4,7,196,189
42,134,5,20,214,194
42,134,6,14,187,173
42,135,0,3,138,135
42,135,1,9,185,176
42,135,2,3,204,201
42,135,3,2,169,167
42,135,4,9,205,196
42,135,5,21,230,209
42,135,6,2,139,137
42,136,0,4,163,159
42,136,1,4,156,152
42,136,2,10,175,165
42,136,3,8,154,146
42,136,4,4,162,158
42,136,5,8,192,184
42,136,6,14,176,162
42,137,0,3,144,141
42,137,1,3,133,130
42,137,2,12,167,155
42,137,3,5,148,143
42,137,4,8,158,150
42,137,5,9,157,148
42,137,6,6,149,143
42,138,0,12,142,130
42,138,1,3,135,132
42,138,2,3,124,121
42,138,3,9,157,148
42,138,4,7,151,144
42,138,5,12,184,172
42,138,6,2,126,124
42,139,0,7,121,114
42,139,1,4,129,125
42,139,2,5,128,123
42,139,3,4,130,126
42,139,4,5,126,121
42,139,5,18,177,159
42,139,6,9,122,113
42,140,0,6,126,120
42,140,1,3,100,97
42,140,2,2,104,102
42,140,3,3,153,150
42,140,4,4,152,148
42,140,5,15,165,150
42,140,6,10,152,142
42,141,0,4,116,112
42,141,1,5,117,112
42,141,2,5,126,121
42,141,3,5,118,113
42,141,4,8,132,124
42,141,5,3,133,130
42,141,6,8,108,100
42,142,0,4,109,105
42,142,1,16,137,121
42,142,2,3,113,110
42,142,3,7,141,134
42,142,4,5,133,128
42,142,5,5,134,129
42,142,6,15,126,111
42,143,0,11,93,82
42,143,1,5,94,89
42,143,2,10,94,84
42,143,3,9,123,114
42,143,4,10,123,113
42,143,5,10,123,113
42,143,6,12,121,109
43,0,6,0,1,1
43,1,5,0,1,1
43,2,1,0,1,1
43,2,2,0,1,1
43,2,6,0,1,1
43,3,1,1,1,0
43,3,6,0,1,1
43,4,1,1,3,2
43,4,4,2,3,1
43,4,5,0,1,1
43,4,6,1,1,0
43,5,4,4,6,2
43,5,5,0,1,1
43,5,6,0,1,1
43,6,0,1,1,0
43,8,5,0,1,1
43,10,0,4,4,0
43,10,1,0,1,1
43,11,0,1,1,0
43,11,3,1,1,0
43,12,3,1,1,0
43,13,0,1,1,0
43,15,3,1,1,0
43,18,3,9,9,0
43,19,3,8,8,0
43,20,3,4,5,1
43,24,3,1,1,0
43,28,1,1,1,0
43,29,1,1,1,0
43,29,4,1,1,0
43,30,4,8,8,0
43,31,1,1,1,0
43,31,4,1,1,0
43,32,1,0,1,1
43,33,2,1,1,0
43,35,3,1,1,0
43,36,2,1,1,0
43,37,1,1,1,0
43,37,4,1,1,0
43,38,6,2,2,0
43,39,1,0,1,1
43,39,2,0,1,1
43,39,4,1,1,0
43,39,5,1,1,0
43,39,6,1,1,0
43,40,1,2,3,1
43,40,4,2,3,1
43,40,6,2,2,0
43,41,1,3,3,0
43,41,3,2,2,0
43,41,4,2,4,2
43,41,6,2,2,0
43,42,0,0,2,2
43,42,1,0,3,3
43,42,2,1,3,2
43,42,3,2,3,1
43,42,4,3,5,2
43,43,1,0,1,1
43,43,2,0,2,2
43,43,3,0,2,2
43,43,4,0,2,2
43,43,5,0,3,3
43,43,6,0,2,2
43,44,0,1,6,5
43,44,1,3,8,5
43,44,2,0,6,6
43,44,3,0,4,4
43,44,4,1,4,3
43,44,5,0,3,3
43,44,6,0,2,2
43,45,0,1,5,4
43,45,1,0,3,3
43,45,2,2,6,4
43,45,3,1,5,4
43,45,4,2,13,11
43,45,5,0,3,3
43,45,6,1,4,3
43,46,0,0,7,7
43,46,1,5,12,7
43,46,2,5,9,4
43,46,3,1,8,7
43,46,4,5,7,2
43,46,5,2,4,2
43,46,6,1,4,3
43,47,0,2,5,3
43,47,1,2,6,4
43,47,2,2,8,6
43,47,3,0,2,2
43,47,4,1,4,3
43,48,0,1,2,1
43,48,1,3,8,5
43,48,2,2,3,1
43,48,3,0,3,3
43,48,4,3,5,2
43,48,5,2,5,3
43,48,6,2,5,3
43,49,0,1,5,4
43,49,1,0,2,2
43,49,2,3,9,6
43,49,3,0,3,3
43,49,4,5,6,1
43,49,5,0,3,3
43,49,6,0,1,1
43,50,0,0,5,5
43,50,1,2,4,2
43,50,2,0,5,5
43,50,3,1,2,1
43,50,4,2,6,4
43,50,5,0,2,2
43,50,6,0,1,1
43,51,0,0,2,2
43,51,1,2,5,3
43,51,2,1,1,0
43,51,3,1,4,3
43,51,4,1,6,5
43,51,5,0,3,3
43,51,6,5,12,7
43,52,0,3,8,5
43,52,1,3,11,8
43,52,2,1,3,2
43,52,3,2,6,4
43,52,4,0,2,2
43,52,5,2,6,4
43,52,6,3,5,2
43,53,0,6,8,2
43,53,1,4,8,4
43,53,2,7,9,2
43,53,3,1,4,3
43,53,4,2,2,0
43,53,5,0,1,1
43,53,6,1,5,4
43,54,0,4,8,4
43,54,1,3,8,5
43,54,2,0,3,3
43,54,3,1,1,0
43,54,4,0,3,3
43,54,5,1,1,0
43,54,6,2,5,3
43,55,0,0,3,3
43,55,1,1,5,4
43,55,2,2,5,3
43,55,3,4,7,3
43,55,4,0,3,3
43,55,5,1,3,2
43,55,6,0,1,1
43,56,1,0,4,4
43,56,2,0,3,3
43,56,3,1,5,4
43,56,4,0,1,1
43,56,5,2,3,1
43,56,6,5,6,1
43,57,0,0,2,2
43,57,1,0,2,2
43,57,2,3,3,0
43,57,3,1,4,3
43,57,4,1,5,4
43,57,5,1,5,4
43,57,6,5,10,5
43,58,0,1,3,2
43,58,1,0,1,1
43,58,2,1,2,1
43,58,3,4,6,2
43,58,4,2,5,3
43,58,5,0,1,1
43,58,6,4,9,5
43,59,0,1,5,4
43,59,1,0,3,3
43,59,2,1,1,0
43,59,3,4,5,1
43,59,4,1,3,2
43,59,5,4,5,1
43,59,6,1,1,0
43,60,0,1,3,2
43,60,1,1,2,1
43,60,2,1,2,1
43,60,3,2,3,1
43,60,4,1,2,1
43,60,5,0,2,2
43,60,6,2,3,1
43,61,0,3,5,2
43,61,1,3,4,1
43,61,2,0,3,3
43,61,3,4,5,1
43,61,4,1,4,3
43,61,5,0,2,2
43,61,6,4,6,2
43,62,0,5,6,1
43,62,1,6,10,4
43,62,2,1,2,1
43,62,3,3,6,3
43,62,4,1,3,2
43,62,5,3,7,4
43,62,6,6,11,5
43,63,0,2,6,4
43,63,1,1,4,3
43,63,2,2,4,2
43,63,3,1,3,2
43,63,4,1,3,2
43,63,5,6,15,9
43,63,6,7,9,2
43,64,0,0,2,2
43,64,1,4,6,2
43,64,2,3,6,3
43,64,3,2,2,0
43,64,4,0,3,3
43,64,5,4,10,6
43,64,6,1,5,4
43,65,0,1,1,0
43,65,1,4,7,3
43,65,2,8,8,0
43,65,3,3,4,1
43,65,4,5,7,2
43,65,5,2,2,0
43,65,6,0,2,2
43,66,0,3,8,5
43,66,1,1,2,1
43,66,2,2,10,8
43,66,3,2,4,2
43,66,4,5,7,2
43,66,5,0,7,7
43,66,6,1,3,2
43,67,0,3,6,3
43,67,1,0,1,1
43,67,2,3,3,0
43,67,3,2,3,1
43,67,4,6,7,1
43,67,5,1,5,4
43,67,6,0,4,4
43,68,0,1,3,2
43,68,1,2,2,0
43,68,2,4,6,2
43,68,3,3,6,3
43,68,4,8,11,3
43,68,5,2,8,6
43,68,6,2,6,4
43,69,0,2,5,3
43,69,1,2,3,1
43,69,2,2,2,0
43,69,3,0,3,3
43,69,4,8,12,4
43,69,5,3,7,4
43,69,6,3,7,4
43,70,0,1,2,1
43,70,1,4,9,5
43,70,2,2,5,3
43,70,4,4,11,7
43,70,5,1,9,8
43,70,6,1,5,4
43,71,0,3,5,2
43,71,1,2,4,2
43,71,2,2,6,4
43,71,3,5,10,5
43,71,4,2,6,4
43,71,5,8,13,5
43,71,6,0,7,7
43,72,0,6,9,3
43,72,1,4,8,4
43,72,2,2,5,3
43,72,3,11,14,3
43,72,4,0,2,2
43,72,5,3,11,8
43,72,6,5,8,3
43,73,0,5,8,3
43,73,1,6,7,1
43,73,2,1,4,3
43,73,3,1,4,3
43,73,4,0,2,2
43,73,5,4,10,6
43,73,6,1,5,4
43,74,0,13,21,8
43,74,1,14,18,4
43,74,2,3,5,2
43,74,3,2,4,2
43,74,4,0,3,3
43,74,5,3,12,9
43,74,6,4,7,3
43,75,0,16,21,5
43,75,1,9,12,3
43,75,2,4,8,4
43,75,3,1,3,2
43,75,4,4,7,3
43,75,5,5,14,9
43,75,6,1,9,8
43,76,0,16,23,7
43,76,1,0,2,2
43,76,2,3,7,4
43,76,3,3,4,1
43,76,4,2,11,9
43,76,5,0,15,15
43,76,6,0,7,7
43,77,0,2,6,4
43,77,1,0,2,2
43,77,2,3,4,1
43,77,3,1,3,2
43,77,4,1,8,7
43,77,5,5,12,7
43,77,6,2,4,2
43,78,0,3,7,4
43,78,1,2,8,6
43,78,2,8,11,3
43,78,3,0,4,4
43,78,4,3,8,5
43,78,5,6,19,13
43,78,6,1,11,10
43,79,0,4,5,1
43,79,1,3,6,3
43,79,2,3,5,2
43,79,3,2,4,2
43,79,4,2,8,6
43,79,5,5,15,10
43,79,6,2,8,6
43,80,0,2,5,3
43,80,1,2,7,5
43,80,2,7,14,7
43,80,3,6,10,4
43,80,4,1,4,3
43,80,5,4,16,12
43,80,6,2,11,9
43,81,0,1,6,5
43,81,1,1,2,1
43,81,2,6,9,3
43,81,3,4,6,2
43,81,4,4,11,7
43,81,5,4,10,6
43,81,6,6,10,4
43,82,0,6,12,6
43,82,1,2,5,3
43,82,2,4,9,5
43,82,3,2,6,4
43,82,4,3,8,5
43,82,5,5,11,6
43,82,6,5,16,11
43,83,0,6,14,8
43,83,1,2,5,3
43,83,2,4,9,5
43,83,3,0,1,1
43,83,4,12,17,5
43,83,5,7,18,11
43,83,6,3,18,15
43,84,0,3,7,4
43,84,1,0,3,3
43,84,2,0,3,3
43,84,3,0,7,7
43,84,4,7,14,7
43,84,5,3,20,17
43,84,6,2,4,2
43,85,0,0,3,3
43,85,2,1,5,4
43,85,3,0,2,2
43,85,4,12,19,7
43,85,5,7,16,9
43,85,6,4,14,10
43,86,0,3,7,4
43,86,1,0,1,1
43,86,2,4,9,5
43,86,3,1,4,3
43,86,4,4,12,8
43,86,5,5,24,19
43,86,6,2,10,8
43,87,0,1,6,5
43,87,1,0,3,3
43,87,2,1,4,3
43,87,3,0,4,4
43,87,4,9,15,6
43,87,5,7,15,8
43,87,6,5,13,8
43,88,0,1,6,5
43,88,1,0,2,2
43,88,2,1,4,3
43,88,3,0,4,4
43,88,4,6,14,8
43,88,5,2,18,16
43,88,6,8,18,10
43,89,0,0,1,1
43,89,1,4,6,2
43,89,2,5,7,2
43,89,3,1,3,2
43,89,4,3,9,6
43,89,5,8,34,26
43,89,6,5,11,6
43,90,0,3,5,2
43,90,1,4,7,3
43,90,2,0,2,2
43,90,3,1,9,8
43,90,4,14,27,13
43,90,5,12,18,6
43,90,6,10,34,24
43,91,0,1,2,1
43,91,1,1,3,2
43,91,2,2,9,7
43,91,3,0,2,2
43,91,4,18,27,9
43,91,5,8,26,18
43,91,6,10,21,11
43,92,0,4,7,3
43,92,1,9,11,2
43,92,2,2,8,6
43,92,3,1,3,2
43,92,4,23,36,13
43,92,5,8,22,14
43,92,6,11,14,3
43,93,1,4,10,6
43,93,2,2,5,3
43,93,3,0,6,6
43,93,4,6,22,16
43,93,5,2,16,14
43,93,6,2,9,7
43,94,0,2,6,4
43,94,1,3,14,11
43,94,2,1,8,7
43,94,3,0,4,4
43,94,4,8,28,20
43,94,5,11,26,15
43,94,6,4,19,15
43,95,0,0,5,5
43,95,1,0,6,6
43,95,2,3,11,8
43,95,3,0,9,9
43,95,4,11,33,22
43,95,5,3,20,17
43,95,6,16,32,16
43,96,0,0,2,2
43,96,1,0,3,3
43,96,2,1,10,9
43,96,3,2,8,6
43,96,4,14,36,22
43,96,5,1,27,26
43,96,6,1,13,12
43,97,0,0,14,14
43,97,1,0,3,3
43,97,2,1,6,5
43,97,3,1,5,4
43,97,4,20,42,22
43,97,5,3,20,17
43,97,6,4,18,14
43,98,0,1,9,8
43,98,1,1,9,8
43,98,2,2,9,7
43,98,3,0,8,8
43,98,4,12,24,12
43,98,5,11,28,17
43,98,6,0,7,7
43,99,0,3,6,3
43,99,1,6,13,7
43,99,2,0,8,8
43,99,3,3,12,9
43,99,4,10,24,14
43,99,5,12,32,20
43,99,6,4,20,16
43,100,0,1,13,12
43,100,1,9,18,9
43,100,2,1,9,8
43,100,3,1,6,5
43,100,4,13,24,11
43,100,5,20,37,17
43,100,6,1,21,20
43,101,0,1,6,5
43,101,1,0,3,3
43,101,2,0,6,6
43,101,3,0,11,11
43,101,4,17,31,14
43,101,5,29,46,17
43,101,6,2,14,12
43,102,0,0,6,6
43,102,1,0,4,4
43,102,2,1,8,7
43,102,3,1,7,6
43,102,4,10,29,19
43,102,5,4,29,25
43,102,6,6,25,19
43,103,0,2,8,6
43,103,1,0,9,9
43,103,2,3,5,2
43,103,3,2,9,7
43,103,4,2,9,7
43,103,5,1,16,15
43,103,6,2,9,7
43,104,0,0,5,5
43,104,1,0,4,4
43,104,2,1,3,2
43,104,3,6,14,8
43,104,4,0,9,9
43,104,5,3,21,18
43,104,6,2,20,18
43,105,0,2,9,7
43,105,1,3,5,2
43,105,2,1,4,3
43,105,3,1,14,13
43,105,4,2,10,8
43,105,5,3,10,7
43,105,6,2,11,9
43,106,0,0,3,3
43,106,1,4,11,7
43,106,2,0,2,2
43,106,3,0,3,3
43,106,4,3,9,6
43,106,5,0,9,9
43,106,6,3,10,7
43,107,0,0,1,1
43,107,1,2,6,4
43,107,2,0,5,5
43,107,3,2,9,7
43,107,4,0,8,8
43,107,5,1,8,7
43,107,6,1,8,7
43,108,0,0,4,4
43,108,1,6,10,4
43,108,2,1,4,3
43,108,3,1,9,8
43,108,4,1,5,4
43,108,5,2,8,6
43,108,6,0,4,4
43,109,0,0,2,2
43,109,1,3,7,4
43,109,2,0,3,3
43,109,3,0,1,1
43,109,4,0,5,5
43,109,5,0,4,4
43,109,6,0,4,4
43,110,0,0,2,2
43,110,1,0,5,5
43,110,2,0,2,2
43,110,4,1,7,6
43,110,5,0,9,9
43,110,6,0,5,5
43,111,0,2,5,3
43,111,1,0,7,7
43,111,2,0,3,3
43,111,3,2,3,1
43,111,4,0,2,2
43,111,5,0,4,4
43,111,6,1,8,7
43,112,0,0,2,2
43,112,1,1,5,4
43,112,2,1,6,5
43,112,3,0,2,2
43,112,4,0,8,8
43,112,5,4,15,11
43,112,6,1,5,4
43,113,0,0,6,6
43,113,1,0,8,8
43,113,2,1,7,6
43,113,3,3,5,2
43,113,4,2,10,8
43,113,5,3,16,13
43,113,6,0,1,1
43,114,0,0,6,6
43,114,1,1,1,0
43,114,2,1,4,3
43,114,3,0,4,4
43,114,4,0,5,5
43,114,5,1,2,1
43,114,6,1,3,2
43,115,0,0,2,2
43,115,1,4,6,2
43,115,2,2,3,1
43,115,3,0,4,4
43,115,4,3,5,2
43,115,5,8,9,1
43,115,6,0,2,2
43,116,0,0,2,2
43,116,1,3,8,5
43,116,2,3,9,6
43,116,3,0,4,4
43,116,4,3,7,4
43,116,5,2,5,3
43,116,6,3,9,6
43,117,1,1,2,1
43,117,2,2,7,5
43,117,3,0,5,5
43,117,4,1,3,2
43,117,5,4,14,10
43,117,6,4,11,7
43,118,0,0,6,6
43,118,1,0,7,7
43,118,2,6,10,4
43,118,3,3,5,2
43,118,4,6,18,12
43,118,5,8,16,8
43,118,6,10,13,3
43,119,1,0,1,1
43,119,2,1,7,6
43,119,3,7,16,9
43,119,4,4,9,5
43,119,5,7,11,4
43,119,6,6,12,6
43,120,0,0,5,5
43,120,2,0,4,4
43,120,3,0,4,4
43,120,4,2,7,5
43,120,5,7,13,6
43,120,6,12,25,13
43,121,0,0,8,8
43,121,1,1,6,5
43,121,2,4,8,4
43,121,3,3,6,3
43,121,4,5,11,6
43,121,5,7,17,10
43,121,6,3,11,8
43,122,0,2,5,3
43,122,1,0,3,3
43,122,2,4,7,3
43,122,3,2,7,5
43,122,4,18,27,9
43,122,5,3,16,13
43,122,6,2,10,8
43,123,0,1,5,4
43,123,1,0,5,5
43,123,2,2,5,3
43,123,3,0,1,1
43,123,4,10,18,8
43,123,5,5,17,12
43,123,6,3,9,6
43,124,0,0,3,3
43,124,1,1,6,5
43,124,2,1,7,6
43,124,3,2,8,6
43,124,4,1,4,3
43,124,5,6,9,3
43,124,6,2,6,4
43,125,0,4,7,3
43,125,1,3,8,5
43,125,2,5,9,4
43,125,3,0,6,6
43,125,4,0,5,5
43,125,5,6,12,6
43,125,6,1,6,5
43,126,0,2,7,5
43,126,1,0,7,7
43,126,2,4,6,2
43,126,4,0,2,2
43,126,5,6,11,5
43,126,6,0,8,8
43,127,0,4,9,5
43,127,1,1,3,2
43,127,2,0,6,6
43,127,3,2,7,5
43,127,4,1,5,4
43,127,5,1,5,4
43,127,6,2,6,4
43,128,0,2,4,2
43,128,1,0,4,4
43,128,2,0,4,4
43,128,3,0,4,4
43,128,4,0,4,4
43,128,5,2,4,2
43,128,6,1,4,3
43,129,0,0,5,5
43,129,1,3,6,3
43,129,2,3,7,4
43,129,3,5,10,5
43,129,4,3,6,3
43,129,5,1,7,6
43,129,6,1,5,4
43,130,0,0,1,1
43,130,1,0,5,5
43,130,3,3,8,5
43,130,4,5,7,2
43,130,5,1,1,0
43,130,6,0,4,4
43,131,0,0,2,2
43,131,1,4,5,1
43,131,2,0,3,3
43,131,3,2,3,1
43,131,4,2,3,1
43,131,5,0,3,3
43,131,6,1,4,3
43,132,0,0,3,3
43,132,1,6,12,6
43,132,2,3,5,2
43,132,3,4,8,4
43,132,4,0,4,4
43,132,5,0,2,2
43,132,6,10,11,1
43,133,0,0,2,2
43,133,1,1,5,4
43,133,2,4,9,5
43,133,3,0,4,4
43,133,5,1,1,0
43,133,6,1,1,0
43,134,0,0,2,2
43,134,1,0,2,2
43,134,2,2,6,4
43,134,3,1,2,1
43,134,4,0,3,3
43,134,5,1,3,2
43,134,6,0,4,4
43,135,0,4,5,1
43,135,1,0,3,3
43,135,2,1,5,4
43,135,3,0,3,3
43,135,4,1,2,1
43,135,6,0,4,4
43,136,0,2,5,3
43,136,2,0,1,1
43,136,3,1,4,3
43,136,5,3,6,3
43,136,6,1,1,0
43,137,0,4,6,2
43,137,1,1,2,1
43,137,2,1,2,1
43,137,3,0,1,1
43,137,4,1,2,1
43,137,5,0,1,1
43,137,6,1,1,0
43,138,0,3,4,1
43,138,2,2,2,0
43,138,3,1,1,0
43,138,4,2,5,3
43,139,1,1,1,0
43,139,2,2,2,0
43,139,3,1,2,1
43,139,4,0,1,1
43,139,5,1,1,0
43,140,0,2,5,3
43,140,2,0,1,1
43,140,4,0,1,1
43,140,5,0,1,1
43,141,0,0,1,1
43,141,2,1,1,0
43,141,3,0,2,2
43,141,5,0,1,1
43,142,1,0,1,1
43,142,6,0,1,1
43,143,0,0,1,1
43,143,2,1,2,1
43,143,5,0,1,1
44,0,2,1,1,0
44,0,3,1,1,0
44,0,5,0,1,1
44,0,6,0,1,1
44,1,3,1,2,1
44,1,4,0,1,1
44,1,5,1,2,1
44,2,0,0,1,1
44,2,1,2,2,0
44,2,2,0,1,1
44,2,3,2,3,1
44,2,5,3,3,0
44,3,4,1,1,0
44,3,5,1,1,0
44,3,6,0,1,1
44,4,3,1,1,0
44,4,4,0,1,1
44,4,5,1,1,0
44,5,2,0,1,1
44,5,5,1,1,0
44,6,4,0,2,2
44,6,5,1,1,0
44,6,6,1,1,0
44,7,4,2,4,2
44,7,6,1,1,0
44,8,0,2,2,0
44,10,3,2,2,0
44,14,0,3,3,0
44,16,3,2,3,1
44,18,4,1,1,0
44,19,4,1,1,0
44,32,6,1,1,0
44,33,0,1,1,0
44,34,0,1,1,0
44,35,6,1,1,0
44,36,0,2,2,0
44,37,0,1,1,0
44,38,2,1,1,0
44,39,0,1,1,0
44,39,2,0,1,1
44,39,3,1,1,0
44,39,4,1,1,0
44,39,5,1,1,0
44,40,0,1,1,0
44,40,1,1,1,0
44,40,2,1,2,1
44,40,3,0,2,2
44,40,5,3,3,0
44,41,0,3,5,2
44,41,1,0,2,2
44,41,2,0,1,1
44,41,3,2,2,0
44,41,4,0,1,1
44,41,5,2,2,0
44,42,0,4,8,4
44,42,1,0,4,4
44,42,2,0,3,3
44,42,3,3,7,4
44,42,4,2,4,2
44,42,5,0,2,2
44,42,6,1,2,1
44,43,0,6,11,5
44,43,1,1,18,17
44,43,2,0,14,14
44,43,3,2,15,13
44,43,4,4,10,6
44,43,5,0,8,8
44,43,6,2,3,1
44,44,0,10,36,26
44,44,1,19,42,23
44,44,2,7,31,24
44,44,3,42,65,23
44,44,4,6,15,9
44,44,5,2,10,8
44,44,6,5,9,4
44,45,0,5,24,19
44,45,1,8,21,13
44,45,2,2,15,13
44,45,3,23,45,22
44,45,4,2,6,4
44,45,5,8,13,5
44,45,6,5,6,1
44,46,0,9,20,11
44,46,1,1,10,9
44,46,2,2,8,6
44,46,3,1,8,7
44,46,4,1,2,1
44,46,5,4,9,5
44,46,6,0,1,1
44,47,0,0,3,3
44,47,1,0,6,6
44,47,2,2,3,1
44,47,3,1,7,6
44,47,4,5,7,2
44,47,5,2,6,4
44,47,6,0,4,4
44,48,0,0,5,5
44,48,1,0,4,4
44,48,2,1,4,3
44,48,3,2,6,4
44,48,4,4,7,3
44,48,5,1,4,3
44,48,6,3,8,5
44,49,0,1,13,12
44,49,1,5,12,7
44,49,2,0,10,10
44,49,3,1,12,11
44,49,4,3,4,1
44,49,5,2,3,1
44,49,6,2,5,3
44,50,0,3,11,8
44,50,1,0,6,6
44,50,2,2,6,4
44,50,3,0,4,4
44,50,4,1,6,5
44,50,5,7,13,6
44,50,6,3,6,3
44,51,0,0,8,8
44,51,1,2,7,5
44,51,2,0,10,10
44,51,3,0,8,8
44,51,4,1,7,6
44,51,5,3,12,9
44,51,6,1,7,6
44,52,0,0,5,5
44,52,1,0,1,1
44,52,2,4,8,4
44,52,3,0,5,5
44,52,4,4,9,5
44,52,5,6,10,4
44,52,6,0,2,2
44,53,0,3,3,0
44,53,1,0,2,2
44,53,2,0,4,4
44,53,3,0,2,2
44,53,4,1,4,3
44,53,5,3,8,5
44,53,6,0,4,4
44,54,0,1,2,1
44,54,1,4,6,2
44,54,3,0,4,4
44,54,4,1,6,5
44,54,5,2,4,2
44,54,6,1,5,4
44,55,0,1,2,1
44,55,1,1,1,0
44,55,2,2,7,5
44,55,3,3,5,2
44,55,4,0,2,2
44,55,5,4,9,5
44,55,6,1,3,2
44,56,0,1,3,2
44,56,1,7,7,0
44,56,2,3,5,2
44,56,3,0,5,5
44,56,4,0,2,2
44,56,5,1,8,7
44,56,6,2,3,1
44,57,0,0,2,2
44,57,1,2,3,1
44,57,2,7,10,3
44,57,3,0,1,1
44,57,4,0,5,5
44,57,5,1,5,4
44,57,6,4,9,5
44,58,0,1,5,4
44,58,1,0,6,6
44,58,2,0,3,3
44,58,4,0,2,2
44,58,5,6,8,2
44,58,6,4,7,3
44,59,0,1,2,1
44,59,1,1,2,1
44,59,2,2,3,1
44,59,3,2,3,1
44,59,4,1,1,0
44,59,5,1,3,2
44,59,6,6,7,1
44,60,0,4,4,0
44,60,1,0,1,1
44,60,2,6,7,1
44,60,3,2,5,3
44,60,4,3,8,5
44,60,5,0,6,6
44,60,6,3,3,0
44,61,1,1,2,1
44,61,2,4,4,0
44,61,3,1,2,1
44,61,4,1,3,2
44,61,6,2,3,1
44,62,0,2,3,1
44,62,1,0,2,2
44,62,2,3,5,2
44,62,3,3,3,0
44,62,4,0,1,1
44,62,5,5,9,4
44,62,6,9,11,2
44,63,0,3,4,1
44,63,1,0,1,1
44,63,2,5,8,3
44,63,3,4,5,1
44,63,4,1,1,0
44,63,5,7,10,3
44,63,6,8,13,5
44,64,0,0,1,1
44,64,2,1,1,0
44,64,3,1,1,0
44,64,4,0,1,1
44,64,5,6,11,5
44,64,6,6,8,2
44,65,1,0,1,1
44,65,2,1,4,3
44,65,3,1,2,1
44,65,4,1,6,5
44,65,5,3,6,3
44,65,6,2,2,0
44,66,0,3,5,2
44,66,1,1,1,0
44,66,2,0,1,1
44,66,3,3,4,1
44,66,4,1,2,1
44,66,5,3,5,2
44,66,6,4,7,3
44,67,0,1,2,1
44,67,1,3,4,1
44,67,3,1,1,0
44,67,4,6,7,1
44,67,6,6,7,1
44,68,0,2,4,2
44,68,1,5,9,4
44,68,2,0,1,1
44,68,3,1,2,1
44,68,4,2,2,0
44,68,5,2,3,1
44,68,6,3,5,2
44,69,0,0,1,1
44,69,1,1,4,3
44,69,2,3,3,0
44,69,3,3,6,3
44,69,4,0,2,2
44,69,5,4,5,1
44,69,6,1,3,2
44,70,0,4,6,2
44,70,1,5,7,2
44,70,2,1,3,2
44,70,3,3,7,4
44,70,4,1,3,2
44,70,5,4,7,3
44,70,6,1,4,3
44,71,0,2,5,3
44,71,1,0,1,1
44,71,2,1,2,1
44,71,3,9,10,1
44,71,4,2,3,1
44,71,5,1,5,4
44,71,6,1,5,4
44,72,0,6,7,1
44,72,1,0,2,2
44,72,2,0,3,3
44,72,3,8,8,0
44,72,4,0,2,2
44,72,5,0,4,4
44,72,6,2,5,3
44,73,0,1,4,3
44,73,1,2,2,0
44,73,2,0,2,2
44,73,3,2,6,4
44,73,4,4,5,1
44,73,5,2,4,2
44,73,6,1,3,2
44,74,0,1,2,1
44,74,1,2,3,1
44,74,2,1,2,1
44,74,3,2,4,2
44,74,4,6,9,3
44,74,5,2,5,3
44,74,6,3,5,2
44,75,0,0,2,2
44,75,1,2,3,1
44,75,2,1,2,1
44,75,3,2,3,1
44,75,4,4,6,2
44,75,5,1,3,2
44,75,6,2,7,5
44,76,0,0,2,2
44,76,1,0,3,3
44,76,2,3,3,0
44,76,3,0,3,3
44,76,4,2,3,1
44,76,5,1,2,1
44,76,6,5,10,5
44,77,0,2,3,1
44,77,1,1,4,3
44,77,2,2,5,3
44,77,3,4,4,0
44,77,4,6,6,0
44,77,5,1,4,3
44,77,6,6,10,4
44,78,0,1,4,3
44,78,1,1,5,4
44,78,2,2,4,2
44,78,3,1,2,1
44,78,4,3,5,2
44,78,5,0,4,4
44,78,6,2,2,0
44,79,0,1,2,1
44,79,1,0,1,1
44,79,2,1,2,1
44,79,3,1,4,3
44,79,4,4,10,6
44,79,5,2,5,3
44,79,6,3,3,0
44,80,0,0,1,1
44,80,1,1,2,1
44,80,2,1,3,2
44,80,3,1,2,1
44,80,4,1,1,0
44,80,6,0,4,4
44,81,0,8,10,2
44,81,1,1,4,3
44,81,2,7,10,3
44,81,3,1,2,1
44,81,4,0,2,2
44,81,5,2,5,3
44,81,6,2,3,1
44,82,0,1,2,1
44,82,1,2,2,0
44,82,2,1,2,1
44,82,3,0,2,2
44,82,4,2,5,3
44,82,5,6,7,1
44,82,6,1,2,1
44,83,0,1,3,2
44,83,1,1,2,1
44,83,2,1,2,1
44,83,3,5,5,0
44,83,4,4,7,3
44,83,5,6,7,1
44,83,6,3,7,4
44,84,0,3,3,0
44,84,2,6,8,2
44,84,3,0,1,1
44,84,4,2,4,2
44,84,5,3,5,2
44,84,6,9,9,0
44,85,0,1,2,1
44,85,1,2,4,2
44,85,2,3,3,0
44,85,3,0,2,2
44,85,4,5,6,1
44,85,5,1,3,2
44,85,6,3,6,3
44,86,0,1,1,0
44,86,1,1,3,2
44,86,2,2,2,0
44,86,3,0,2,2
44,86,4,3,4,1
44,86,5,0,1,1
44,86,6,1,5,4
44,87,1,1,5,4
44,87,2,2,3,1
44,87,3,2,6,4
44,87,4,0,1,1
44,87,5,2,3,1
44,87,6,0,1,1
44,88,0,0,2,2
44,88,1,1,3,2
44,88,2,1,2,1
44,88,3,2,3,1
44,88,4,0,5,5
44,88,5,5,7,2
44,88,6,0,2,2
44,89,0,2,4,2
44,89,2,0,1,1
44,89,3,1,2,1
44,89,4,4,5,1
44,89,5,3,4,1
44,89,6,0,1,1
44,90,0,2,3,1
44,90,1,0,2,2
44,90,2,7,8,1
44,90,4,6,8,2
44,90,5,1,2,1
44,90,6,1,2,1
44,91,0,1,2,1
44,91,1,4,7,3
44,91,2,5,9,4
44,91,3,3,3,0
44,91,4,3,5,2
44,91,5,1,3,2
44,91,6,1,2,1
44,92,0,4,6,2
44,92,1,0,2,2
44,92,2,2,3,1
44,92,3,0,4,4
44,92,4,2,2,0
44,92,5,0,1,1
44,92,6,0,2,2
44,93,0,0,3,3
44,93,1,0,2,2
44,93,2,1,1,0
44,93,3,0,1,1
44,93,4,6,10,4
44,93,5,0,3,3
44,93,6,0,1,1
44,94,1,1,3,2
44,94,2,3,5,2
44,94,3,5,6,1
44,94,4,0,4,4
44,94,5,1,3,2
44,94,6,1,3,2
44,95,1,0,2,2
44,95,2,1,2,1
44,95,3,3,5,2
44,95,4,0,2,2
44,95,5,0,1,1
44,95,6,0,2,2
44,96,0,1,3,2
44,96,1,2,5,3
44,96,2,2,3,1
44,96,3,3,8,5
44,96,5,1,4,3
44,96,6,1,5,4
44,97,1,0,2,2
44,97,2,0,2,2
44,97,3,2,2,0
44,97,4,3,4,1
44,97,5,0,3,3
44,97,6,3,8,5
44,98,0,1,2,1
44,98,1,1,13,12
44,98,2,3,6,3
44,98,3,2,9,7
44,98,4,4,8,4
44,98,5,1,2,1
44,98,6,4,5,1
44,99,0,3,14,11
44,99,1,4,9,5
44,99,2,6,12,6
44,99,3,2,15,13
44,99,4,12,17,5
44,99,5,3,6,3
44,99,6,2,7,5
44,100,0,1,7,6
44,100,1,2,8,6
44,100,2,5,9,4
44,100,3,1,11,10
44,100,4,3,4,1
44,100,5,3,4,1
44,100,6,1,4,3
44,101,0,0,6,6
44,101,1,1,7,6
44,101,2,2,12,10
44,101,3,1,11,10
44,101,4,2,10,8
44,101,5,5,10,5
44,101,6,1,2,1
44,102,0,0,9,9
44,102,1,0,10,10
44,102,2,4,13,9
44,102,3,0,6,6
44,102,4,0,7,7
44,102,5,5,11,6
44,102,6,1,3,2
44,103,0,3,8,5
44,103,1,1,7,6
44,103,2,2,11,9
44,103,3,0,6,6
44,103,4,3,8,5
44,103,5,0,4,4
44,103,6,2,4,2
44,104,0,0,4,4
44,104,1,0,4,4
44,104,2,1,4,3
44,104,3,0,5,5
44,104,4,0,6,6
44,104,5,0,5,5
44,104,6,4,9,5
44,105,0,0,3,3
44,105,1,0,6,6
44,105,2,0,3,3
44,105,3,0,5,5
44,105,4,0,2,2
44,105,5,2,5,3
44,105,6,1,10,9
44,106,0,1,6,5
44,106,1,5,8,3
44,106,2,1,8,7
44,106,3,0,3,3
44,106,4,4,7,3
44,106,5,2,7,5
44,106,6,0,5,5
44,107,0,4,12,8
44,107,1,5,9,4
44,107,2,0,4,4
44,107,3,2,10,8
44,107,4,1,4,3
44,107,5,0,5,5
44,107,6,0,2,2
44,108,0,3,8,5
44,108,1,1,3,2
44,108,2,3,7,4
44,108,3,6,10,4
44,108,4,1,6,5
44,108,5,1,5,4
44,108,6,2,7,5
44,109,0,1,6,5
44,109,1,0,4,4
44,109,2,0,4,4
44,109,3,2,9,7
44,109,4,3,9,6
44,109,5,1,3,2
44,109,6,2,6,4
44,110,0,1,6,5
44,110,1,1,6,5
44,110,2,2,8,6
44,110,3,0,5,5
44,110,4,0,4,4
44,110,5,0,3,3
44,110,6,0,2,2
44,111,0,0,5,5
44,111,1,0,2,2
44,111,2,1,7,6
44,111,3,0,9,9
44,111,4,0,9,9
44,111,5,3,6,3
44,111,6,0,1,1
44,112,0,1,5,4
44,112,1,0,2,2
44,112,2,1,4,3
44,112,3,0,1,1
44,112,4,0,3,3
44,112,5,2,7,5
44,112,6,4,6,2
44,113,0,3,7,4
44,113,1,0,7,7
44,113,2,1,7,6
44,113,3,1,2,1
44,113,4,1,7,6
44,113,5,1,6,5
44,113,6,2,10,8
44,114,0,2,5,3
44,114,1,0,1,1
44,114,2,0,4,4
44,114,3,0,2,2
44,114,4,1,3,2
44,114,5,1,1,0
44,114,6,1,3,2
44,115,0,0,1,1
44,115,1,0,2,2
44,115,2,0,3,3
44,115,3,1,3,2
44,115,4,2,3,1
44,115,5,1,1,0
44,115,6,4,8,4
44,116,0,0,5,5
44,116,1,0,1,1
44,116,2,1,3,2
44,116,3,1,1,0
44,116,4,1,3,2
44,116,5,2,5,3
44,117,0,0,3,3
44,117,1,1,2,1
44,117,2,4,8,4
44,117,3,1,3,2
44,117,4,0,4,4
44,117,5,0,2,2
44,117,6,2,3,1
44,118,0,3,7,4
44,118,1,0,3,3
44,118,2,1,3,2
44,118,3,0,3,3
44,118,4,1,4,3
44,118,5,0,1,1
44,118,6,0,3,3
44,119,0,0,1,1
44,119,1,1,3,2
44,119,2,1,3,2
44,119,3,2,5,3
44,119,4,0,1,1
44,119,5,4,4,0
44,119,6,0,3,3
44,120,0,0,1,1
44,120,1,2,7,5
44,120,2,1,4,3
44,120,3,2,4,2
44,120,4,1,3,2
44,120,5,1,3,2
44,120,6,0,3,3
44,121,0,0,1,1
44,121,1,4,8,4
44,121,2,0,4,4
44,121,3,0,1,1
44,121,4,0,2,2
44,121,5,1,5,4
44,122,0,1,4,3
44,122,1,2,8,6
44,122,2,0,3,3
44,122,3,0,4,4
44,122,4,1,3,2
44,122,6,0,3,3
44,123,0,0,2,2
44,123,1,1,5,4
44,123,2,2,3,1
44,123,3,0,3,3
44,123,4,1,3,2
44,123,5,1,2,1
44,123,6,2,4,2
44,124,0,1,3,2
44,124,2,2,6,4
44,124,4,1,1,0
44,124,5,5,6,1
44,124,6,7,9,2
44,125,0,0,2,2
44,125,1,0,1,1
44,125,2,0,5,5
44,125,3,0,1,1
44,125,4,4,8,4
44,125,5,1,6,5
44,125,6,4,8,4
44,126,0,0,4,4
44,126,1,0,1,1
44,126,2,0,6,6
44,126,3,0,1,1
44,126,4,5,7,2
44,126,5,2,5,3
44,126,6,1,1,0
44,127,0,0,1,1
44,127,2,0,2,2
44,127,3,1,2,1
44,127,4,1,3,2
44,127,5,2,3,1
44,127,6,0,2,2
44,128,0,0,1,1
44,128,1,0,1,1
44,128,2,0,4,4
44,128,3,1,1,0
44,128,4,0,1,1
44,128,5,1,3,2
44,128,6,0,1,1
44,129,0,1,2,1
44,129,1,0,2,2
44,129,2,3,3,0
44,129,3,1,3,2
44,129,4,1,2,1
44,129,5,4,5,1
44,129,6,0,2,2
44,130,0,1,3,2
44,130,2,1,3,2
44,130,3,0,1,1
44,130,4,2,3,1
44,130,6,0,1,1
44,131,0,4,5,1
44,131,1,0,1,1
44,131,3,0,1,1
44,131,4,0,1,1
44,131,6,1,1,0
44,132,1,2,5,3
44,132,3,0,2,2
44,132,5,1,1,0
44,133,0,2,2,0
44,133,1,2,3,1
44,133,2,6,7,1
44,133,4,0,2,2
44,133,6,0,1,1
44,134,0,0,1,1
44,134,1,0,1,1
44,134,2,2,2,0
44,134,5,0,2,2
44,134,6,0,1,1
44,135,1,0,1,1
44,135,2,1,2,1
44,135,3,0,1,1
44,135,4,0,1,1
44,136,0,1,3,2
44,136,1,1,2,1
44,136,2,1,2,1
44,136,3,0,1,1
44,136,4,1,3,2
44,136,5,0,1,1
44,136,6,0,2,2
44,137,0,1,1,0
44,137,1,0,1,1
44,137,2,1,1,0
44,137,3,0,1,1
44,137,5,1,2,1
44,137,6,0,2,2
44,138,0,1,1,0
44,138,1,0,1,1
44,138,3,1,1,0
44,138,4,0,1,1
44,138,5,0,1,1
44,138,6,1,1,0
44,139,0,0,1,1
44,139,1,0,1,1
44,139,4,1,1,0
44,140,4,1,1,0
44,141,1,2,3,1
44,141,4,1,1,0
44,143,1,5,6,1
44,143,5,1,1,0
45,0,0,1,6,5
45,0,1,0,3,3
45,0,2,2,7,5
45,0,3,0,3,3
45,0,4,0,6,6
45,0,5,0,1,1
45,0,6,1,6,5
45,1,0,0,3,3
45,1,1,0,3,3
45,1,2,1,3,2
45,1,3,7,11,4
45,1,4,0,8,8
45,1,5,0,2,2
45,2,0,0,1,1
45,2,2,2,2,0
45,2,3,0,1,1
45,2,4,0,6,6
45,2,5,0,1,1
45,3,2,1,2,1
45,3,4,1,3,2
45,4,3,0,1,1
45,4,4,0,2,2
45,4,6,0,1,1
45,5,2,1,3,2
45,5,4,1,3,2
45,5,6,0,3,3
45,6,1,0,1,1
45,6,2,0,2,2
45,6,5,0,1,1
45,7,4,0,1,1
45,7,6,1,2,1
45,8,0,0,1,1
45,8,6,1,2,1
45,9,5,0,1,1
45,9,6,1,2,1
45,10,0,0,1,1
45,11,1,0,1,1
45,11,4,0,2,2
45,12,0,0,2,2
45,12,2,0,1,1
45,12,3,0,1,1
45,12,5,0,1,1
45,13,3,0,1,1
45,13,4,1,1,0
45,13,5,0,1,1
45,14,6,0,1,1
45,15,2,1,1,0
45,16,0,2,2,0
45,16,6,0,1,1
45,17,0,0,1,1
45,17,1,0,1,1
45,17,4,0,1,1
45,17,6,1,1,0
45,18,0,0,1,1
45,18,1,0,1,1
45,18,6,3,3,0
45,19,1,0,1,1
45,19,3,2,2,0
45,19,4,1,1,0
45,20,1,1,1,0
45,20,4,3,5,2
45,20,6,0,1,1
45,21,1,1,1,0
45,21,6,0,1,1
45,22,1,1,1,0
45,22,5,1,1,0
45,22,6,1,1,0
45,23,2,0,1,1
45,23,5,1,2,1
45,23,6,0,1,1
45,24,2,1,1,0
45,24,4,0,1,1
45,24,5,1,1,0
45,25,6,0,1,1
45,26,1,4,4,0
45,26,4,0,1,1
45,26,5,1,1,0
45,26,6,0,1,1
45,27,1,1,1,0
45,27,2,1,2,1
45,28,0,1,1,0
45,28,1,1,1,0
45,28,3,0,1,1
45,30,6,2,2,0
45,31,1,1,1,0
45,31,5,1,1,0
45,32,3,0,1,1
45,33,3,0,1,1
45,35,6,4,4,0
45,36,0,2,3,1
45,36,3,2,2,0
45,36,4,1,1,0
45,36,6,1,1,0
45,37,0,3,4,1
45,37,1,0,1,1
45,37,2,0,1,1
45,37,4,3,3,0
45,37,5,1,2,1
45,38,0,2,2,0
45,38,1,1,2,1
45,38,3,0,1,1
45,38,4,0,1,1
45,39,0,0,5,5
45,39,1,0,4,4
45,39,2,1,3,2
45,39,3,2,3,1
45,39,4,0,7,7
45,39,6,1,1,0
45,40,0,1,5,4
45,40,1,0,1,1
45,40,2,0,4,4
45,40,3,0,4,4
45,40,4,0,4,4
45,40,5,0,1,1
45,40,6,1,1,0
45,41,0,1,6,5
45,41,1,1,3,2
45,41,2,2,3,1
45,41,3,0,2,2
45,41,4,0,2,2
45,41,5,0,3,3
45,42,0,0,7,7
45,42,1,1,10,9
45,42,2,0,14,14
45,42,3,2,15,13
45,42,4,1,9,8
45,42,6,1,3,2
45,43,0,0,10,10
45,43,1,1,11,10
45,43,2,1,10,9
45,43,3,4,13,9
45,43,4,1,9,8
45,43,5,0,5,5
45,43,6,0,5,5
45,44,0,0,3,3
45,44,1,1,8,7
45,44,2,1,11,10
45,44,3,3,12,9
45,44,4,1,10,9
45,44,5,0,8,8
45,44,6,0,6,6
45,45,0,1,19,18
45,45,1,0,9,9
45,45,2,1,17,16
45,45,3,0,15,15
45,45,4,0,13,13
45,45,5,1,15,14
45,45,6,1,7,6
45,46,0,2,15,13
45,46,1,1,15,14
45,46,2,0,11,11
45,46,3,1,10,9
45,46,4,1,7,6
45,46,5,0,4,4
45,46,6,0,10,10
45,47,0,3,14,11
45,47,1,2,16,14
45,47,2,1,11,10
45,47,3,3,21,18
45,47,4,0,7,7
45,47,5,0,8,8
45,47,6,0,5,5
45,48,0,2,25,23
45,48,1,2,23,21
45,48,2,0,26,26
45,48,3,1,17,16
45,48,4,3,19,16
45,48,5,0,10,10
45,48,6,0,10,10
45,49,0,7,26,19
45,49,1,10,31,21
45,49,2,1,14,13
45,49,3,1,21,20
45,49,4,2,16,14
45,49,5,1,8,7
45,49,6,0,11,11
45,50,0,0,12,12
45,50,1,3,14,11
45,50,2,3,26,23
45,50,3,2,16,14
45,50,4,0,11,11
45,50,5,1,10,9
45,50,6,1,9,8
45,51,0,0,15,15
45,51,1,2,20,18
45,51,2,0,10,10
45,51,3,2,17,15
45,51,4,1,10,9
45,51,5,2,14,12
45,51,6,0,8,8
45,52,0,4,21,17
45,52,1,3,12,9
45,52,2,3,23,20
45,52,3,4,26,22
45,52,4,4,26,22
45,52,5,3,23,20
45,52,6,2,19,17
45,53,0,3,11,8
45,53,1,4,14,10
45,53,2,7,14,7
45,53,3,2,14,12
45,53,4,0,6,6
45,53,5,9,18,9
45,53,6,2,8,6
45,54,0,0,9,9
45,54,1,2,19,17
45,54,2,1,16,15
45,54,3,1,15,14
45,54,4,3,19,16
45,54,5,0,14,14
45,54,6,0,7,7
45,55,0,1,12,11
45,55,1,0,10,10
45,55,2,0,7,7
45,55,3,0,8,8
45,55,4,2,14,12
45,55,5,2,11,9
45,55,6,1,11,10
45,56,0,0,13,13
45,56,1,1,11,10
45,56,2,0,11,11
45,56,3,0,9,9
45,56,4,2,22,20
45,56,5,2,15,13
45,56,6,1,12,11
45,57,0,1,7,6
45,57,1,1,13,12
45,57,2,2,12,10
45,57,3,1,12,11
45,57,4,9,17,8
45,57,5,4,15,11
45,57,6,0,8,8
45,58,0,0,5,5
45,58,1,0,4,4
45,58,2,4,13,9
45,58,3,2,11,9
45,58,4,34,47,13
45,58,5,4,16,12
45,58,6,0,10,10
45,59,0,0,7,7
45,59,1,0,10,10
45,59,2,1,7,6
45,59,3,1,18,17
45,59,4,11,23,12
45,59,5,0,8,8
45,59,6,1,17,16
45,60,0,0,11,11
45,60,1,0,5,5
45,60,2,4,7,3
45,60,3,3,12,9
45,60,4,14,22,8
45,60,5,0,10,10
45,60,6,1,18,17
45,61,0,1,8,7
45,61,1,1,7,6
45,61,2,2,8,6
45,61,3,3,11,8
45,61,4,18,29,11
45,61,5,0,12,12
45,61,6,1,16,15
45,62,0,2,11,9
45,62,1,1,7,6
45,62,2,3,12,9
45,62,3,2,19,17
45,62,4,13,21,8
45,62,5,1,7,6
45,62,6,1,14,13
45,63,0,0,9,9
45,63,1,3,12,9
45,63,2,1,6,5
45,63,3,1,7,6
45,63,4,17,26,9
45,63,5,3,12,9
45,63,6,5,20,15
45,64,0,2,8,6
45,64,1,3,9,6
45,64,2,2,13,11
45,64,3,2,10,8
45,64,4,8,16,8
45,64,5,0,5,5
45,64,6,3,14,11
45,65,0,3,14,11
45,65,1,3,14,11
45,65,2,1,7,6
45,65,3,0,6,6
45,65,4,8,15,7
45,65,5,0,9,9
45,65,6,1,14,13
45,66,0,0,6,6
45,66,1,0,13,13
45,66,2,0,14,14
45,66,3,0,7,7
45,66,4,8,14,6
45,66,5,0,4,4
45,66,6,7,19,12
45,67,0,4,11,7
45,67,1,2,6,4
45,67,2,1,8,7
45,67,3,2,6,4
45,67,4,10,15,5
45,67,5,1,15,14
45,67,6,2,11,9
45,68,0,2,10,8
45,68,1,2,9,7
45,68,2,0,10,10
45,68,3,2,9,7
45,68,4,11,21,10
45,68,5,3,14,11
45,68,6,5,19,14
45,69,0,8,16,8
45,69,1,3,19,16
45,69,2,1,15,14
45,69,3,2,14,12
45,69,4,16,25,9
45,69,5,4,14,10
45,69,6,2,15,13
45,70,0,3,12,9
45,70,1,0,10,10
45,70,2,1,10,9
45,70,3,4,17,13
45,70,4,25,34,9
45,70,5,2,12,10
45,70,6,3,11,8
45,71,0,5,18,13
45,71,1,6,16,10
45,71,2,2,12,10
45,71,3,4,14,10
45,71,4,12,21,9
45,71,5,3,14,11
45,71,6,1,11,10
45,72,0,3,19,16
45,72,1,2,12,10
45,72,2,2,15,13
45,72,3,8,23,15
45,72,4,26,45,19
45,72,5,5,16,11
45,72,6,12,21,9
45,73,0,2,7,5
45,73,1,2,14,12
45,73,2,0,3,3
45,73,3,10,16,6
45,73,4,15,26,11
45,73,5,1,14,13
45,73,6,12,24,12
45,74,0,4,19,15
45,74,1,4,13,9
45,74,2,0,11,11
45,74,3,4,9,5
45,74,4,9,28,19
45,74,5,7,15,8
45,74,6,5,26,21
45,75,0,2,14,12
45,75,1,1,9,8
45,75,2,6,17,11
45,75,3,5,15,10
45,75,4,9,26,17
45,75,5,3,10,7
45,75,6,0,13,13
45,76,0,5,15,10
45,76,1,5,11,6
45,76,2,5,17,12
45,76,3,4,18,14
45,76,4,5,21,16
45,76,5,3,14,11
45,76,6,1,16,15
45,77,0,0,13,13
45,77,1,0,6,6
45,77,2,3,9,6
45,77,3,2,8,6
45,77,4,11,23,12
45,77,5,0,11,11
45,77,6,9,24,15
45,78,0,3,14,11
45,78,1,6,17,11
45,78,2,0,7,7
45,78,3,0,6,6
45,78,4,11,22,11
45,78,5,1,21,20
45,78,6,4,15,11
45,79,0,3,16,13
45,79,1,3,17,14
45,79,2,6,14,8
45,79,3,2,10,8
45,79,4,4,8,4
45,79,5,2,11,9
45,79,6,3,17,14
45,80,0,2,14,12
45,80,1,10,19,9
45,80,2,1,12,11
45,80,3,0,7,7
45,80,4,5,22,17
45,80,5,5,13,8
45,80,6,1,12,11
45,81,0,8,12,4
45,81,1,7,11,4
45,81,2,4,11,7
45,81,3,1,9,8
45,81,4,12,25,13
45,81,5,6,14,8
45,81,6,4,22,18
45,82,0,9,17,8
45,82,1,7,16,9
45,82,2,1,14,13
45,82,3,6,18,12
45,82,4,5,14,9
45,82,5,0,5,5
45,82,6,12,28,16
45,83,0,3,13,10
45,83,1,2,7,5
45,83,2,3,13,10
45,83,3,1,10,9
45,83,4,1,11,10
45,83,5,8,14,6
45,83,6,4,15,11
45,84,0,2,16,14
45,84,1,1,12,11
45,84,2,2,11,9
45,84,3,4,17,13
45,84,4,0,8,8
45,84,5,2,9,7
45,84,6,1,15,14
45,85,0,2,7,5
45,85,1,3,7,4
45,85,2,12,22,10
45,85,3,0,7,7
45,85,4,12,22,10
45,85,5,6,18,12
45,85,6,0,8,8
45,86,0,0,3,3
45,86,1,3,11,8
45,86,2,2,10,8
45,86,3,3,11,8
45,86,4,2,10,8
45,86,5,9,22,13
45,86,6,1,9,8
45,87,0,2,10,8
45,87,1,3,10,7
45,87,2,3,12,9
45,87,3,4,14,10
45,87,4,8,17,9
45,87,5,6,18,12
45,87,6,2,18,16
45,88,0,3,9,6
45,88,1,0,4,4
45,88,2,0,5,5
45,88,3,2,8,6
45,88,4,10,21,11
45,88,5,2,10,8
45,88,6,2,9,7
45,89,0,2,11,9
45,89,1,4,18,14
45,89,2,5,14,9
45,89,3,1,11,10
45,89,4,3,8,5
45,89,5,3,14,11
45,89,6,0,9,9
45,90,0,0,8,8
45,90,1,4,10,6
45,90,2,9,26,17
45,90,3,8,17,9
45,90,4,3,10,7
45,90,5,1,14,13
45,90,6,2,22,20
45,91,0,4,15,11
45,91,1,0,4,4
45,91,2,7,14,7
45,91,3,4,16,12
45,91,4,1,6,5
45,91,5,3,15,12
45,91,6,0,8,8
45,92,0,4,17,13
45,92,1,2,9,7
45,92,2,3,12,9
45,92,3,0,9,9
45,92,4,2,16,14
45,92,5,1,16,15
45,92,6,0,16,16
45,93,0,1,11,10
45,93,1,0,14,14
45,93,2,3,15,12
45,93,3,1,16,15
45,93,4,0,13,13
45,93,5,2,15,13
45,93,6,0,9,9
45,94,0,2,9,7
45,94,1,1,11,10
45,94,2,0,14,14
45,94,3,1,13,12
45,94,4,3,21,18
45,94,5,1,9,8
45,94,6,0,9,9
45,95,0,1,16,15
45,95,1,0,15,15
45,95,2,0,10,10
45,95,3,1,25,24
45,95,4,1,14,13
45,95,5,4,13,9
45,95,6,0,16,16
45,96,0,0,7,7
45,96,1,1,19,18
45,96,2,1,15,14
45,96,3,2,16,14
45,96,4,0,14,14
45,96,5,3,21,18
45,96,6,0,15,15
45,97,0,0,15,15
45,97,1,1,6,5
45,97,2,0,5,5
45,97,3,0,14,14
45,97,4,0,5,5
45,97,5,1,12,11
45,97,6,0,7,7
45,98,0,0,13,13
45,98,1,2,10,8
45,98,2,1,13,12
45,98,3,1,20,19
45,98,4,1,14,13
45,98,5,0,8,8
45,98,6,0,17,17
45,99,0,2,13,11
45,99,1,2,21,19
45,99,2,3,17,14
45,99,3,5,25,20
45,99,4,2,19,17
45,99,5,1,13,12
45,99,6,1,18,17
45,100,0,0,10,10
45,100,1,3,17,14
45,100,2,1,19,18
45,100,3,1,8,7
45,100,4,1,18,17
45,100,5,1,12,11
45,100,6,3,12,9
45,101,0,3,22,19
45,101,1,1,25,24
45,101,2,1,29,28
45,101,3,1,23,22
45,101,4,0,18,18
45,101,5,2,18,16
45,101,6,3,15,12
45,102,0,3,27,24
45,102,1,0,32,32
45,102,2,0,34,34
45,102,3,2,30,28
45,102,4,0,30,30
45,102,5,2,27,25
45,102,6,1,26,25
45,103,0,9,30,21
45,103,1,1,29,28
45,103,2,1,36,35
45,103,3,2,33,31
45,103,4,1,22,21
45,103,5,1,49,48
45,103,6,2,27,25
45,104,0,2,21,19
45,104,1,7,39,32
45,104,2,2,25,23
45,104,3,0,21,21
45,104,4,2,21,19
45,104,5,5,33,28
45,104,6,0,28,28
45,105,0,4,76,72
45,105,1,3,80,77
45,105,2,6,74,68
45,105,3,4,77,73
45,105,4,4,54,50
45,105,5,2,46,44
45,105,6,2,33,31
45,106,0,2,71,69
45,106,1,1,63,62
45,106,2,9,66,57
45,106,3,26,99,73
45,106,4,8,64,56
45,106,5,2,31,29
45,106,6,14,43,29
45,107,0,0,45,45
45,107,1,1,68,67
45,107,2,25,76,51
45,107,3,20,77,57
45,107,4,2,37,35
45,107,5,2,32,30
45,107,6,4,31,27
45,108,0,3,55,52
45,108,1,5,42,37
45,108,2,16,49,33
45,108,3,5,44,39
45,108,4,3,45,42
45,108,5,0,23,23
45,108,6,4,27,23
45,109,0,8,48,40
45,109,1,1,32,31
45,109,2,3,39,36
45,109,3,1,34,33
45,109,4,9,35,26
45,109,5,0,21,21
45,109,6,1,20,19
45,110,0,4,37,33
45,110,1,0,23,23
45,110,2,4,40,36
45,110,3,1,38,37
45,110,4,6,35,29
45,110,5,2,21,19
45,110,6,2,18,16
45,111,0,1,26,25
45,111,1,0,17,17
45,111,2,3,29,26
45,111,3,1,24,23
45,111,4,6,34,28
45,111,5,0,8,8
45,111,6,3,22,19
45,112,0,1,32,31
45,112,1,0,20,20
45,112,2,5,36,31
45,112,3,1,25,24
45,112,4,6,22,16
45,112,5,0,22,22
45,112,6,1,16,15
45,113,0,2,19,17
45,113,1,0,24,24
45,113,2,3,36,33
45,113,3,3,29,26
45,113,4,2,19,17
45,113,5,3,30,27
45,113,6,0,14,14
45,114,0,2,19,17
45,114,1,2,26,24
45,114,2,3,18,15
45,114,3,1,17,16
45,114,4,3,20,17
45,114,5,2,9,7
45,114,6,0,10,10
45,115,0,2,19,17
45,115,1,0,21,21
45,115,2,3,22,19
45,115,3,1,10,9
45,115,4,2,18,16
45,115,5,0,9,9
45,115,6,3,12,9
45,116,0,3,18,15
45,116,1,0,19,19
45,116,2,4,17,13
45,116,3,1,15,14
45,116,4,6,15,9
45,116,5,0,8,8
45,116,6,4,17,13
45,117,0,0,22,22
45,117,1,1,15,14
45,117,2,2,26,24
45,117,3,0,18,18
45,117,4,0,12,12
45,117,5,0,9,9
45,117,6,1,11,10
45,118,0,0,17,17
45,118,1,0,10,10
45,118,2,1,12,11
45,118,3,0,20,20
45,118,4,0,17,17
45,118,5,2,14,12
45,118,6,0,11,11
45,119,0,0,15,15
45,119,1,0,13,13
45,119,2,1,13,12
45,119,3,0,9,9
45,119,4,0,7,7
45,119,5,0,6,6
45,119,6,1,11,10
45,120,0,1,26,25
45,120,1,2,25,23
45,120,2,4,22,18
45,120,3,0,16,16
45,120,4,1,16,15
45,120,5,0,15,15
45,120,6,2,15,13
45,121,0,0,21,21
45,121,1,4,17,13
45,121,2,0,23,23
45,121,3,2,20,18
45,121,4,0,17,17
45,121,5,0,15,15
45,121,6,0,12,12
45,122,0,0,12,12
45,122,1,2,25,23
45,122,2,0,13,13
45,122,3,2,24,22
45,122,4,1,7,6
45,122,5,1,10,9
45,122,6,1,15,14
45,123,0,2,18,16
45,123,1,5,38,33
45,123,2,0,16,16
45,123,3,1,22,21
45,123,4,0,13,13
45,123,5,0,8,8
45,123,6,1,13,12
45,124,0,0,15,15
45,124,1,1,14,13
45,124,2,2,17,15
45,124,3,3,14,11
45,124,4,0,6,6
45,124,5,0,10,10
45,124,6,0,7,7
45,125,0,0,8,8
45,125,1,2,8,6
45,125,2,0,13,13
45,125,3,1,13,12
45,125,4,0,10,10
45,125,5,0,15,15
45,125,6,3,11,8
45,126,0,4,15,11
45,126,1,3,19,16
45,126,2,2,18,16
45,126,3,1,13,12
45,126,4,0,7,7
45,126,5,1,6,5
45,126,6,0,13,13
45,127,0,3,22,19
45,127,1,2,11,9
45,127,2,2,14,12
45,127,3,2,19,17
45,127,4,2,12,10
45,127,5,0,14,14
45,127,6,0,7,7
45,128,0,1,11,10
45,128,1,1,16,15
45,128,2,2,8,6
45,128,3,1,5,4
45,128,4,0,9,9
45,128,5,0,7,7
45,128,6,2,9,7
45,129,0,1,13,12
45,129,1,0,11,11
45,129,2,1,9,8
45,129,3,0,2,2
45,129,4,0,10,10
45,129,5,0,8,8
45,129,6,0,6,6
45,130,0,0,7,7
45,130,1,0,8,8
45,130,2,1,15,14
45,130,3,1,10,9
45,130,4,0,9,9
45,130,5,0,4,4
45,130,6,0,4,4
45,131,0,0,10,10
45,131,1,2,12,10
45,131,2,0,4,4
45,131,3,1,11,10
45,131,4,1,12,11
45,131,5,0,6,6
45,131,6,0,6,6
45,132,0,0,6,6
45,132,1,0,7,7
45,132,2,3,16,13
45,132,3,0,6,6
45,132,4,2,10,8
45,132,5,0,4,4
45,132,6,0,8,8
45,133,0,1,7,6
45,133,1,0,5,5
45,133,2,0,5,5
45,133,3,1,10,9
45,133,4,4,17,13
45,133,5,0,7,7
45,133,6,0,6,6
45,134,0,1,4,3
45,134,1,0,4,4
45,134,2,1,7,6
45,134,3,0,4,4
45,134,4,1,9,8
45,134,5,0,1,1
45,134,6,0,4,4
45,135,0,0,6,6
45,135,1,3,8,5
45,135,2,1,5,4
45,135,3,0,2,2
45,135,4,1,11,10
45,135,5,0,6,6
45,135,6,2,6,4
45,136,0,1,2,1
45,136,1,1,4,3
45,136,2,1,7,6
45,136,3,0,5,5
45,136,4,0,3,3
45,136,5,0,8,8
45,136,6,0,13,13
45,137,0,2,4,2
45,137,1,1,4,3
45,137,2,0,3,3
45,137,3,0,5,5
45,137,4,2,11,9
45,137,5,0,7,7
45,137,6,3,7,4
45,138,0,0,2,2
45,138,1,0,5,5
45,138,2,2,5,3
45,138,3,0,1,1
45,138,4,0,3,3
45,138,5,1,5,4
45,138,6,0,2,2
45,139,1,0,2,2
45,139,2,1,4,3
45,139,3,5,9,4
45,139,4,0,5,5
45,139,5,0,4,4
45,139,6,0,3,3
45,140,0,2,6,4
45,140,1,0,3,3
45,140,2,0,3,3
45,140,3,4,6,2
45,140,4,1,1,0
45,140,5,0,2,2
45,140,6,0,1,1
45,141,1,0,3,3
45,141,2,1,3,2
45,141,3,1,3,2
45,141,4,0,3,3
45,141,5,1,2,1
45,141,6,0,2,2
45,142,0,0,3,3
45,142,1,2,4,2
45,142,2,0,2,2
45,142,3,0,1,1
45,142,4,0,4,4
45,142,5,0,5,5
45,142,6,0,1,1
45,143,0,0,2,2
45,143,1,3,6,3
45,143,2,1,5,4
45,143,3,0,2,2
45,143,4,0,5,5
45,143,5,0,2,2
45,143,6,0,3,3
46,0,0,3,97,94
46,0,1,12,103,91
46,0,2,7,123,116
46,0,3,16,113,97
46,0,4,10,177,167
46,0,5,5,135,130
46,0,6,7,144,137
46,1,0,12,100,88
46,1,1,5,75,70
46,1,2,14,93,79
46,1,3,14,112,98
46,1,4,3,99,96
46,1,5,8,112,104
46,1,6,6,105,99
46,2,0,4,73,69
46,2,1,2,57,55
46,2,2,3,94,91
46,2,3,3,81,78
46,2,4,2,95,93
46,2,5,1,85,84
46,2,6,2,98,96
46,3,0,9,94,85
46,3,1,13,74,61
46,3,2,4,88,84
46,3,3,3,79,76
46,3,4,10,104,94
46,3,5,6,81,75
46,3,6,2,103,101
46,4,0,6,53,47
46,4,1,2,55,53
46,4,2,1,46,45
46,4,3,6,72,66
46,4,4,9,96,87
46,4,5,5,77,72
46,4,6,2,67,65
46,5,0,2,57,55
46,5,1,4,62,58
46,5,2,0,47,47
46,5,3,6,69,63
46,5,4,5,88,83
46,5,5,1,54,53
46,5,6,1,72,71
46,6,0,1,46,45
46,6,1,10,68,58
46,6,2,4,34,30
46,6,3,1,53,52
46,6,4,12,91,79
46,6,5,5,52,47
46,6,6,3,76,73
46,7,0,3,42,39
46,7,1,16,67,51
46,7,2,7,38,31
46,7,3,4,53,49
46,7,4,7,79,72
46,7,5,5,58,53
46,7,6,2,62,60
46,8,0,5,60,55
46,8,1,11,62,51
46,8,2,0,36,36
46,8,3,5,44,39
46,8,4,2,75,73
46,8,5,0,43,43
46,8,6,2,75,73
46,9,0,2,31,29
46,9,1,1,40,39
46,9,2,3,39,36
46,9,3,1,38,37
46,9,4,2,60,58
46,9,5,5,56,51
46,9,6,6,60,54
46,10,0,5,32,27
46,10,1,3,37,34
46,10,2,2,32,30
46,10,3,2,38,36
46,10,4,2,53,51
46,10,5,5,46,41
46,10,6,0,34,34
46,11,0,2,24,22
46,11,1,1,37,36
46,11,2,1,31,30
46,11,3,4,25,21
46,11,4,1,54,53
46,11,5,1,30,29
46,11,6,7,37,30
46,12,0,5,33,28
46,12,1,11,41,30
46,12,2,1,19,18
46,12,3,6,45,39
46,12,4,3,43,40
46,12,5,2,47,45
46,12,6,7,52,45
46,13,0,3,27,24
46,13,1,6,35,29
46,13,2,7,36,29
46,13,3,2,25,23
46,13,4,3,41,38
46,13,5,1,23,22
46,13,6,4,30,26
46,14,0,4,23,19
46,14,1,7,41,34
46,14,2,3,18,15
46,14,3,7,31,24
46,14,4,7,62,55
46,14,5,2,35,33
46,14,6,5,40,35
46,15,0,7,29,22
46,15,1,1,20,19
46,15,2,4,24,20
46,15,3,5,24,19
46,15,4,3,46,43
46,15,5,2,32,30
46,15,6,4,39,35
46,16,0,6,23,17
46,16,1,3,19,16
46,16,2,4,25,21
46,16,3,3,17,14
46,16,4,3,31,28
46,16,5,7,31,24
46,16,6,1,31,30
46,17,0,2,22,20
46,17,1,0,21,21
46,17,2,2,16,14
46,17,3,1,9,8
46,17,4,7,39,32
46,17,5,8,29,21
46,17,6,7,26,19
46,18,0,0,15,15
46,18,1,7,21,14
46,18,2,0,19,19
46,18,3,2,15,13
46,18,4,9,40,31
46,18,5,3,33,30
46,18,6,4,26,22
46,19,0,1,21,20
46,19,1,4,13,9
46,19,2,4,16,12
46,19,3,0,23,23
46,19,4,8,38,30
46,19,5,1,16,15
46,19,6,1,23,22
46,20,0,9,22,13
46,20,1,8,22,14
46,20,2,3,16,13
46,20,3,1,11,10
46,20,4,8,30,22
46,20,5,5,26,21
46,20,6,4,18,14
46,21,0,5,17,12
46,21,1,4,12,8
46,21,2,0,13,13
46,21,3,0,9,9
46,21,4,2,28,26
46,21,5,1,15,14
46,21,6,0,6,6
46,22,0,8,14,6
46,22,1,4,15,11
46,22,2,7,15,8
46,22,3,0,9,9
46,22,4,4,19,15
46,22,5,2,24,22
46,22,6,5,10,5
46,23,0,2,14,12
46,23,1,3,11,8
46,23,2,2,13,11
46,23,3,0,14,14
46,23,4,2,17,15
46,23,5,1,10,9
46,23,6,0,11,11
46,24,0,1,13,12
46,24,1,6,13,7
46,24,2,0,8,8
46,24,3,3,16,13
46,24,4,9,29,20
46,24,5,3,14,11
46,24,6,4,19,15
46,25,0,1,6,5
46,25,1,9,22,13
46,25,2,4,15,11
46,25,3,10,14,4
46,25,4,0,13,13
46,25,5,10,25,15
46,25,6,11,29,18
46,26,0,4,12,8
46,26,1,1,9,8
46,26,2,5,16,11
46,26,3,3,10,7
46,26,4,1,25,24
46,26,5,5,20,15
46,26,6,1,12,11
46,27,0,5,14,9
46,27,1,4,9,5
46,27,2,1,10,9
46,27,3,0,6,6
46,27,4,18,32,14
46,27,5,15,23,8
46,27,6,2,8,6
46,28,0,4,11,7
46,28,1,4,7,3
46,28,2,2,12,10
46,28,3,4,9,5
46,28,4,11,20,9
46,28,5,8,19,11
46,28,6,4,17,13
46,29,0,6,13,7
46,29,1,4,12,8
46,29,2,2,9,7
46,29,3,1,9,8
46,29,4,16,30,14
46,29,5,9,20,11
46,29,6,2,13,11
46,30,0,5,8,3
46,30,1,4,14,10
46,30,2,5,16,11
46,30,3,4,15,11
46,30,4,11,25,14
46,30,5,5,11,6
46,30,6,3,13,10
46,31,0,6,12,6
46,31,1,2,8,6
46,31,2,1,11,10
46,31,3,7,18,11
46,31,4,10,24,14
46,31,5,1,9,8
46,31,6,3,11,8
46,32,0,9,21,12
46,32,1,8,18,10
46,32,2,1,12,11
46,32,3,8,24,16
46,32,4,18,28,10
46,32,5,8,25,17
46,32,6,3,19,16
46,33,0,18,28,10
46,33,1,5,28,23
46,33,2,8,30,22
46,33,3,7,26,19
46,33,4,32,48,16
46,33,5,8,24,16
46,33,6,4,13,9
46,34,0,18,35,17
46,34,1,5,16,11
46,34,2,15,31,16
46,34,3,6,16,10
46,34,4,47,60,13
46,34,5,14,29,15
46,34,6,6,23,17
46,35,0,17,36,19
46,35,1,8,23,15
46,35,2,8,28,20
46,35,3,8,18,10
46,35,4,48,64,16
46,35,5,11,22,11
46,35,6,12,28,16
46,36,0,26,50,24
46,36,1,24,41,17
46,36,2,20,38,18
46,36,3,17,35,18
46,36,4,85,106,21
46,36,5,17,42,25
46,36,6,12,43,31
46,37,0,34,56,22
46,37,1,17,37,20
46,37,2,36,53,17
46,37,3,31,50,19
46,37,4,117,136,19
46,37,5,31,50,19
46,37,6,13,31,18
46,38,0,43,74,31
46,38,1,20,52,32
46,38,2,31,68,37
46,38,3,23,49,26
46,38,4,147,175,28
46,38,5,32,60,28
46,38,6,21,54,33
46,39,0,11,145,134
46,39,1,4,92,88
46,39,2,6,85,79
46,39,3,5,113,108
46,39,4,159,228,69
46,39,5,5,70,65
46,39,6,9,66,57
46,40,0,7,118,111
46,40,1,3,92,89
46,40,2,6,110,104
46,40,3,5,115,110
46,40,4,176,274,98
46,40,5,19,97,78
46,40,6,15,70,55
46,41,0,11,141,130
46,41,1,3,138,135
46,41,2,1,123,122
46,41,3,3,144,141
46,41,4,155,274,119
46,41,5,37,136,99
46,41,6,18,91,73
46,42,0,25,310,285
46,42,1,10,270,260
46,42,2,7,281,274
46,42,3,10,287,277
46,42,4,173,395,222
46,42,5,64,181,117
46,42,6,25,120,95
46,43,0,24,389,365
46,43,1,11,342,331
46,43,2,14,366,352
46,43,3,11,411,400
46,43,4,150,396,246
46,43,5,40,180,140
46,43,6,24,144,120
46,44,0,93,638,545
46,44,1,27,569,542
46,44,2,41,583,542
46,44,3,120,609,489
46,44,4,146,534,388
46,44,5,56,288,232
46,44,6,52,212,160
46,45,0,466,1072,606
46,45,1,117,789,672
46,45,2,150,846,696
46,45,3,450,1126,676
46,45,4,169,696,527
46,45,5,59,354,295
46,45,6,36,271,235
46,46,0,801,1454,653
46,46,1,574,1294,720
46,46,2,487,1226,739
46,46,3,653,1398,745
46,46,4,346,936,590
46,46,5,66,358,292
46,46,6,33,268,235
46,47,0,1011,1603,592
46,47,1,1251,1928,677
46,47,2,903,1567,664
46,47,3,850,1545,695
46,47,4,504,1024,520
46,47,5,130,458,328
46,47,6,52,287,235
46,48,0,1226,1777,551
46,48,1,1400,2068,668
46,48,2,974,1588,614
46,48,3,1004,1670,666
46,48,4,645,1171,526
46,48,5,243,587,344
46,48,6,63,323,260
46,49,0,1200,1851,651
46,49,1,1362,2007,645
46,49,2,936,1573,637
46,49,3,819,1531,712
46,49,4,554,1127,573
46,49,5,235,584,349
46,49,6,77,386,309
46,50,0,1017,1728,711
46,50,1,1097,1858,761
46,50,2,715,1500,785
46,50,3,550,1356,806
46,50,4,422,1074,652
46,50,5,316,729,413
46,50,6,50,376,326
46,51,0,1128,1914,786
46,51,1,881,1748,867
46,51,2,720,1544,824
46,51,3,574,1408,834
46,51,4,395,1045,650
46,51,5,466,885,419
46,51,6,110,439,329
46,52,0,869,1588,719
46,52,1,715,1453,738
46,52,2,615,1318,703
46,52,3,500,1233,733
46,52,4,370,901,531
46,52,5,509,916,407
46,52,6,141,495,354
46,53,0,517,1223,706
46,53,1,474,1170,696
46,53,2,398,1086,688
46,53,3,339,1026,687
46,53,4,238,741,503
46,53,5,275,644,369
46,53,6,84,361,277
46,54,0,354,1032,678
46,54,1,329,1007,678
46,54,2,261,952,691
46,54,3,254,942,688
46,54,4,222,744,522
46,54,5,208,626,418
46,54,6,67,340,273
46,55,0,313,909,596
46,55,1,314,885,571
46,55,2,240,863,623
46,55,3,232,878,646
46,55,4,277,790,513
46,55,5,333,694,361
46,55,6,48,342,294
46,56,0,161,666,505
46,56,1,251,789,538
46,56,2,169,692,523
46,56,3,141,661,520
46,56,4,259,686,427
46,56,5,356,744,388
46,56,6,86,386,300
46,57,0,167,604,437
46,57,1,233,615,382
46,57,2,183,638,455
46,57,3,165,583,418
46,57,4,254,565,311
46,57,5,380,694,314
46,57,6,86,382,296
46,58,0,124,487,363
46,58,1,172,554,382
46,58,2,127,512,385
46,58,3,178,599,421
46,58,4,247,548,301
46,58,5,396,716,320
46,58,6,145,443,298
46,59,0,51,361,310
46,59,1,93,407,314
46,59,2,110,471,361
46,59,3,98,460,362
46,59,4,270,568,298
46,59,5,307,593,286
46,59,6,80,343,263
46,60,0,17,270,253
46,60,1,27,281,254
46,60,2,45,299,254
46,60,3,58,372,314
46,60,4,199,479,280
46,60,5,290,624,334
46,60,6,103,361,258
46,61,0,13,291,278
46,61,1,56,313,257
46,61,2,64,310,246
46,61,3,19,309,290
46,61,4,193,436,243
46,61,5,217,548,331
46,61,6,122,392,270
46,62,0,19,258,239
46,62,1,36,266,230
46,62,2,40,263,223
46,62,3,23,281,258
46,62,4,164,392,228
46,62,5,260,591,331
46,62,6,145,435,290
46,63,0,9,262,253
46,63,1,23,243,220
46,63,2,32,255,223
46,63,3,23,258,235
46,63,4,215,450,235
46,63,5,258,545,287
46,63,6,127,408,281
46,64,0,19,255,236
46,64,1,29,249,220
46,64,2,38,251,213
46,64,3,43,310,267
46,64,4,232,453,221
46,64,5,241,545,304
46,64,6,131,413,282
46,65,0,15,239,224
46,65,1,30,236,206
46,65,2,24,259,235
46,65,3,13,259,246
46,65,4,250,469,219
46,65,5,206,523,317
46,65,6,181,469,288
46,66,0,14,250,236
46,66,1,18,207,189
46,66,2,18,244,226
46,66,3,21,287,266
46,66,4,239,485,246
46,66,5,209,491,282
46,66,6,225,480,255
46,67,0,14,241,227
46,67,1,23,243,220
46,67,2,31,257,226
46,67,3,49,318,269
46,67,4,246,475,229
46,67,5,193,466,273
46,67,6,258,545,287
46,68,0,15,253,238
46,68,1,44,302,258
46,68,2,29,277,248
46,68,3,45,318,273
46,68,4,243,486,243
46,68,5,258,553,295
46,68,6,370,617,247
46,69,0,29,290,261
46,69,1,57,341,284
46,69,2,55,317,262
46,69,3,81,372,291
46,69,4,251,522,271
46,69,5,281,575,294
46,69,6,364,622,258
46,70,0,22,289,267
46,70,1,64,353,289
46,70,2,98,355,257
46,70,3,60,341,281
46,70,4,224,459,235
46,70,5,278,586,308
46,70,6,308,616,308
46,71,0,28,308,280
46,71,1,25,288,263
46,71,2,71,336,265
46,71,3,37,330,293
46,71,4,213,471,258
46,71,5,246,592,346
46,71,6,243,585,342
46,72,0,14,292,278
46,72,1,45,334,289
46,72,2,45,322,277
46,72,3,39,345,306
46,72,4,183,460,277
46,72,5,214,574,360
46,72,6,118,492,374
46,73,0,13,298,285
46,73,1,77,362,285
46,73,2,72,373,301
46,73,3,68,326,258
46,73,4,181,452,271
46,73,5,231,564,333
46,73,6,130,484,354
46,74,0,23,311,288
46,74,1,48,316,268
46,74,2,83,356,273
46,74,3,29,311,282
46,74,4,191,465,274
46,74,5,193,532,339
46,74,6,86,423,337
46,75,0,36,316,280
46,75,1,59,338,279
46,75,2,59,347,288
46,75,3,68,380,312
46,75,4,159,432,273
46,75,5,236,576,340
46,75,6,102,457,355
46,76,0,37,305,268
46,76,1,89,399,310
46,76,2,128,420,292
46,76,3,67,349,282
46,76,4,162,456,294
46,76,5,300,687,387
46,76,6,70,438,368
46,77,0,26,319,293
46,77,1,69,343,274
46,77,2,100,383,283
46,77,3,61,363,302
46,77,4,198,480,282
46,77,5,246,616,370
46,77,6,103,514,411
46,78,0,45,357,312
46,78,1,122,408,286
46,78,2,117,417,300
46,78,3,102,433,331
46,78,4,162,445,283
46,78,5,220,577,357
46,78,6,62,440,378
46,79,0,35,321,286
46,79,1,78,358,280
46,79,2,60,349,289
46,79,3,67,335,268
46,79,4,166,468,302
46,79,5,311,701,390
46,79,6,83,487,404
46,80,0,42,313,271
46,80,1,99,388,289
46,80,2,65,363,298
46,80,3,74,356,282
46,80,4,193,455,262
46,80,5,271,624,353
46,80,6,71,437,366
46,81,0,41,324,283
46,81,1,87,394,307
46,81,2,87,370,283
46,81,3,82,385,303
46,81,4,155,425,270
46,81,5,257,609,352
46,81,6,105,512,407
46,82,0,18,280,262
46,82,1,56,333,277
46,82,2,52,307,255
46,82,3,54,316,262
46,82,4,179,477,298
46,82,5,319,666,347
46,82,6,124,514,390
46,83,0,40,291,251
46,83,1,62,326,264
46,83,2,34,270,236
46,83,3,38,301,263
46,83,4,167,420,253
46,83,5,215,563,348
46,83,6,77,452,375
46,84,0,22,248,226
46,84,1,67,326,259
46,84,2,34,292,258
46,84,3,25,265,240
46,84,4,167,434,267
46,84,5,167,514,347
46,84,6,132,516,384
46,85,0,34,271,237
46,85,1,60,303,243
46,85,2,25,256,231
46,85,3,24,285,261
46,85,4,141,409,268
46,85,5,118,433,315
46,85,6,81,457,376
46,86,0,24,273,249
46,86,1,31,295,264
46,86,2,27,268,241
46,86,3,25,268,243
46,86,4,123,380,257
46,86,5,88,413,325
46,86,6,28,376,348
46,87,0,25,263,238
46,87,1,13,263,250
46,87,2,25,258,233
46,87,3,13,240,227
46,87,4,79,342,263
46,87,5,78,383,305
46,87,6,21,382,361
46,88,0,5,232,227
46,88,1,16,268,252
46,88,2,16,257,241
46,88,3,11,253,242
46,88,4,115,362,247
46,88,5,54,374,320
46,88,6,11,364,353
46,89,0,9,247,238
46,89,1,24,269,245
46,89,2,12,248,236
46,89,3,11,271,260
46,89,4,90,343,253
46,89,5,25,344,319
46,89,6,10,363,353
46,90,0,10,260,250
46,90,1,13,269,256
46,90,2,26,302,276
46,90,3,34,294,260
46,90,4,106,376,270
46,90,5,23,334,311
46,90,6,8,353,345
46,91,0,9,244,235
46,91,1,17,257,240
46,91,2,48,303,255
46,91,3,49,300,251
46,91,4,125,395,270
46,91,5,18,307,289
46,91,6,16,346,330
46,92,0,7,224,217
46,92,1,28,264,236
46,92,2,30,279,249
46,92,3,11,248,237
46,92,4,106,353,247
46,92,5,11,289,278
46,92,6,7,335,328
46,93,0,6,278,272
46,93,1,8,265,257
46,93,2,3,296,293
46,93,3,12,267,255
46,93,4,9,333,324
46,93,5,10,297,287
46,93,6,14,379,365
46,94,0,12,261,249
46,94,1,6,258,252
46,94,2,10,277,267
46,94,3,12,251,239
46,94,4,14,304,290
46,94,5,10,273,263
46,94,6,15,329,314
46,95,0,6,270,264
46,95,1,19,282,263
46,95,2,8,273,265
46,95,3,8,249,241
46,95,4,9,304,295
46,95,5,29,331,302
46,95,6,10,328,318
46,96,0,5,246,241
46,96,1,4,291,287
46,96,2,5,271,266
46,96,3,11,307,296
46,96,4,8,277,269
46,96,5,11,347,336
46,96,6,9,356,347
46,97,0,10,248,238
46,97,1,6,251,245
46,97,2,3,260,257
46,97,3,10,295,285
46,97,4,5,308,303
46,97,5,8,280,272
46,97,6,7,324,317
46,98,0,15,257,242
46,98,1,14,278,264
46,98,2,11,299,288
46,98,3,15,298,283
46,98,4,13,319,306
46,98,5,10,298,288
46,98,6,18,330,312
46,99,0,10,325,315
46,99,1,7,301,294
46,99,2,8,307,299
46,99,3,7,312,305
46,99,4,9,315,306
46,99,5,5,332,327
46,99,6,19,376,357
46,100,0,13,334,321
46,100,1,9,307,298
46,100,2,7,334,327
46,100,3,10,321,311
46,100,4,15,358,343
46,100,5,9,334,325
46,100,6,15,353,338
46,101,0,11,337,326
46,101,1,14,373,359
46,101,2,9,421,412
46,101,3,11,390,379
46,101,4,20,422,402
46,101,5,9,363,354
46,101,6,9,340,331
46,102,0,13,524,511
46,102,1,19,557,538
46,102,2,23,591,568
46,102,3,13,595,582
46,102,4,17,517,500
46,102,5,13,386,373
46,102,6,14,400,386
46,103,0,13,465,452
46,103,1,12,488,476
46,103,2,22,556,534
46,103,3,15,499,484
46,103,4,19,436,417
46,103,5,14,411,397
46,103,6,7,390,383
46,104,0,13,471,458
46,104,1,22,558,536
46,104,2,28,514,486
46,104,3,14,547,533
46,104,4,18,515,497
46,104,5,17,392,375
46,104,6,12,376,364
46,105,0,20,839,819
46,105,1,23,887,864
46,105,2,169,979,810
46,105,3,74,952,878
46,105,4,42,780,738
46,105,5,19,493,474
46,105,6,15,385,370
46,106,0,35,743,708
46,106,1,23,756,733
46,106,2,186,853,667
46,106,3,131,855,724
46,106,4,115,809,694
46,106,5,18,459,441
46,106,6,9,367,358
46,107,0,34,660,626
46,107,1,30,651,621
46,107,2,157,732,575
46,107,3,110,755,645
46,107,4,103,735,632
46,107,5,15,430,415
46,107,6,12,382,370
46,108,0,41,815,774
46,108,1,72,850,778
46,108,2,240,948,708
46,108,3,157,924,767
46,108,4,194,889,695
46,108,5,13,478,465
46,108,6,10,405,395
46,109,0,69,751,682
46,109,1,83,771,688
46,109,2,169,813,644
46,109,3,91,821,730
46,109,4,179,770,591
46,109,5,8,417,409
46,109,6,12,385,373
46,110,0,27,577,550
46,110,1,40,705,665
46,110,2,120,738,618
46,110,3,101,647,546
46,110,4,108,625,517
46,110,5,10,412,402
46,110,6,7,356,349
46,111,0,17,541,524
46,111,1,17,538,521
46,111,2,94,636,542
46,111,3,39,591,552
46,111,4,54,575,521
46,111,5,8,380,372
46,111,6,12,360,348
46,112,0,7,427,420
46,112,1,13,520,507
46,112,2,39,590,551
46,112,3,7,485,478
46,112,4,12,419,407
46,112,5,12,352,340
46,112,6,14,313,299
46,113,0,16,443,427
46,113,1,4,407,403
46,113,2,25,477,452
46,113,3,20,465,445
46,113,4,10,447,437
46,113,5,8,307,299
46,113,6,12,325,313
46,114,0,9,381,372
46,114,1,11,410,399
46,114,2,16,429,413
46,114,3,12,439,427
46,114,4,16,403,387
46,114,5,7,306,299
46,114,6,9,301,292
46,115,0,9,405,396
46,115,1,18,428,410
46,115,2,18,443,425
46,115,3,20,415,395
46,115,4,16,381,365
46,115,5,7,274,267
46,115,6,8,342,334
46,116,0,14,420,406
46,116,1,4,369,365
46,116,2,10,409,399
46,116,3,9,382,373
46,116,4,12,366,354
46,116,5,4,305,301
46,116,6,9,297,288
46,117,0,6,385,379
46,117,1,13,414,401
46,117,2,6,421,415
46,117,3,13,379,366
46,117,4,9,338,329
46,117,5,9,262,253
46,117,6,11,270,259
46,118,0,6,396,390
46,118,1,9,357,348
46,118,2,17,382,365
46,118,3,21,379,358
46,118,4,12,341,329
46,118,5,13,313,300
46,118,6,8,278,270
46,119,0,9,403,394
46,119,1,11,369,358
46,119,2,14,382,368
46,119,3,10,372,362
46,119,4,9,345,336
46,119,5,5,266,261
46,119,6,6,286,280
46,120,0,16,516,500
46,120,1,24,481,457
46,120,2,20,498,478
46,120,3,11,534,523
46,120,4,21,406,385
46,120,5,7,311,304
46,120,6,15,327,312
46,121,0,19,517,498
46,121,1,28,562,534
46,121,2,18,512,494
46,121,3,21,519,498
46,121,4,19,410,391
46,121,5,10,309,299
46,121,6,8,291,283
46,122,0,17,473,456
46,122,1,16,513,497
46,122,2,20,550,530
46,122,3,21,494,473
46,122,4,12,398,386
46,122,5,13,348,335
46,122,6,16,325,309
46,123,0,22,492,470
46,123,1,17,523,506
46,123,2,14,560,546
46,123,3,11,516,505
46,123,4,9,371,362
46,123,5,14,330,316
46,123,6,4,279,275
46,124,0,18,444,426
46,124,1,18,504,486
46,124,2,11,443,432
46,124,3,15,429,414
46,124,4,10,358,348
46,124,5,14,296,282
46,124,6,2,274,272
46,125,0,9,415,406
46,125,1,18,440,422
46,125,2,15,431,416
46,125,3,13,441,428
46,125,4,19,374,355
46,125,5,3,307,304
46,125,6,6,254,248
46,126,0,9,479,470
46,126,1,17,536,519
46,126,2,18,508,490
46,126,3,20,551,531
46,126,4,11,451,440
46,126,5,11,329,318
46,126,6,4,305,301
46,127,0,16,461,445
46,127,1,20,487,467
46,127,2,7,453,446
46,127,3,15,461,446
46,127,4,16,401,385
46,127,5,8,313,305
46,127,6,10,298,288
46,128,0,16,413,397
46,128,1,14,402,388
46,128,2,12,419,407
46,128,3,16,446,430
46,128,4,11,401,390
46,128,5,12,305,293
46,128,6,5,231,226
46,129,0,18,426,408
46,129,1,12,404,392
46,129,2,12,418,406
46,129,3,12,392,380
46,129,4,13,368,355
46,129,5,14,291,277
46,129,6,7,274,267
46,130,0,9,384,375
46,130,1,11,353,342
46,130,2,11,397,386
46,130,3,10,375,365
46,130,4,17,326,309
46,130,5,8,330,322
46,130,6,10,241,231
46,131,0,13,335,322
46,131,1,24,373,349
46,131,2,10,358,348
46,131,3,15,365,350
46,131,4,7,335,328
46,131,5,8,295,287
46,131,6,5,231,226
46,132,0,9,338,329
46,132,1,6,356,350
46,132,2,10,358,348
46,132,3,10,296,286
46,132,4,16,313,297
46,132,5,12,346,334
46,132,6,5,227,222
46,133,0,7,286,279
46,133,1,13,278,265
46,133,2,10,333,323
46,133,3,11,271,260
46,133,4,5,309,304
46,133,5,9,314,305
46,133,6,7,238,231
46,134,0,9,225,216
46,134,1,8,259,251
46,134,2,12,283,271
46,134,3,5,277,272
46,134,4,13,265,252
46,134,5,10,256,246
46,134,6,5,177,172
46,135,0,10,197,187
46,135,1,9,246,237
46,135,2,4,215,211
46,135,3,1,224,223
46,135,4,7,249,242
46,135,5,9,216,207
46,135,6,7,176,169
46,136,0,6,194,188
46,136,1,7,251,244
46,136,2,12,223,211
46,136,3,8,198,190
46,136,4,10,217,207
46,136,5,5,204,199
46,136,6,6,161,155
46,137,0,12,189,177
46,137,1,8,177,169
46,137,2,4,167,163
46,137,3,17,225,208
46,137,4,6,190,184
46,137,5,10,218,208
46,137,6,7,166,159
46,138,0,8,152,144
46,138,1,7,161,154
46,138,2,15,188,173
46,138,3,9,172,163
46,138,4,7,168,161
46,138,5,8,166,158
46,138,6,7,120,113
46,139,0,4,120,116
46,139,1,3,120,117
46,139,2,3,139,136
46,139,3,4,137,133
46,139,4,5,158,153
46,139,5,8,140,132
46,139,6,13,120,107
46,140,0,4,109,105
46,140,1,6,108,102
46,140,2,6,131,125
46,140,3,11,126,115
46,140,4,2,160,158
46,140,5,4,121,117
46,140,6,6,98,92
46,141,0,5,101,96
46,141,1,9,125,116
46,141,2,7,108,101
46,141,3,6,135,129
46,141,4,5,141,136
46,141,5,5,124,119
46,141,6,5,98,93
46,142,0,4,82,78
46,142,1,2,86,84
46,142,2,5,100,95
46,142,3,4,104,100
46,142,4,2,121,119
46,142,5,10,132,122
46,142,6,5,109,104
46,143,0,8,73,65
46,143,1,0,74,74
46,143,2,11,113,102
46,143,3,4,81,77
46,143,4,14,147,133
46,143,5,7,109,102
46,143,6,4,86,82
47,0,0,3,15,12
47,0,1,1,13,12
47,0,2,3,7,4
47,0,3,1,10,9
47,0,4,0,8,8
47,0,5,1,6,5
47,0,6,1,13,12
47,1,0,4,12,8
47,1,1,0,8,8
47,1,2,4,10,6
47,1,3,2,8,6
47,1,4,1,8,7
47,1,5,0,10,10
47,1,6,3,11,8
47,2,0,5,10,5
47,2,1,0,7,7
47,2,2,1,8,7
47,2,3,2,10,8
47,2,4,2,15,13
47,2,5,2,7,5
47,2,6,9,15,6
47,3,0,3,12,9
47,3,1,6,10,4
47,3,2,2,7,5
47,3,3,13,23,10
47,3,4,3,8,5
47,3,5,2,9,7
47,3,6,3,7,4
47,4,0,3,12,9
47,4,1,4,10,6
47,4,2,0,5,5
47,4,3,11,19,8
47,4,4,0,5,5
47,4,5,1,7,6
47,4,6,0,7,7
47,5,0,3,9,6
47,5,1,3,8,5
47,5,2,2,7,5
47,5,3,4,6,2
47,5,4,1,7,6
47,5,5,2,5,3
47,5,6,2,7,5
47,6,0,1,3,2
47,6,1,4,7,3
47,6,2,2,5,3
47,6,3,3,10,7
47,6,4,1,2,1
47,6,5,1,6,5
47,6,6,3,14,11
47,7,0,0,4,4
47,7,1,1,3,2
47,7,2,2,7,5
47,7,3,8,12,4
47,7,4,1,4,3
47,7,5,2,7,5
47,7,6,1,4,3
47,8,0,6,9,3
47,8,1,0,2,2
47,8,2,0,2,2
47,8,3,2,9,7
47,8,4,3,12,9
47,8,5,3,12,9
47,8,6,1,7,6
47,9,0,0,2,2
47,9,1,3,9,6
47,9,2,2,9,7
47,9,3,1,9,8
47,9,4,0,2,2
47,9,5,4,14,10
47,9,6,3,3,0
47,10,0,2,4,2
47,10,1,9,12,3
47,10,2,0,5,5
47,10,3,2,4,2
47,10,4,4,7,3
47,10,5,0,6,6
47,10,6,2,8,6
47,11,0,2,4,2
47,11,1,5,6,1
47,11,2,5,9,4
47,11,3,5,9,4
47,11,4,6,11,5
47,11,5,0,5,5
47,11,6,1,4,3
47,12,0,2,3,1
47,12,1,1,4,3
47,12,2,5,10,5
47,12,3,2,5,3
47,12,4,3,10,7
47,12,5,2,4,2
47,12,6,2,6,4
47,13,0,5,7,2
47,13,2,2,6,4
47,13,3,1,3,2
47,13,4,0,4,4
47,13,5,1,4,3
47,13,6,1,2,1
47,14,0,0,3,3
47,14,1,0,5,5
47,14,2,3,7,4
47,14,3,2,7,5
47,14,4,1,4,3
47,14,5,2,3,1
47,14,6,1,4,3
47,15,0,0,5,5
47,15,1,3,6,3
47,15,2,0,3,3
47,15,3,2,3,1
47,15,4,0,1,1
47,15,5,1,4,3
47,15,6,1,5,4
47,16,0,2,3,1
47,16,1,2,3,1
47,16,3,1,4,3
47,16,4,1,2,1
47,16,5,2,5,3
47,16,6,1,4,3
47,17,0,0,3,3
47,17,1,2,6,4
47,17,2,0,1,1
47,17,4,3,5,2
47,17,5,9,11,2
47,17,6,0,4,4
47,18,0,0,1,1
47,18,1,4,5,1
47,18,2,2,4,2
47,18,3,1,4,3
47,18,4,3,4,1
47,18,5,5,9,4
47,18,6,2,3,1
47,19,0,1,2,1
47,19,1,1,2,1
47,19,2,1,3,2
47,19,3,3,5,2
47,19,4,2,5,3
47,19,5,3,5,2
47,19,6,1,5,4
47,20,0,0,1,1
47,20,2,1,3,2
47,20,3,2,4,2
47,20,4,0,1,1
47,20,6,1,5,4
47,21,0,4,5,1
47,21,1,0,2,2
47,21,2,3,4,1
47,21,4,3,7,4
47,21,5,4,5,1
47,21,6,3,4,1
47,22,0,4,7,3
47,22,1,0,2,2
47,22,2,2,3,1
47,22,3,0,1,1
47,22,4,2,4,2
47,22,5,7,9,2
47,22,6,3,5,2
47,23,1,1,1,0
47,23,2,2,4,2
47,23,3,1,3,2
47,23,4,2,3,1
47,23,5,1,3,2
47,23,6,1,4,3
47,24,1,1,1,0
47,24,2,1,2,1
47,24,3,0,1,1
47,24,4,0,1,1
47,24,5,0,2,2
47,24,6,1,2,1
47,25,1,5,5,0
47,25,2,0,4,4
47,25,3,1,1,0
47,25,4,1,5,4
47,25,5,1,1,0
47,25,6,0,2,2
47,26,0,4,5,1
47,26,1,3,8,5
47,26,2,4,7,3
47,26,3,4,6,2
47,26,4,1,1,0
47,26,5,1,2,1
47,26,6,0,1,1
47,27,0,6,7,1
47,27,2,0,3,3
47,27,3,2,3,1
47,27,4,2,3,1
47,27,5,1,3,2
47,27,6,0,4,4
47,28,0,3,4,1
47,28,2,2,3,1
47,28,3,1,2,1
47,28,4,1,1,0
47,28,5,1,2,1
47,28,6,3,3,0
47,29,0,1,1,0
47,29,1,5,7,2
47,29,2,3,4,1
47,29,3,1,3,2
47,29,4,3,3,0
47,29,5,0,3,3
47,29,6,5,6,1
47,30,0,1,2,1
47,30,2,3,5,2
47,30,3,9,9,0
47,30,4,5,6,1
47,30,5,0,2,2
47,30,6,1,2,1
47,31,0,1,1,0
47,31,1,2,2,0
47,31,2,2,2,0
47,31,3,8,10,2
47,31,4,5,6,1
47,31,6,0,2,2
47,32,1,2,2,0
47,32,2,2,2,0
47,32,3,11,11,0
47,32,5,2,2,0
47,32,6,4,7,3
47,33,0,2,2,0
47,33,1,5,6,1
47,33,2,2,6,4
47,33,3,7,10,3
47,33,4,0,2,2
47,33,5,2,2,0
47,33,6,1,2,1
47,34,0,5,7,2
47,34,1,1,2,1
47,34,2,1,2,1
47,34,3,6,7,1
47,34,4,3,5,2
47,34,5,1,2,1
47,34,6,2,2,0
47,35,0,0,2,2
47,35,1,4,9,5
47,35,2,0,1,1
47,35,3,2,3,1
47,35,4,5,7,2
47,35,5,4,5,1
47,35,6,1,1,0
47,36,0,4,7,3
47,36,1,4,11,7
47,36,2,0,8,8
47,36,3,9,10,1
47,36,4,2,9,7
47,36,5,0,1,1
47,36,6,2,4,2
47,37,0,7,12,5
47,37,1,1,7,6
47,37,2,9,11,2
47,37,3,7,10,3
47,37,4,1,7,6
47,37,5,0,6,6
47,37,6,4,5,1
47,38,0,8,12,4
47,38,1,5,15,10
47,38,2,2,8,6
47,38,3,6,8,2
47,38,4,2,10,8
47,38,5,3,9,6
47,38,6,4,6,2
47,39,0,2,15,13
47,39,1,0,15,15
47,39,2,0,7,7
47,39,3,3,17,14
47,39,4,3,15,12
47,39,5,0,6,6
47,39,6,0,7,7
47,40,0,0,24,24
47,40,1,0,9,9
47,40,2,3,26,23
47,40,3,2,20,18
47,40,4,0,12,12
47,40,5,2,7,5
47,40,6,1,8,7
47,41,0,2,26,24
47,41,1,0,16,16
47,41,2,3,23,20
47,41,3,1,19,18
47,41,4,0,13,13
47,41,5,0,9,9
47,41,6,2,7,5
47,42,0,1,27,26
47,42,1,1,31,30
47,42,2,3,31,28
47,42,3,1,38,37
47,42,4,2,17,15
47,42,5,4,21,17
47,42,6,4,15,11
47,43,0,0,25,25
47,43,1,0,24,24
47,43,2,0,19,19
47,43,3,3,28,25
47,43,4,7,29,22
47,43,5,0,24,24
47,43,6,0,13,13
47,44,0,1,47,46
47,44,1,2,30,28
47,44,2,0,34,34
47,44,3,2,54,52
47,44,4,6,40,34
47,44,5,7,27,20
47,44,6,1,16,15
47,45,0,2,47,45
47,45,1,2,43,41
47,45,2,2,33,31
47,45,3,0,44,44
47,45,4,2,35,33
47,45,5,0,28,28
47,45,6,1,26,25
47,46,0,4,50,46
47,46,1,3,56,53
47,46,2,0,42,42
47,46,3,2,48,46
47,46,4,6,38,32
47,46,5,5,36,31
47,46,6,13,39,26
47,47,0,7,53,46
47,47,1,3,45,42
47,47,2,2,53,51
47,47,3,9,67,58
47,47,4,7,40,33
47,47,5,1,27,26
47,47,6,4,29,25
47,48,0,21,68,47
47,48,1,4,51,47
47,48,2,8,65,57
47,48,3,4,60,56
47,48,4,11,50,39
47,48,5,2,30,28
47,48,6,4,27,23
47,49,0,17,65,48
47,49,1,8,61,53
47,49,2,8,57,49
47,49,3,5,42,37
47,49,4,12,45,33
47,49,5,1,25,24
47,49,6,1,32,31
47,50,0,14,51,37
47,50,1,9,45,36
47,50,2,7,49,42
47,50,3,12,54,42
47,50,4,9,46,37
47,50,5,2,33,31
47,50,6,6,34,28
47,51,0,23,69,46
47,51,1,27,72,45
47,51,2,18,59,41
47,51,3,9,47,38
47,51,4,5,40,35
47,51,5,1,25,24
47,51,6,1,24,23
47,52,0,19,54,35
47,52,1,17,60,43
47,52,2,7,39,32
47,52,3,9,53,44
47,52,4,5,30,25
47,52,5,4,23,19
47,52,6,0,24,24
47,53,0,12,42,30
47,53,1,5,36,31
47,53,2,6,38,32
47,53,3,7,35,28
47,53,4,8,31,23
47,53,5,2,27,25
47,53,6,2,26,24
47,54,0,9,36,27
47,54,1,7,41,34
47,54,2,6,38,32
47,54,3,13,46,33
47,54,4,3,23,20
47,54,5,5,29,24
47,54,6,2,29,27
47,55,0,9,40,31
47,55,1,7,45,38
47,55,2,2,41,39
47,55,3,11,52,41
47,55,4,7,25,18
47,55,5,3,35,32
47,55,6,3,24,21
47,56,0,6,31,25
47,56,1,4,32,28
47,56,2,9,36,27
47,56,3,20,50,30
47,56,4,12,38,26
47,56,5,3,28,25
47,56,6,3,31,28
47,57,0,11,39,28
47,57,1,0,31,31
47,57,2,21,44,23
47,57,3,15,40,25
47,57,4,17,40,23
47,57,5,1,26,25
47,57,6,2,18,16
47,58,0,15,41,26
47,58,1,7,31,24
47,58,2,25,54,29
47,58,3,13,36,23
47,58,4,22,52,30
47,58,5,7,33,26
47,58,6,6,28,22
47,59,0,14,34,20
47,59,1,7,26,19
47,59,2,18,38,20
47,59,3,20,52,32
47,59,4,8,33,25
47,59,5,7,30,23
47,59,6,10,37,27
47,60,0,15,36,21
47,60,1,1,23,22
47,60,2,10,40,30
47,60,3,23,50,27
47,60,4,14,34,20
47,60,5,0,26,26
47,60,6,15,41,26
47,61,0,12,29,17
47,61,1,10,26,16
47,61,2,10,27,17
47,61,3,14,37,23
47,61,4,14,35,21
47,61,5,6,24,18
47,61,6,14,44,30
47,62,0,17,40,23
47,62,1,6,30,24
47,62,2,7,26,19
47,62,3,19,37,18
47,62,4,13,27,14
47,62,5,5,36,31
47,62,6,9,39,30
47,63,0,20,41,21
47,63,1,5,33,28
47,63,2,3,22,19
47,63,3,9,27,18
47,63,4,9,29,20
47,63,5,7,38,31
47,63,6,26,57,31
47,64,0,8,31,23
47,64,1,7,30,23
47,64,2,5,21,16
47,64,3,25,47,22
47,64,4,23,44,21
47,64,5,13,40,27
47,64,6,14,34,20
47,65,0,10,32,22
47,65,1,12,36,24
47,65,2,13,32,19
47,65,3,24,51,27
47,65,4,17,44,27
47,65,5,3,27,24
47,65,6,12,35,23
47,66,0,8,36,28
47,66,1,7,28,21
47,66,2,18,37,19
47,66,3,8,27,19
47,66,4,18,43,25
47,66,5,9,31,22
47,66,6,11,46,35
47,67,0,7,24,17
47,67,1,5,21,16
47,67,2,22,41,19
47,67,3,8,18,10
47,67,4,20,35,15
47,67,5,5,32,27
47,67,6,4,35,31
47,68,0,13,33,20
47,68,1,6,24,18
47,68,2,11,35,24
47,68,3,19,38,19
47,68,4,13,31,18
47,68,5,4,25,21
47,68,6,13,39,26
47,69,0,9,25,16
47,69,1,7,21,14
47,69,2,14,43,29
47,69,3,12,27,15
47,69,4,11,38,27
47,69,5,3,30,27
47,69,6,12,34,22
47,70,0,9,23,14
47,70,1,11,27,16
47,70,2,5,21,16
47,70,3,16,33,17
47,70,4,16,39,23
47,70,5,7,29,22
47,70,6,11,35,24
47,71,0,10,29,19
47,71,1,13,28,15
47,71,2,7,33,26
47,71,3,20,55,35
47,71,4,8,31,23
47,71,5,11,34,23
47,71,6,14,52,38
47,72,0,10,34,24
47,72,1,11,34,23
47,72,2,10,33,23
47,72,3,17,43,26
47,72,4,17,33,16
47,72,5,10,25,15
47,72,6,4,40,36
47,73,0,4,28,24
47,73,1,20,49,29
47,73,2,9,40,31
47,73,3,7,29,22
47,73,4,18,37,19
47,73,5,12,39,27
47,73,6,12,56,44
47,74,0,6,30,24
47,74,1,19,36,17
47,74,2,9,31,22
47,74,3,21,36,15
47,74,4,30,51,21
47,74,5,11,40,29
47,74,6,3,33,30
47,75,0,3,16,13
47,75,1,6,32,26
47,75,2,11,31,20
47,75,3,13,41,28
47,75,4,12,36,24
47,75,5,15,41,26
47,75,6,5,40,35
47,76,0,14,41,27
47,76,1,7,22,15
47,76,2,12,36,24
47,76,3,11,26,15
47,76,4,20,48,28
47,76,5,15,47,32
47,76,6,1,33,32
47,77,0,21,50,29
47,77,1,5,27,22
47,77,2,19,47,28
47,77,3,8,34,26
47,77,4,28,55,27
47,77,5,16,40,24
47,77,6,5,36,31
47,78,0,6,31,25
47,78,1,4,32,28
47,78,2,30,60,30
47,78,3,5,34,29
47,78,4,24,42,18
47,78,5,23,54,31
47,78,6,10,33,23
47,79,0,15,44,29
47,79,1,7,35,28
47,79,2,29,51,22
47,79,3,3,26,23
47,79,4,3,26,23
47,79,5,26,54,28
47,79,6,8,48,40
47,80,0,8,38,30
47,80,1,11,45,34
47,80,2,29,52,23
47,80,3,4,27,23
47,80,4,9,39,30
47,80,5,20,45,25
47,80,6,5,35,30
47,81,0,8,30,22
47,81,1,10,41,31
47,81,2,20,48,28
47,81,3,2,17,15
47,81,4,11,40,29
47,81,5,31,54,23
47,81,6,16,54,38
47,82,0,15,43,28
47,82,1,13,36,23
47,82,2,30,51,21
47,82,3,6,32,26
47,82,4,8,36,28
47,82,5,33,58,25
47,82,6,26,57,31
47,83,0,8,30,22
47,83,1,4,27,23
47,83,2,22,44,22
47,83,3,2,29,27
47,83,4,13,29,16
47,83,5,17,30,13
47,83,6,29,58,29
47,84,0,13,40,27
47,84,1,5,26,21
47,84,2,28,45,17
47,84,3,6,31,25
47,84,4,11,30,19
47,84,5,7,27,20
47,84,6,29,53,24
47,85,0,5,27,22
47,85,1,2,25,23
47,85,2,19,40,21
47,85,3,4,26,22
47,85,4,19,38,19
47,85,5,9,31,22
47,85,6,14,45,31
47,86,0,15,36,21
47,86,1,1,24,23
47,86,2,12,35,23
47,86,3,2,33,31
47,86,4,18,40,22
47,86,5,3,23,20
47,86,6,16,44,28
47,87,0,11,38,27
47,87,1,5,28,23
47,87,2,6,29,23
47,87,3,6,29,23
47,87,4,23,58,35
47,87,5,4,18,14
47,87,6,4,27,23
47,88,0,9,26,17
47,88,1,3,20,17
47,88,2,3,29,26
47,88,3,10,36,26
47,88,4,9,30,21
47,88,5,1,25,24
47,88,6,7,28,21
47,89,0,13,31,18
47,89,1,2,25,23
47,89,2,3,20,17
47,89,3,8,33,25
47,89,4,10,33,23
47,89,5,3,28,25
47,89,6,7,32,25
47,90,0,1,31,30
47,90,1,5,31,26
47,90,2,3,27,24
47,90,3,8,37,29
47,90,4,7,27,20
47,90,5,2,31,29
47,90,6,9,32,23
47,91,0,13,28,15
47,91,1,3,33,30
47,91,2,7,37,30
47,91,3,5,28,23
47,91,4,1,16,15
47,91,5,2,29,27
47,91,6,1,20,19
47,92,0,5,26,21
47,92,1,3,24,21
47,92,2,5,29,24
47,92,3,7,33,26
47,92,4,8,31,23
47,92,5,7,38,31
47,92,6,5,32,27
47,93,0,1,23,22
47,93,1,1,36,35
47,93,2,5,31,26
47,93,3,2,44,42
47,93,4,2,28,26
47,93,5,0,28,28
47,93,6,2,25,23
47,94,0,4,41,37
47,94,1,7,38,31
47,94,2,7,38,31
47,94,3,2,38,36
47,94,4,0,26,26
47,94,5,3,18,15
47,94,6,3,34,31
47,95,0,3,28,25
47,95,1,0,22,22
47,95,2,3,25,22
47,95,3,3,29,26
47,95,4,3,35,32
47,95,5,3,38,35
47,95,6,6,41,35
47,96,0,2,33,31
47,96,1,1,29,28
47,96,2,2,28,26
47,96,3,0,33,33
47,96,4,0,29,29
47,96,5,7,47,40
47,96,6,0,35,35
47,97,0,2,34,32
47,97,1,3,47,44
47,97,2,7,31,24
47,97,3,1,20,19
47,97,4,7,32,25
47,97,5,0,34,34
47,97,6,2,41,39
47,98,0,0,33,33
47,98,1,0,33,33
47,98,2,2,35,33
47,98,3,0,35,35
47,98,4,1,39,38
47,98,5,0,41,41
47,98,6,2,37,35
47,99,0,0,26,26
47,99,1,1,32,31
47,99,2,2,24,22
47,99,3,2,26,24
47,99,4,0,40,40
47,99,5,1,34,33
47,99,6,0,38,38
47,100,0,1,25,24
47,100,1,1,36,35
47,100,2,2,52,50
47,100,3,2,37,35
47,100,4,2,29,27
47,100,5,2,29,27
47,100,6,0,31,31
47,101,0,3,35,32
47,101,1,6,40,34
47,101,2,1,35,34
47,101,3,2,30,28
47,101,4,2,30,28
47,101,5,1,27,26
47,101,6,1,36,35
47,102,0,4,53,49
47,102,1,2,40,38
47,102,2,2,50,48
47,102,3,2,45,43
47,102,4,4,46,42
47,102,5,2,43,41
47,102,6,1,30,29
47,103,0,5,50,45
47,103,1,5,39,34
47,103,2,6,44,38
47,103,3,6,54,48
47,103,4,5,49,44
47,103,5,2,37,35
47,103,6,7,40,33
47,104,0,3,37,34
47,104,1,1,40,39
47,104,2,4,51,47
47,104,3,5,42,37
47,104,4,6,42,36
47,104,5,1,29,28
47,104,6,3,35,32
47,105,0,6,36,30
47,105,1,2,30,28
47,105,2,8,41,33
47,105,3,1,36,35
47,105,4,2,31,29
47,105,5,3,41,38
47,105,6,1,35,34
47,106,0,2,29,27
47,106,1,2,26,24
47,106,2,4,42,38
47,106,3,2,30,28
47,106,4,3,47,44
47,106,5,2,25,23
47,106,6,2,35,33
47,107,0,3,36,33
47,107,1,1,23,22
47,107,2,6,30,24
47,107,3,1,27,26
47,107,4,5,35,30
47,107,5,2,35,33
47,107,6,7,34,27
47,108,0,5,32,27
47,108,1,9,36,27
47,108,2,2,33,31
47,108,3,2,26,24
47,108,4,1,27,26
47,108,5,0,24,24
47,108,6,1,30,29
47,109,0,2,25,23
47,109,1,5,53,48
47,109,2,2,21,19
47,109,3,0,29,29
47,109,4,7,30,23
47,109,5,4,22,18
47,109,6,2,21,19
47,110,0,2,17,15
47,110,1,3,31,28
47,110,2,5,40,35
47,110,3,2,24,22
47,110,4,2,30,28
47,110,5,0,30,30
47,110,6,9,45,36
47,111,0,6,38,32
47,111,1,6,34,28
47,111,2,3,30,27
47,111,3,1,19,18
47,111,4,1,21,20
47,111,5,7,34,27
47,111,6,7,34,27
47,112,0,6,38,32
47,112,1,0,18,18
47,112,2,1,21,20
47,112,3,0,23,23
47,112,4,3,22,19
47,112,5,1,26,25
47,112,6,8,33,25
47,113,0,4,24,20
47,113,1,2,22,20
47,113,2,2,22,20
47,113,3,0,21,21
47,113,4,2,31,29
47,113,5,1,29,28
47,113,6,0,35,35
47,114,0,0,23,23
47,114,1,2,13,11
47,114,2,2,18,16
47,114,3,1,15,14
47,114,4,1,22,21
47,114,5,1,28,27
47,114,6,3,25,22
47,115,0,0,20,20
47,115,1,2,21,19
47,115,2,1,25,24
47,115,3,0,24,24
47,115,4,0,22,22
47,115,5,8,34,26
47,115,6,0,20,20
47,116,0,1,19,18
47,116,1,1,20,19
47,116,2,0,16,16
47,116,3,3,16,13
47,116,4,1,17,16
47,116,5,2,23,21
47,116,6,4,22,18
47,117,0,4,24,20
47,117,1,1,15,14
47,117,2,7,24,17
47,117,3,1,15,14
47,117,4,2,22,20
47,117,5,3,20,17
47,117,6,5,31,26
47,118,0,2,20,18
47,118,1,1,16,15
47,118,2,6,28,22
47,118,3,4,17,13
47,118,4,2,13,11
47,118,5,2,23,21
47,118,6,3,20,17
47,119,0,2,19,17
47,119,1,7,28,21
47,119,2,2,18,16
47,119,3,1,19,18
47,119,4,1,16,15
47,119,5,3,25,22
47,119,6,6,34,28
47,120,0,0,13,13
47,120,1,1,18,17
47,120,2,0,16,16
47,120,3,3,22,19
47,120,4,0,22,22
47,120,5,2,33,31
47,120,6,2,18,16
47,121,0,5,27,22
47,121,1,2,28,26
47,121,2,0,17,17
47,121,3,2,32,30
47,121,4,2,24,22
47,121,5,1,31,30
47,121,6,2,13,11
47,122,0,2,24,22
47,122,1,0,27,27
47,122,2,2,19,17
47,122,3,1,26,25
47,122,4,3,22,19
47,122,5,8,33,25
47,122,6,4,29,25
47,123,0,2,21,19
47,123,1,1,21,20
47,123,2,0,23,23
47,123,3,3,17,14
47,123,4,3,32,29
47,123,5,2,22,20
47,123,6,0,17,17
47,124,0,2,18,16
47,124,1,0,6,6
47,124,2,3,25,22
47,124,3,5,24,19
47,124,4,1,22,21
47,124,5,3,27,24
47,124,6,1,18,17
47,125,0,1,22,21
47,125,1,1,19,18
47,125,2,1,7,6
47,125,3,0,19,19
47,125,4,0,21,21
47,125,5,6,22,16
47,125,6,2,22,20
47,126,0,4,22,18
47,126,1,0,16,16
47,126,2,4,18,14
47,126,3,5,18,13
47,126,4,1,15,14
47,126,5,5,25,20
47,126,6,1,28,27
47,127,0,1,10,9
47,127,1,4,22,18
47,127,2,2,22,20
47,127,3,4,17,13
47,127,4,0,17,17
47,127,5,3,21,18
47,127,6,2,17,15
47,128,0,3,16,13
47,128,1,3,20,17
47,128,2,2,14,12
47,128,3,2,15,13
47,128,4,0,15,15
47,128,5,1,14,13
47,128,6,1,20,19
47,129,0,4,19,15
47,129,1,4,25,21
47,129,2,4,17,13
47,129,3,3,15,12
47,129,4,1,14,13
47,129,5,2,31,29
47,129,6,1,20,19
47,130,0,0,16,16
47,130,1,5,22,17
47,130,2,7,21,14
47,130,3,1,17,16
47,130,4,2,25,23
47,130,5,4,21,17
47,130,6,3,17,14
47,131,0,4,17,13
47,131,1,2,12,10
47,131,2,0,23,23
47,131,3,0,12,12
47,131,4,0,14,14
47,131,5,4,23,19
47,131,6,1,13,12
47,132,0,2,9,7
47,132,1,2,10,8
47,132,2,2,20,18
47,132,3,2,14,12
47,132,4,0,19,19
47,132,5,3,20,17
47,132,6,2,19,17
47,133,0,2,17,15
47,133,1,2,17,15
47,133,2,0,9,9
47,133,3,2,19,17
47,133,4,1,14,13
47,133,5,5,28,23
47,133,6,2,10,8
47,134,0,0,8,8
47,134,1,0,5,5
47,134,2,1,9,8
47,134,3,1,12,11
47,134,4,2,12,10
47,134,5,6,24,18
47,134,6,2,24,22
47,135,0,2,7,5
47,135,1,6,17,11
47,135,2,4,12,8
47,135,3,1,13,12
47,135,4,1,13,12
47,135,5,2,14,12
47,135,6,2,11,9
47,136,0,2,8,6
47,136,1,0,7,7
47,136,2,2,15,13
47,136,3,1,15,14
47,136,4,1,15,14
47,136,5,2,14,12
47,136,6,2,11,9
47,137,0,0,8,8
47,137,1,4,17,13
47,137,2,2,13,11
47,137,3,3,12,9
47,137,4,0,16,16
47,137,5,2,18,16
47,137,6,1,11,10
47,138,0,3,13,10
47,138,1,7,17,10
47,138,2,3,8,5
47,138,3,1,13,12
47,138,4,0,12,12
47,138,5,1,7,6
47,138,6,1,7,6
47,139,0,3,15,12
47,139,1,8,21,13
47,139,2,3,17,14
47,139,3,0,12,12
47,139,4,0,10,10
47,139,5,0,16,16
47,139,6,3,12,9
47,140,0,3,11,8
47,140,1,3,12,9
47,140,2,7,16,9
47,140,3,3,13,10
47,140,4,0,9,9
47,140,5,3,13,10
47,140,6,3,11,8
47,141,0,3,11,8
47,141,1,4,15,11
47,141,2,2,12,10
47,141,3,1,8,7
47,141,4,5,18,13
47,141,5,4,13,9
47,141,6,5,15,10
47,142,0,0,7,7
47,142,1,5,8,3
47,142,2,3,10,7
47,142,3,4,12,8
47,142,4,2,10,8
47,142,5,9,21,12
47,142,6,1,8,7
47,143,0,3,6,3
47,143,1,8,12,4
47,143,2,0,5,5
47,143,3,1,9,8
47,143,4,6,22,16
47,143,5,5,15,10
47,143,6,4,12,8
48,0,0,62,236,174
48,0,1,89,258,169
48,0,2,28,191,163
48,0,3,27,206,179
48,0,4,21,314,293
48,0,5,14,236,222
48,0,6,33,248,215
48,1,0,49,216,167
48,1,1,57,189,132
48,1,2,34,188,154
48,1,3,33,207,174
48,1,4,28,321,293
48,1,5,39,249,210
48,1,6,47,260,213
48,2,0,61,189,128
48,2,1,50,183,133
48,2,2,31,177,146
48,2,3,31,219,188
48,2,4,46,317,271
48,2,5,54,265,211
48,2,6,108,297,189
48,3,0,43,162,119
48,3,1,45,166,121
48,3,2,56,190,134
48,3,3,30,166,136
48,3,4,83,389,306
48,3,5,26,199,173
48,3,6,87,273,186
48,4,0,20,126,106
48,4,1,27,154,127
48,4,2,50,177,127
48,4,3,26,179,153
48,4,4,47,318,271
48,4,5,32,217,185
48,4,6,47,199,152
48,5,0,36,156,120
48,5,1,40,151,111
48,5,2,53,192,139
48,5,3,51,177,126
48,5,4,29,248,219
48,5,5,15,161,146
48,5,6,44,194,150
48,6,0,25,136,111
48,6,1,30,147,117
48,6,2,33,151,118
48,6,3,41,154,113
48,6,4,41,267,226
48,6,5,28,168,140
48,6,6,39,198,159
48,7,0,27,122,95
48,7,1,36,134,98
48,7,2,20,150,130
48,7,3,29,133,104
48,7,4,22,220,198
48,7,5,31,185,154
48,7,6,24,139,115
48,8,0,10,109,99
48,8,1,32,125,93
48,8,2,15,128,113
48,8,3,51,161,110
48,8,4,35,241,206
48,8,5,25,155,130
48,8,6,35,152,117
48,9,0,23,103,80
48,9,1,21,120,99
48,9,2,23,117,94
48,9,3,27,120,93
48,9,4,28,200,172
48,9,5,19,143,124
48,9,6,33,157,124
48,10,0,31,108,77
48,10,1,33,125,92
48,10,2,15,100,85
48,10,3,29,109,80
48,10,4,28,212,184
48,10,5,23,142,119
48,10,6,31,149,118
48,11,0,23,87,64
48,11,1,15,97,82
48,11,2,11,92,81
48,11,3,27,109,82
48,11,4,21,188,167
48,11,5,32,139,107
48,11,6,28,132,104
48,12,0,21,78,57
48,12,1,26,99,73
48,12,2,24,94,70
48,12,3,30,108,78
48,12,4,24,158,134
48,12,5,31,118,87
48,12,6,29,122,93
48,13,0,28,88,60
48,13,1,15,92,77
48,13,2,26,91,65
48,13,3,30,101,71
48,13,4,31,159,128
48,13,5,65,160,95
48,13,6,21,112,91
48,14,0,24,73,49
48,14,1,18,71,53
48,14,2,11,71,60
48,14,3,23,84,61
48,14,4,30,138,108
48,14,5,67,152,85
48,14,6,29,128,99
48,15,0,11,63,52
48,15,1,17,78,61
48,15,2,17,85,68
48,15,3,20,86,66
48,15,4,35,124,89
48,15,5,48,131,83
48,15,6,19,110,91
48,16,0,32,79,47
48,16,1,16,85,69
48,16,2,27,84,57
48,16,3,12,57,45
48,16,4,31,118,87
48,16,5,31,105,74
48,16,6,19,75,56
48,17,0,29,73,44
48,17,1,28,86,58
48,17,2,15,68,53
48,17,3,11,77,66
48,17,4,29,112,83
48,17,5,15,84,69
48,17,6,26,83,57
48,18,0,24,66,42
48,18,1,9,57,48
48,18,2,11,64,53
48,18,3,14,66,52
48,18,4,46,116,70
48,18,5,13,76,63
48,18,6,14,65,51
48,19,0,14,47,33
48,19,1,18,61,43
48,19,2,12,55,43
48,19,3,9,45,36
48,19,4,35,111,76
48,19,5,15,69,54
48,19,6,12,57,45
48,20,0,4,37,33
48,20,1,9,46,37
48,20,2,2,41,39
48,20,3,14,52,38
48,20,4,26,82,56
48,20,5,4,36,32
48,20,6,19,69,50
48,21,0,4,42,38
48,21,1,13,55,42
48,21,2,15,57,42
48,21,3,14,56,42
48,21,4,23,73,50
48,21,5,25,63,38
48,21,6,22,68,46
48,22,0,11,53,42
48,22,1,7,32,25
48,22,2,15,62,47
48,22,3,4,33,29
48,22,4,20,63,43
48,22,5,15,50,35
48,22,6,12,44,32
48,23,0,10,42,32
48,23,1,6,37,31
48,23,2,11,57,46
48,23,3,13,50,37
48,23,4,16,59,43
48,23,5,11,49,38
48,23,6,15,59,44
48,24,0,13,47,34
48,24,1,22,59,37
48,24,2,27,77,50
48,24,3,7,49,42
48,24,4,18,54,36
48,24,5,4,35,31
48,24,6,9,66,57
48,25,0,18,48,30
48,25,1,24,66,42
48,25,2,11,43,32
48,25,3,16,48,32
48,25,4,13,55,42
48,25,5,6,49,43
48,25,6,21,61,40
48,26,0,5,42,37
48,26,1,19,52,33
48,26,2,10,46,36
48,26,3,11,48,37
48,26,4,12,59,47
48,26,5,5,46,41
48,26,6,15,56,41
48,27,0,11,54,43
48,27,1,12,54,42
48,27,2,17,63,46
48,27,3,15,54,39
48,27,4,14,43,29
48,27,5,5,46,41
48,27,6,14,59,45
48,28,0,5,48,43
48,28,1,14,61,47
48,28,2,9,58,49
48,28,3,10,60,50
48,28,4,27,65,38
48,28,5,21,77,56
48,28,6,11,56,45
48,29,0,5,47,42
48,29,1,7,44,37
48,29,2,2,41,39
48,29,3,11,45,34
48,29,4,34,79,45
48,29,5,11,57,46
48,29,6,11,62,51
48,30,0,9,52,43
48,30,1,7,48,41
48,30,2,2,51,49
48,30,3,4,45,41
48,30,4,27,63,36
48,30,5,3,44,41
48,30,6,9,47,38
48,31,0,19,62,43
48,31,1,10,61,51
48,31,2,6,53,47
48,31,3,6,40,34
48,31,4,66,114,48
48,31,5,4,42,38
48,31,6,23,75,52
48,32,0,9,52,43
48,32,1,9,60,51
48,32,2,13,48,35
48,32,3,15,59,44
48,32,4,61,120,59
48,32,5,6,60,54
48,32,6,15,57,42
48,33,0,26,61,35
48,33,1,12,54,42
48,33,2,8,49,41
48,33,3,16,67,51
48,33,4,47,89,42
48,33,5,9,31,22
48,33,6,15,46,31
48,34,0,27,76,49
48,34,1,9,70,61
48,34,2,10,72,62
48,34,3,7,56,49
48,34,4,70,120,50
48,34,5,8,51,43
48,34,6,8,44,36
48,35,0,27,72,45
48,35,1,25,83,58
48,35,2,9,62,53
48,35,3,23,77,54
48,35,4,49,100,51
48,35,5,27,73,46
48,35,6,13,63,50
48,36,0,45,98,53
48,36,1,26,96,70
48,36,2,38,106,68
48,36,3,35,83,48
48,36,4,57,114,57
48,36,5,19,77,58
48,36,6,15,78,63
48,37,0,42,89,47
48,37,1,25,83,58
48,37,2,42,106,64
48,37,3,29,98,69
48,37,4,68,132,64
48,37,5,17,72,55
48,37,6,21,80,59
48,38,0,45,102,57
48,38,1,42,119,77
48,38,2,43,107,64
48,38,3,41,103,62
48,38,4,70,140,70
48,38,5,33,112,79
48,38,6,15,84,69
48,39,0,5,142,137
48,39,1,5,158,153
48,39,2,2,138,136
48,39,3,5,141,136
48,39,4,44,165,121
48,39,5,14,110,96
48,39,6,13,97,84
48,40,0,16,239,223
48,40,1,4,172,168
48,40,2,3,192,189
48,40,3,4,172,168
48,40,4,42,196,154
48,40,5,4,109,105
48,40,6,12,117,105
48,41,0,18,309,291
48,41,1,6,245,239
48,41,2,6,272,266
48,41,3,7,235,228
48,41,4,53,253,200
48,41,5,7,138,131
48,41,6,8,135,127
48,42,0,45,435,390
48,42,1,15,394,379
48,42,2,12,406,394
48,42,3,20,404,384
48,42,4,48,365,317
48,42,5,5,179,174
48,42,6,14,147,133
48,43,0,65,595,530
48,43,1,9,517,508
48,43,2,13,491,478
48,43,3,11,459,448
48,43,4,33,371,338
48,43,5,7,219,212
48,43,6,10,214,204
48,44,0,270,868,598
48,44,1,32,660,628
48,44,2,11,610,599
48,44,3,18,602,584
48,44,4,91,539,448
48,44,5,11,280,269
48,44,6,29,255,226
48,45,0,415,1022,607
48,45,1,68,744,676
48,45,2,80,743,663
48,45,3,95,707,612
48,45,4,63,590,527
48,45,5,10,346,336
48,45,6,21,271,250
48,46,0,546,1131,585
48,46,1,146,821,675
48,46,2,250,926,676
48,46,3,149,812,663
48,46,4,49,597,548
48,46,5,9,332,323
48,46,6,24,313,289
48,47,0,728,1312,584
48,47,1,317,986,669
48,47,2,439,1124,685
48,47,3,165,900,735
48,47,4,180,777,597
48,47,5,9,355,346
48,47,6,13,334,321
48,48,0,1035,1615,580
48,48,1,637,1343,706
48,48,2,673,1333,660
48,48,3,220,946,726
48,48,4,386,932,546
48,48,5,12,398,386
48,48,6,12,321,309
48,49,0,880,1481,601
48,49,1,762,1425,663
48,49,2,740,1467,727
48,49,3,208,1025,817
48,49,4,314,896,582
48,49,5,16,422,406
48,49,6,14,375,361
48,50,0,726,1469,743
48,50,1,478,1309,831
48,50,2,414,1265,851
48,50,3,85,946,861
48,50,4,124,857,733
48,50,5,15,448,433
48,50,6,21,415,394
48,51,0,798,1519,721
48,51,1,334,1217,883
48,51,2,313,1244,931
48,51,3,81,1043,962
48,51,4,143,891,748
48,51,5,9,459,450
48,51,6,11,396,385
48,52,0,552,1386,834
48,52,1,282,1122,840
48,52,2,169,1068,899
48,52,3,44,894,850
48,52,4,50,697,647
48,52,5,10,461,451
48,52,6,13,402,389
48,53,0,101,824,723
48,53,1,58,798,740
48,53,2,26,697,671
48,53,3,24,650,626
48,53,4,21,542,521
48,53,5,13,411,398
48,53,6,10,352,342
48,54,0,20,668,648
48,54,1,18,673,655
48,54,2,11,663,652
48,54,3,15,673,658
48,54,4,18,546,528
48,54,5,14,446,432
48,54,6,6,388,382
48,55,0,12,599,587
48,55,1,9,575,566
48,55,2,15,665,650
48,55,3,16,638,622
48,55,4,12,528,516
48,55,5,8,472,464
48,55,6,9,420,411
48,56,0,10,563,553
48,56,1,15,620,605
48,56,2,16,587,571
48,56,3,19,635,616
48,56,4,11,549,538
48,56,5,18,478,460
48,56,6,18,469,451
48,57,0,13,517,504
48,57,1,16,557,541
48,57,2,14,616,602
48,57,3,13,577,564
48,57,4,13,543,530
48,57,5,5,493,488
48,57,6,7,431,424
48,58,0,6,466,460
48,58,1,16,553,537
48,58,2,15,542,527
48,58,3,9,551,542
48,58,4,18,508,490
48,58,5,12,479,467
48,58,6,6,461,455
48,59,0,11,454,443
48,59,1,15,559,544
48,59,2,22,577,555
48,59,3,6,518,512
48,59,4,16,461,445
48,59,5,14,470,456
48,59,6,13,442,429
48,60,0,11,470,459
48,60,1,10,502,492
48,60,2,20,517,497
48,60,3,14,536,522
48,60,4,28,485,457
48,60,5,9,495,486
48,60,6,13,474,461
48,61,0,11,474,463
48,61,1,6,473,467
48,61,2,18,472,454
48,61,3,11,500,489
48,61,4,50,533,483
48,61,5,13,471,458
48,61,6,11,424,413
48,62,0,13,453,440
48,62,1,21,497,476
48,62,2,8,492,484
48,62,3,20,497,477
48,62,4,26,507,481
48,62,5,13,484,471
48,62,6,22,519,497
48,63,0,11,488,477
48,63,1,11,495,484
48,63,2,13,543,530
48,63,3,13,469,456
48,63,4,30,492,462
48,63,5,10,511,501
48,63,6,7,488,481
48,64,0,14,503,489
48,64,1,15,476,461
48,64,2,20,515,495
48,64,3,11,489,478
48,64,4,49,509,460
48,64,5,13,481,468
48,64,6,10,448,438
48,65,0,17,477,460
48,65,1,14,508,494
48,65,2,11,426,415
48,65,3,23,504,481
48,65,4,34,511,477
48,65,5,10,470,460
48,65,6,15,471,456
48,66,0,16,465,449
48,66,1,7,513,506
48,66,2,12,510,498
48,66,3,14,491,477
48,66,4,37,573,536
48,66,5,13,493,480
48,66,6,15,506,491
48,67,0,12,472,460
48,67,1,15,485,470
48,67,2,49,540,491
48,67,3,16,484,468
48,67,4,104,565,461
48,67,5,15,490,475
48,67,6,20,509,489
48,68,0,8,513,505
48,68,1,9,495,486
48,68,2,37,566,529
48,68,3,12,537,525
48,68,4,106,622,516
48,68,5,17,518,501
48,68,6,17,542,525
48,69,0,14,584,570
48,69,1,19,551,532
48,69,2,59,613,554
48,69,3,17,545,528
48,69,4,100,566,466
48,69,5,15,489,474
48,69,6,18,545,527
48,70,0,18,563,545
48,70,1,14,527,513
48,70,2,70,644,574
48,70,3,14,585,571
48,70,4,93,582,489
48,70,5,15,531,516
48,70,6,12,595,583
48,71,0,11,503,492
48,71,1,13,563,550
48,71,2,83,605,522
48,71,3,14,532,518
48,71,4,67,574,507
48,71,5,23,502,479
48,71,6,23,596,573
48,72,0,22,601,579
48,72,1,21,567,546
48,72,2,30,604,574
48,72,3,18,595,577
48,72,4,82,614,532
48,72,5,15,536,521
48,72,6,13,568,555
48,73,0,16,578,562
48,73,1,11,561,550
48,73,2,21,596,575
48,73,3,5,556,551
48,73,4,53,514,461
48,73,5,19,601,582
48,73,6,24,643,619
48,74,0,13,575,562
48,74,1,10,555,545
48,74,2,19,609,590
48,74,3,19,588,569
48,74,4,70,554,484
48,74,5,18,570,552
48,74,6,15,603,588
48,75,0,15,559,544
48,75,1,21,618,597
48,75,2,23,553,530
48,75,3,24,593,569
48,75,4,98,575,477
48,75,5,14,646,632
48,75,6,12,651,639
48,76,0,19,537,518
48,76,1,18,548,530
48,76,2,18,613,595
48,76,3,10,570,560
48,76,4,94,589,495
48,76,5,20,643,623
48,76,6,17,654,637
48,77,0,22,579,557
48,77,1,32,621,589
48,77,2,24,648,624
48,77,3,26,650,624
48,77,4,83,644,561
48,77,5,30,682,652
48,77,6,19,707,688
48,78,0,32,676,644
48,78,1,63,696,633
48,78,2,31,696,665
48,78,3,15,652,637
48,78,4,102,654,552
48,78,5,25,637,612
48,78,6,12,722,710
48,79,0,49,642,593
48,79,1,138,795,657
48,79,2,25,709,684
48,79,3,14,626,612
48,79,4,105,660,555
48,79,5,53,690,637
48,79,6,19,656,637
48,80,0,80,739,659
48,80,1,126,781,655
48,80,2,48,702,654
48,80,3,21,730,709
48,80,4,135,755,620
48,80,5,119,847,728
48,80,6,25,721,696
48,81,0,64,719,655
48,81,1,151,854,703
48,81,2,108,853,745
48,81,3,40,712,672
48,81,4,137,715,578
48,81,5,80,810,730
48,81,6,30,750,720
48,82,0,57,726,669
48,82,1,138,801,663
48,82,2,60,779,719
48,82,3,30,692,662
48,82,4,134,745,611
48,82,5,48,753,705
48,82,6,24,697,673
48,83,0,119,795,676
48,83,1,152,759,607
48,83,2,125,874,749
48,83,3,35,720,685
48,83,4,159,748,589
48,83,5,97,765,668
48,83,6,17,759,742
48,84,0,106,823,717
48,84,1,150,808,658
48,84,2,132,886,754
48,84,3,28,769,741
48,84,4,141,762,621
48,84,5,71,748,677
48,84,6,37,773,736
48,85,0,117,781,664
48,85,1,160,802,642
48,85,2,150,811,661
48,85,3,29,667,638
48,85,4,177,810,633
48,85,5,72,775,703
48,85,6,31,720,689
48,86,0,128,763,635
48,86,1,186,831,645
48,86,2,209,866,657
48,86,3,27,714,687
48,86,4,173,799,626
48,86,5,71,780,709
48,86,6,44,778,734
48,87,0,112,823,711
48,87,1,163,835,672
48,87,2,115,879,764
48,87,3,90,772,682
48,87,4,223,870,647
48,87,5,86,779,693
48,87,6,33,829,796
48,88,0,105,783,678
48,88,1,171,850,679
48,88,2,204,949,745
48,88,3,56,753,697
48,88,4,190,842,652
48,88,5,93,774,681
48,88,6,45,836,791
48,89,0,145,792,647
48,89,1,183,859,676
48,89,2,216,965,749
48,89,3,90,754,664
48,89,4,172,769,597
48,89,5,73,779,706
48,89,6,95,935,840
48,90,0,212,888,676
48,90,1,213,863,650
48,90,2,137,878,741
48,90,3,91,830,739
48,90,4,203,897,694
48,90,5,73,789,716
48,90,6,162,890,728
48,91,0,428,1087,659
48,91,1,302,924,622
48,91,2,261,1003,742
48,91,3,116,822,706
48,91,4,262,864,602
48,91,5,106,864,758
48,91,6,223,990,767
48,92,0,535,1180,645
48,92,1,364,994,630
48,92,2,370,1053,683
48,92,3,154,857,703
48,92,4,312,899,587
48,92,5,107,799,692
48,92,6,336,1140,804
48,93,0,218,1076,858
48,93,1,236,947,711
48,93,2,203,995,792
48,93,3,74,872,798
48,93,4,28,892,864
48,93,5,135,918,783
48,93,6,308,1119,811
48,94,0,206,948,742
48,94,1,234,872,638
48,94,2,198,953,755
48,94,3,139,877,738
48,94,4,29,767,738
48,94,5,221,956,735
48,94,6,512,1228,716
48,95,0,256,979,723
48,95,1,295,1015,720
48,95,2,253,966,713
48,95,3,176,941,765
48,95,4,38,753,715
48,95,5,242,947,705
48,95,6,555,1357,802
48,96,0,113,946,833
48,96,1,218,1114,896
48,96,2,225,1027,802
48,96,3,47,993,946
48,96,4,122,816,694
48,96,5,48,980,932
48,96,6,53,1130,1077
48,97,0,212,1002,790
48,97,1,253,1117,864
48,97,2,403,1255,852
48,97,3,39,964,925
48,97,4,176,975,799
48,97,5,35,931,896
48,97,6,79,1057,978
48,98,0,280,1051,771
48,98,1,343,1158,815
48,98,2,287,1138,851
48,98,3,58,1020,962
48,98,4,228,1089,861
48,98,5,60,1018,958
48,98,6,210,1181,971
48,99,0,295,1186,891
48,99,1,243,1052,809
48,99,2,304,1166,862
48,99,3,52,1036,984
48,99,4,237,1060,823
48,99,5,88,999,911
48,99,6,269,1231,962
48,100,0,217,1044,827
48,100,1,218,1008,790
48,100,2,378,1215,837
48,100,3,64,942,878
48,100,4,176,950,774
48,100,5,118,1094,976
48,100,6,277,1213,936
48,101,0,280,1176,896
48,101,1,247,1202,955
48,101,2,424,1351,927
48,101,3,132,1205,1073
48,101,4,253,1079,826
48,101,5,167,1114,947
48,101,6,252,1223,971
48,102,0,466,1542,1076
48,102,1,419,1510,1091
48,102,2,527,1558,1031
48,102,3,347,1536,1189
48,102,4,364,1338,974
48,102,5,238,1162,924
48,102,6,196,1224,1028
48,103,0,488,1362,874
48,103,1,409,1365,956
48,103,2,509,1382,873
48,103,3,460,1458,998
48,103,4,458,1380,922
48,103,5,347,1240,893
48,103,6,186,1193,1007
48,104,0,619,1495,876
48,104,1,531,1422,891
48,104,2,547,1427,880
48,104,3,358,1454,1096
48,104,4,453,1304,851
48,104,5,331,1223,892
48,104,6,165,1044,879
48,105,0,943,1926,983
48,105,1,812,1842,1030
48,105,2,774,1740,966
48,105,3,624,1799,1175
48,105,4,541,1468,927
48,105,5,349,1279,930
48,105,6,122,1051,929
48,106,0,647,1550,903
48,106,1,725,1725,1000
48,106,2,734,1589,855
48,106,3,384,1334,950
48,106,4,516,1401,885
48,106,5,236,1038,802
48,106,6,63,942,879
48,107,0,526,1380,854
48,107,1,552,1455,903
48,107,2,660,1477,817
48,107,3,320,1233,913
48,107,4,432,1256,824
48,107,5,98,855,757
48,107,6,28,752,724
48,108,0,492,1392,900
48,108,1,447,1405,958
48,108,2,625,1480,855
48,108,3,313,1296,983
48,108,4,442,1250,808
48,108,5,36,799,763
48,108,6,29,733,704
48,109,0,293,1168,875
48,109,1,267,1079,812
48,109,2,514,1307,793
48,109,3,188,1033,845
48,109,4,329,1099,770
48,109,5,24,669,645
48,109,6,22,701,679
48,110,0,109,867,758
48,110,1,176,957,781
48,110,2,261,1012,751
48,110,3,80,824,744
48,110,4,178,900,722
48,110,5,18,638,620
48,110,6,13,606,593
48,111,0,23,742,719
48,111,1,71,819,748
48,111,2,160,943,783
48,111,3,22,731,709
48,111,4,48,761,713
48,111,5,12,617,605
48,111,6,12,644,632
48,112,0,18,627,609
48,112,1,32,742,710
48,112,2,140,852,712
48,112,3,25,706,681
48,112,4,39,721,682
48,112,5,21,675,654
48,112,6,18,591,573
48,113,0,15,649,634
48,113,1,17,712,695
48,113,2,95,803,708
48,113,3,30,711,681
48,113,4,36,685,649
48,113,5,17,657,640
48,113,6,16,640,624
48,114,0,27,645,618
48,114,1,37,708,671
48,114,2,89,774,685
48,114,3,25,677,652
48,114,4,30,694,664
48,114,5,20,604,584
48,114,6,14,624,610
48,115,0,13,591,578
48,115,1,39,662,623
48,115,2,57,636,579
48,115,3,28,607,579
48,115,4,36,654,618
48,115,5,17,587,570
48,115,6,30,589,559
48,116,0,27,558,531
48,116,1,67,673,606
48,116,2,52,638,586
48,116,3,26,632,606
48,116,4,21,574,553
48,116,5,14,543,529
48,116,6,49,596,547
48,117,0,34,607,573
48,117,1,121,709,588
48,117,2,120,761,641
48,117,3,18,608,590
48,117,4,39,622,583
48,117,5,37,617,580
48,117,6,37,552,515
48,118,0,34,586,552
48,118,1,77,611,534
48,118,2,115,714,599
48,118,3,29,605,576
48,118,4,53,608,555
48,118,5,51,602,551
48,118,6,86,638,552
48,119,0,78,670,592
48,119,1,122,712,590
48,119,2,66,701,635
48,119,3,16,595,579
48,119,4,71,687,616
48,119,5,129,681,552
48,119,6,117,659,542
48,120,0,20,622,602
48,120,1,36,681,645
48,120,2,75,779,704
48,120,3,20,631,611
48,120,4,15,684,669
48,120,5,23,627,604
48,120,6,47,672,625
48,121,0,33,648,615
48,121,1,52,685,633
48,121,2,66,701,635
48,121,3,26,611,585
48,121,4,35,658,623
48,121,5,49,685,636
48,121,6,40,628,588
48,122,0,27,609,582
48,122,1,59,664,605
48,122,2,61,693,632
48,122,3,39,646,607
48,122,4,35,651,616
48,122,5,72,666,594
48,122,6,81,625,544
48,123,0,63,641,578
48,123,1,55,664,609
48,123,2,76,743,667
48,123,3,101,697,596
48,123,4,73,721,648
48,123,5,45,665,620
48,123,6,104,696,592
48,124,0,98,674,576
48,124,1,89,656,567
48,124,2,90,730,640
48,124,3,49,635,586
48,124,4,165,841,676
48,124,5,90,726,636
48,124,6,68,587,519
48,125,0,72,657,585
48,125,1,135,720,585
48,125,2,139,765,626
48,125,3,111,695,584
48,125,4,114,755,641
48,125,5,70,662,592
48,125,6,72,649,577
48,126,0,46,612,566
48,126,1,121,699,578
48,126,2,111,769,658
48,126,3,120,697,577
48,126,4,221,856,635
48,126,5,53,623,570
48,126,6,96,667,571
48,127,0,66,623,557
48,127,1,140,724,584
48,127,2,192,846,654
48,127,3,98,638,540
48,127,4,263,889,626
48,127,5,75,628,553
48,127,6,130,649,519
48,128,0,108,624,516
48,128,1,164,788,624
48,128,2,176,777,601
48,128,3,110,669,559
48,128,4,238,816,578
48,128,5,53,547,494
48,128,6,100,546,446
48,129,0,140,682,542
48,129,1,238,860,622
48,129,2,141,818,677
48,129,3,75,610,535
48,129,4,180,742,562
48,129,5,84,648,564
48,129,6,113,622,509
48,130,0,84,575,491
48,130,1,190,708,518
48,130,2,46,587,541
48,130,3,104,584,480
48,130,4,90,683,593
48,130,5,79,596,517
48,130,6,110,564,454
48,131,0,57,537,480
48,131,1,94,568,474
48,131,2,42,602,560
48,131,3,103,559,456
48,131,4,103,670,567
48,131,5,166,706,540
48,131,6,64,514,450
48,132,0,60,548,488
48,132,1,143,627,484
48,132,2,24,547,523
48,132,3,141,619,478
48,132,4,170,728,558
48,132,5,278,768,490
48,132,6,96,522,426
48,133,0,44,486,442
48,133,1,59,465,406
48,133,2,15,516,501
48,133,3,83,500,417
48,133,4,122,639,517
48,133,5,254,749,495
48,133,6,86,537,451
48,134,0,31,408,377
48,134,1,24,389,365
48,134,2,18,407,389
48,134,3,36,439,403
48,134,4,58,497,439
48,134,5,187,602,415
48,134,6,68,432,364
48,135,0,14,324,310
48,135,1,19,379,360
48,135,2,13,363,350
48,135,3,34,369,335
48,135,4,53,449,396
48,135,5,125,547,422
48,135,6,40,352,312
48,136,0,13,288,275
48,136,1,18,317,299
48,136,2,13,349,336
48,136,3,10,304,294
48,136,4,53,455,402
48,136,5,95,496,401
48,136,6,52,331,279
48,137,0,12,309,297
48,137,1,16,294,278
48,137,2,13,298,285
48,137,3,13,278,265
48,137,4,19,352,333
48,137,5,58,383,325
48,137,6,28,270,242
48,138,0,55,294,239
48,138,1,21,281,260
48,138,2,7,247,240
48,138,3,12,268,256
48,138,4,24,365,341
48,138,5,28,334,306
48,138,6,41,248,207
48,139,0,36,263,227
48,139,1,14,239,225
48,139,2,15,247,232
48,139,3,15,268,253
48,139,4,17,299,282
48,139,5,70,379,309
48,139,6,35,261,226
48,140,0,25,242,217
48,140,1,42,266,224
48,140,2,16,222,206
48,140,3,21,250,229
48,140,4,22,299,277
48,140,5,41,297,256
48,140,6,58,281,223
48,141,0,35,235,200
48,141,1,56,275,219
48,141,2,20,240,220
48,141,3,30,242,212
48,141,4,17,272,255
48,141,5,26,255,229
48,141,6,83,293,210
48,142,0,72,266,194
48,142,1,65,283,218
48,142,2,15,208,193
48,142,3,34,223,189
48,142,4,21,265,244
48,142,5,58,293,235
48,142,6,68,256,188
48,143,0,62,231,169
48,143,1,51,218,167
48,143,2,27,244,217
48,143,3,83,242,159
48,143,4,34,262,228
48,143,5,39,260,221
48,143,6,53,232,179
49,0,0,0,2,2
49,0,1,0,1,1
49,0,2,2,2,0
49,0,4,0,1,1
49,0,5,1,3,2
49,0,6,1,3,2
49,1,0,1,2,1
49,1,1,2,3,1
49,1,3,1,1,0
49,1,4,0,1,1
49,1,5,1,2,1
49,1,6,3,5,2
49,2,1,1,1,0
49,2,2,1,2,1
49,2,4,2,3,1
49,2,5,2,4,2
49,2,6,0,3,3
49,3,0,1,1,0
49,3,2,2,3,1
49,3,4,0,1,1
49,3,5,1,3,2
49,3,6,1,2,1
49,4,1,2,2,0
49,4,2,1,1,0
49,4,3,3,5,2
49,4,4,0,1,1
49,4,6,3,5,2
49,5,1,1,1,0
49,5,3,1,2,1
49,5,5,1,1,0
49,5,6,1,1,0
49,6,6,1,3,2
49,7,2,0,3,3
49,7,5,0,1,1
49,7,6,5,5,0
49,8,4,0,1,1
49,8,6,1,2,1
49,9,4,3,3,0
49,9,6,0,1,1
49,10,4,2,3,1
49,10,5,0,1,1
49,10,6,1,2,1
49,11,6,7,8,1
49,12,2,0,1,1
49,12,4,1,1,0
49,13,3,1,1,0
49,13,5,1,1,0
49,14,0,0,1,1
49,14,1,0,1,1
49,14,3,1,1,0
49,14,4,2,2,0
49,14,5,1,1,0
49,14,6,2,2,0
49,15,3,1,1,0
49,15,6,1,1,0
49,16,2,1,2,1
49,16,3,0,1,1
49,16,6,1,1,0
49,17,3,1,2,1
49,17,5,1,1,0
49,18,5,1,1,0
49,18,6,1,1,0
49,19,4,0,1,1
49,19,5,1,1,0
49,20,5,2,2,0
49,20,6,1,1,0
49,22,0,1,1,0
49,22,3,1,1,0
49,23,0,1,1,0
49,23,1,1,1,0
49,23,6,3,3,0
49,24,0,1,1,0
49,25,0,2,2,0
49,26,0,3,3,0
49,27,0,2,2,0
49,28,3,2,2,0
49,30,6,0,1,1
49,32,3,0,1,1
49,33,4,0,1,1
49,33,6,2,3,1
49,35,3,0,1,1
49,36,1,0,1,1
49,36,2,0,1,1
49,36,6,1,1,0
49,37,0,0,1,1
49,37,2,0,1,1
49,37,3,1,2,1
49,37,4,0,1,1
49,37,6,2,3,1
49,38,0,0,2,2
49,38,2,4,6,2
49,38,3,0,2,2
49,38,4,2,3,1
49,38,5,0,1,1
49,38,6,4,4,0
49,39,0,0,5,5
49,39,1,2,7,5
49,39,2,0,3,3
49,39,3,0,4,4
49,39,4,0,5,5
49,39,5,0,1,1
49,39,6,3,4,1
49,40,0,0,6,6
49,40,1,2,11,9
49,40,2,0,4,4
49,40,3,3,6,3
49,40,4,0,4,4
49,40,5,2,6,4
49,40,6,4,5,1
49,41,0,4,7,3
49,41,1,0,2,2
49,41,2,0,6,6
49,41,3,1,6,5
49,41,4,0,11,11
49,41,5,1,3,2
49,41,6,4,7,3
49,42,0,0,22,22
49,42,1,1,9,8
49,42,2,0,3,3
49,42,3,0,9,9
49,42,4,0,4,4
49,42,5,0,3,3
49,42,6,4,8,4
49,43,0,1,12,11
49,43,1,1,7,6
49,43,2,7,16,9
49,43,3,2,9,7
49,43,4,2,9,7
49,43,5,0,10,10
49,43,6,4,8,4
49,44,0,2,12,10
49,44,1,0,5,5
49,44,2,3,11,8
49,44,3,1,14,13
49,44,4,1,5,4
49,44,5,0,10,10
49,44,6,0,8,8
49,45,0,0,12,12
49,45,1,1,8,7
49,45,2,0,14,14
49,45,3,0,14,14
49,45,4,2,12,10
49,45,5,2,10,8
49,45,6,1,7,6
49,46,0,7,16,9
49,46,1,0,8,8
49,46,2,3,21,18
49,46,3,5,24,19
49,46,4,3,13,10
49,46,5,0,8,8
49,46,6,2,9,7
49,47,0,9,18,9
49,47,1,0,3,3
49,47,2,2,12,10
49,47,3,0,9,9
49,47,4,9,17,8
49,47,5,2,11,9
49,47,6,6,13,7
49,48,0,6,26,20
49,48,1,1,15,14
49,48,2,1,17,16
49,48,3,1,22,21
49,48,4,4,21,17
49,48,5,2,12,10
49,48,6,7,16,9
49,49,0,3,11,8
49,49,1,1,10,9
49,49,2,1,12,11
49,49,3,4,14,10
49,49,4,12,18,6
49,49,5,5,18,13
49,49,6,0,5,5
49,50,0,5,14,9
49,50,1,3,12,9
49,50,2,9,20,11
49,50,3,5,15,10
49,50,4,8,20,12
49,50,5,4,13,9
49,50,6,2,7,5
49,51,0,9,14,5
49,51,1,2,10,8
49,51,2,4,18,14
49,51,3,3,16,13
49,51,4,8,15,7
49,51,5,3,14,11
49,51,6,10,22,12
49,52,0,7,14,7
49,52,1,6,13,7
49,52,2,5,15,10
49,52,3,6,14,8
49,52,4,7,12,5
49,52,5,3,12,9
49,52,6,4,10,6
49,53,0,5,9,4
49,53,1,5,10,5
49,53,2,0,8,8
49,53,3,2,9,7
49,53,4,7,16,9
49,53,5,5,14,9
49,53,6,5,16,11
49,54,0,10,25,15
49,54,1,3,7,4
49,54,2,1,7,6
49,54,3,2,7,5
49,54,4,4,11,7
49,54,5,9,14,5
49,54,6,9,11,2
49,55,0,6,10,4
49,55,1,7,18,11
49,55,2,0,14,14
49,55,3,1,3,2
49,55,4,1,11,10
49,55,5,3,11,8
49,55,6,3,6,3
49,56,0,11,16,5
49,56,1,6,17,11
49,56,2,5,14,9
49,56,3,4,13,9
49,56,4,2,8,6
49,56,5,4,7,3
49,56,6,3,7,4
49,57,0,2,8,6
49,57,1,8,14,6
49,57,2,6,12,6
49,57,3,4,12,8
49,57,4,4,7,3
49,57,5,4,8,4
49,57,6,4,12,8
49,58,0,1,6,5
49,58,1,5,12,7
49,58,2,6,13,7
49,58,3,5,10,5
49,58,4,6,11,5
49,58,5,4,12,8
49,58,6,5,12,7
49,59,0,6,7,1
49,59,1,14,16,2
49,59,2,3,7,4
49,59,3,3,4,1
49,59,4,0,5,5
49,59,5,5,13,8
49,59,6,5,13,8
49,60,0,12,19,7
49,60,1,14,21,7
49,60,2,1,3,2
49,60,3,5,11,6
49,60,4,2,7,5
49,60,5,11,17,6
49,60,6,9,17,8
49,61,0,5,11,6
49,61,1,8,13,5
49,61,2,1,5,4
49,61,3,1,10,9
49,61,4,5,8,3
49,61,5,4,12,8
49,61,6,5,12,7
49,62,0,4,6,2
49,62,1,4,10,6
49,62,2,6,10,4
49,62,3,1,2,1
49,62,4,8,15,7
49,62,5,10,14,4
49,62,6,1,8,7
49,63,0,0,7,7
49,63,1,7,11,4
49,63,2,5,16,11
49,63,3,5,5,0
49,63,4,3,7,4
49,63,5,2,12,10
49,63,6,3,8,5
49,64,0,2,9,7
49,64,1,13,19,6
49,64,2,1,8,7
49,64,3,7,11,4
49,64,4,5,7,2
49,64,5,5,14,9
49,64,6,2,7,5
49,65,0,6,8,2
49,65,1,0,5,5
49,65,2,4,8,4
49,65,3,3,4,1
49,65,4,10,16,6
49,65,5,6,17,11
49,65,6,6,11,5
49,66,0,1,4,3
49,66,1,0,4,4
49,66,2,2,4,2
49,66,3,2,4,2
49,66,4,18,21,3
49,66,5,13,24,11
49,66,6,5,12,7
49,67,0,0,4,4
49,67,1,4,13,9
49,67,2,0,3,3
49,67,3,2,7,5
49,67,4,11,13,2
49,67,5,1,6,5
49,67,6,3,13,10
49,68,0,2,7,5
49,68,1,2,8,6
49,68,2,4,11,7
49,68,3,5,8,3
49,68,4,5,13,8
49,68,5,0,7,7
49,68,6,11,18,7
49,69,0,1,6,5
49,69,1,12,20,8
49,69,2,3,7,4
49,69,3,4,10,6
49,69,4,7,10,3
49,69,5,0,8,8
49,69,6,2,10,8
49,70,0,4,9,5
49,70,1,3,8,5
49,70,2,5,11,6
49,70,3,3,9,6
49,70,4,7,14,7
49,70,5,4,13,9
49,70,6,4,11,7
49,71,0,5,15,10
49,71,1,3,9,6
49,71,2,2,4,2
49,71,3,8,16,8
49,71,4,5,16,11
49,71,5,2,11,9
49,71,6,2,9,7
49,72,0,8,15,7
49,72,1,5,12,7
49,72,2,3,7,4
49,72,3,5,17,12
49,72,4,10,18,8
49,72,5,3,11,8
49,72,6,3,11,8
49,73,0,2,7,5
49,73,1,5,10,5
49,73,2,5,9,4
49,73,3,13,21,8
49,73,4,12,21,9
49,73,5,4,15,11
49,73,6,6,21,15
49,74,0,7,14,7
49,74,1,7,10,3
49,74,2,9,17,8
49,74,3,3,8,5
49,74,4,3,12,9
49,74,5,2,12,10
49,74,6,6,14,8
49,75,0,6,17,11
49,75,1,3,9,6
49,75,2,3,8,5
49,75,3,2,10,8
49,75,4,2,9,7
49,75,5,12,24,12
49,75,6,2,18,16
49,76,0,10,16,6
49,76,1,2,6,4
49,76,2,27,34,7
49,76,3,2,6,4
49,76,4,1,5,4
49,76,5,11,23,12
49,76,6,3,10,7
49,77,0,4,10,6
49,77,1,5,13,8
49,77,2,15,17,2
49,77,3,7,13,6
49,77,4,5,11,6
49,77,5,14,20,6
49,77,6,3,17,14
49,78,0,8,17,9
49,78,1,5,12,7
49,78,2,3,14,11
49,78,3,3,8,5
49,78,4,2,6,4
49,78,5,4,14,10
49,78,6,0,11,11
49,79,0,4,8,4
49,79,1,0,5,5
49,79,2,3,8,5
49,79,3,4,9,5
49,79,4,1,6,5
49,79,5,6,13,7
49,79,6,1,11,10
49,80,0,3,11,8
49,80,1,4,9,5
49,80,2,2,8,6
49,80,3,1,12,11
49,80,4,1,10,9
49,80,5,6,15,9
49,80,6,5,13,8
49,81,0,5,5,0
49,81,1,0,9,9
49,81,2,0,1,1
49,81,3,4,7,3
49,81,4,6,11,5
49,81,5,2,11,9
49,81,6,2,13,11
49,82,0,1,2,1
49,82,1,6,16,10
49,82,2,3,7,4
49,82,3,9,21,12
49,82,4,8,14,6
49,82,5,1,7,6
49,82,6,2,11,9
49,83,0,0,3,3
49,83,1,0,8,8
49,83,2,0,5,5
49,83,3,2,7,5
49,83,4,3,7,4
49,83,5,4,12,8
49,83,6,4,14,10
49,84,0,0,8,8
49,84,1,1,6,5
49,84,2,3,11,8
49,84,3,1,5,4
49,84,4,1,4,3
49,84,5,6,11,5
49,84,6,7,13,6
49,85,0,0,7,7
49,85,1,3,9,6
49,85,2,2,7,5
49,85,3,5,8,3
49,85,4,3,9,6
49,85,5,4,13,9
49,85,6,8,10,2
49,86,0,2,7,5
49,86,1,0,6,6
49,86,2,4,9,5
49,86,3,1,6,5
49,86,4,4,12,8
49,86,5,0,4,4
49,86,6,2,6,4
49,87,0,1,5,4
49,87,1,4,11,7
49,87,2,3,13,10
49,87,3,3,11,8
49,87,4,4,9,5
49,87,5,2,7,5
49,87,6,1,5,4
49,88,0,2,8,6
49,88,1,0,4,4
49,88,2,3,6,3
49,88,3,1,10,9
49,88,4,3,8,5
49,88,5,10,14,4
49,88,6,8,14,6
49,89,0,2,5,3
49,89,1,0,7,7
49,89,2,1,6,5
49,89,3,2,4,2
49,89,4,1,11,10
49,89,5,3,11,8
49,89,6,7,13,6
49,90,0,1,2,1
49,90,1,3,6,3
49,90,2,0,2,2
49,90,3,9,14,5
49,90,4,1,8,7
49,90,5,2,5,3
49,90,6,0,4,4
49,91,0,2,6,4
49,91,1,2,4,2
49,91,2,5,7,2
49,91,3,0,8,8
49,91,4,0,7,7
49,91,5,1,9,8
49,91,6,1,9,8
49,92,0,2,6,4
49,92,1,3,7,4
49,92,2,5,9,4
49,92,3,1,2,1
49,92,4,0,10,10
49,92,5,1,6,5
49,92,6,3,9,6
49,93,0,0,9,9
49,93,1,0,11,11
49,93,2,2,9,7
49,93,3,0,5,5
49,93,4,1,16,15
49,93,5,2,6,4
49,93,6,3,9,6
49,94,0,0,4,4
49,94,1,1,6,5
49,94,2,3,7,4
49,94,3,0,5,5
49,94,4,0,7,7
49,94,5,3,12,9
49,94,6,1,7,6
49,95,0,0,6,6
49,95,1,0,12,12
49,95,2,1,6,5
49,95,3,0,7,7
49,95,4,0,5,5
49,95,5,1,6,5
49,95,6,1,9,8
49,96,0,0,11,11
49,96,1,7,14,7
49,96,2,1,9,8
49,96,3,0,15,15
49,96,4,0,11,11
49,96,5,0,15,15
49,96,6,2,7,5
49,97,0,1,7,6
49,97,1,1,10,9
49,97,2,2,6,4
49,97,3,0,12,12
49,97,4,1,7,6
49,97,5,0,8,8
49,97,6,0,7,7
49,98,0,4,14,10
49,98,1,0,5,5
49,98,2,0,8,8
49,98,3,0,9,9
49,98,4,0,9,9
49,98,5,0,2,2
49,98,6,1,10,9
49,99,0,0,11,11
49,99,1,0,10,10
49,99,2,2,14,12
49,99,3,0,5,5
49,99,4,5,10,5
49,99,5,0,11,11
49,99,6,0,11,11
49,100,0,3,16,13
49,100,1,0,11,11
49,100,2,0,7,7
49,100,3,1,15,14
49,100,4,3,12,9
49,100,5,0,10,10
49,100,6,1,11,10
49,101,0,0,9,9
49,101,1,0,10,10
49,101,2,4,12,8
49,101,3,0,11,11
49,101,4,2,9,7
49,101,5,0,6,6
49,101,6,1,13,12
49,102,0,1,7,6
49,102,1,2,8,6
49,102,2,1,10,9
49,102,3,4,11,7
49,102,4,1,6,5
49,102,5,1,14,13
49,102,6,0,10,10
49,103,0,0,2,2
49,103,1,3,9,6
49,103,2,0,8,8
49,103,3,3,10,7
49,103,4,2,5,3
49,103,5,0,5,5
49,103,6,2,11,9
49,104,0,0,8,8
49,104,1,1,6,5
49,104,2,3,14,11
49,104,3,2,12,10
49,104,4,1,3,2
49,104,5,0,8,8
49,104,6,1,10,9
49,105,0,0,5,5
49,105,1,0,12,12
49,105,2,3,10,7
49,105,3,1,10,9
49,105,4,1,12,11
49,105,5,0,7,7
49,105,6,1,8,7
49,106,0,1,12,11
49,106,1,0,11,11
49,106,2,3,9,6
49,106,3,1,12,11
49,106,4,4,12,8
49,106,5,5,16,11
49,106,6,2,17,15
49,107,0,0,10,10
49,107,1,2,11,9
49,107,2,0,6,6
49,107,3,0,5,5
49,107,4,1,5,4
49,107,5,2,15,13
49,107,6,0,8,8
49,108,0,1,12,11
49,108,1,1,10,9
49,108,2,0,6,6
49,108,3,0,7,7
49,108,4,1,9,8
49,108,5,1,9,8
49,108,6,1,9,8
49,109,0,1,6,5
49,109,1,2,14,12
49,109,2,0,3,3
49,109,3,2,7,5
49,109,4,4,12,8
49,109,5,4,10,6
49,109,6,1,15,14
49,110,0,0,7,7
49,110,1,0,8,8
49,110,2,0,11,11
49,110,3,0,4,4
49,110,4,0,13,13
49,110,5,2,15,13
49,110,6,5,16,11
49,111,0,0,6,6
49,111,1,2,11,9
49,111,2,0,10,10
49,111,3,2,11,9
49,111,4,1,16,15
49,111,5,1,16,15
49,111,6,9,21,12
49,112,0,1,10,9
49,112,1,0,6,6
49,112,2,2,7,5
49,112,3,1,5,4
49,112,4,2,13,11
49,112,5,2,12,10
49,112,6,2,25,23
49,113,0,1,6,5
49,113,1,2,16,14
49,113,2,2,15,13
49,113,3,0,11,11
49,113,4,0,7,7
49,113,5,3,12,9
49,113,6,1,12,11
49,114,0,1,8,7
49,114,1,5,9,4
49,114,2,0,9,9
49,114,3,1,4,3
49,114,4,3,13,10
49,114,5,4,18,14
49,114,6,0,10,10
49,115,0,4,10,6
49,115,1,2,9,7
49,115,2,3,11,8
49,115,3,5,12,7
49,115,4,1,5,4
49,115,5,1,15,14
49,115,6,1,8,7
49,116,0,0,6,6
49,116,1,1,5,4
49,116,2,0,4,4
49,116,3,7,13,6
49,116,4,1,8,7
49,116,5,3,11,8
49,116,6,3,10,7
49,117,0,0,5,5
49,117,1,1,5,4
49,117,2,1,5,4
49,117,3,1,5,4
49,117,4,3,8,5
49,117,5,0,7,7
49,117,6,3,9,6
49,118,0,0,3,3
49,118,1,3,7,4
49,118,2,1,9,8
49,118,3,3,5,2
49,118,4,2,5,3
49,118,5,0,9,9
49,118,6,5,12,7
49,119,0,2,8,6
49,119,1,2,4,2
49,119,2,0,8,8
49,119,3,2,6,4
49,119,5,2,7,5
49,119,6,0,7,7
49,120,0,1,11,10
49,120,1,2,3,1
49,120,2,0,6,6
49,120,3,2,7,5
49,120,4,0,1,1
49,120,5,1,7,6
49,120,6,3,10,7
49,121,0,0,3,3
49,121,1,1,8,7
49,121,2,1,6,5
49,121,3,2,3,1
49,121,4,0,6,6
49,121,5,4,8,4
49,121,6,3,13,10
49,122,0,1,2,1
49,122,1,0,6,6
49,122,2,1,5,4
49,122,3,8,12,4
49,122,4,1,2,1
49,122,5,1,5,4
49,122,6,6,11,5
49,123,0,3,5,2
49,123,1,3,9,6
49,123,2,2,4,2
49,123,3,6,9,3
49,123,4,2,7,5
49,123,5,2,10,8
49,123,6,4,7,3
49,124,0,0,1,1
49,124,1,2,11,9
49,124,2,2,3,1
49,124,3,3,4,1
49,124,4,0,6,6
49,124,5,3,8,5
49,124,6,2,5,3
49,125,0,2,6,4
49,125,1,1,7,6
49,125,2,0,5,5
49,125,3,1,6,5
49,125,4,1,7,6
49,125,5,2,9,7
49,125,6,0,5,5
49,126,0,0,5,5
49,126,1,1,4,3
49,126,2,0,4,4
49,126,3,0,1,1
49,126,4,2,8,6
49,126,5,0,5,5
49,126,6,3,12,9
49,127,0,5,6,1
49,127,1,0,5,5
49,127,2,1,7,6
49,127,3,0,4,4
49,127,4,1,7,6
49,127,5,2,8,6
49,127,6,0,5,5
49,128,0,0,5,5
49,128,1,2,7,5
49,128,2,0,4,4
49,128,3,1,3,2
49,128,4,3,6,3
49,128,5,0,2,2
49,128,6,4,7,3
49,129,0,1,5,4
49,129,1,0,3,3
49,129,2,0,3,3
49,129,3,2,6,4
49,129,4,5,7,2
49,129,5,0,5,5
49,129,6,0,4,4
49,130,0,1,2,1
49,130,1,0,1,1
49,130,2,1,8,7
49,130,3,1,3,2
49,130,4,2,5,3
49,130,5,0,4,4
49,130,6,0,3,3
49,131,0,2,9,7
49,131,1,1,3,2
49,131,2,1,7,6
49,131,3,0,3,3
49,131,4,1,3,2
49,131,5,0,1,1
49,131,6,0,1,1
49,132,0,1,4,3
49,132,1,0,2,2
49,132,2,2,7,5
49,132,3,0,3,3
49,132,4,1,3,2
49,132,5,0,4,4
49,132,6,0,4,4
49,133,0,1,4,3
49,133,1,3,5,2
49,133,2,0,5,5
49,133,3,0,3,3
49,133,4,0,2,2
49,133,5,2,6,4
49,133,6,0,8,8
49,134,0,0,6,6
49,134,1,2,4,2
49,134,2,2,3,1
49,134,3,1,10,9
49,134,4,2,6,4
49,134,5,0,3,3
49,134,6,1,5,4
49,135,0,2,5,3
49,135,1,3,8,5
49,135,2,0,5,5
49,135,3,1,5,4
49,135,4,1,4,3
49,135,5,3,8,5
49,135,6,0,5,5
49,136,0,0,6,6
49,136,1,1,3,2
49,136,2,1,2,1
49,136,4,5,12,7
49,136,5,0,2,2
49,136,6,4,9,5
49,137,0,1,8,7
49,137,1,1,3,2
49,137,2,4,8,4
49,137,3,4,7,3
49,137,4,0,6,6
49,137,5,1,3,2
49,137,6,1,4,3
49,138,0,1,3,2
49,138,2,0,3,3
49,138,3,3,4,1
49,138,4,2,4,2
49,138,5,4,8,4
49,138,6,0,2,2
49,139,0,2,6,4
49,139,2,3,6,3
49,139,3,0,4,4
49,139,4,1,2,1
49,139,5,1,6,5
49,139,6,5,7,2
49,140,0,2,2,0
49,140,1,0,1,1
49,140,2,4,6,2
49,140,3,1,1,0
49,140,4,3,5,2
49,140,5,2,2,0
49,140,6,0,1,1
49,141,0,3,3,0
49,141,1,2,2,0
49,141,2,4,6,2
49,141,3,2,4,2
49,141,4,0,3,3
49,141,5,1,2,1
49,141,6,1,1,0
49,142,0,2,3,1
49,142,1,1,3,2
49,142,2,1,7,6
49,142,3,2,2,0
49,142,4,6,8,2
49,142,5,0,1,1
49,143,0,1,2,1
49,143,1,0,1,1
49,143,3,0,2,2
49,143,4,4,6,2
49,143,5,1,2,1
50,0,0,1,1,0
50,0,2,0,1,1
50,0,3,1,2,1
50,0,4,5,5,0
50,0,5,2,2,0
50,0,6,3,5,2
50,1,0,0,2,2
50,1,1,0,1,1
50,1,2,1,1,0
50,1,3,0,2,2
50,1,4,3,3,0
50,1,5,0,1,1
50,1,6,6,6,0
50,2,0,0,2,2
50,2,3,0,1,1
50,2,4,4,4,0
50,2,5,2,4,2
50,2,6,3,4,1
50,3,0,0,1,1
50,3,1,0,1,1
50,3,3,1,1,0
50,3,5,1,2,1
50,3,6,7,7,0
50,4,0,0,2,2
50,4,1,0,1,1
50,4,2,1,1,0
50,4,3,1,2,1
50,4,5,2,3,1
50,4,6,2,3,1
50,5,1,0,1,1
50,5,4,2,4,2
50,5,6,1,1,0
50,6,0,2,2,0
50,6,1,0,1,1
50,6,2,0,1,1
50,6,3,0,1,1
50,6,4,2,2,0
50,6,5,1,3,2
50,7,2,5,6,1
50,7,4,2,3,1
50,8,2,1,1,0
50,9,0,2,2,0
50,9,2,3,3,0
50,10,6,3,3,0
50,11,0,0,1,1
50,11,2,1,1,0
50,11,4,1,1,0
50,11,5,1,2,1
50,11,6,4,5,1
50,12,4,1,2,1
50,13,1,0,1,1
50,13,4,0,1,1
50,13,5,1,1,0
50,13,6,2,2,0
50,14,1,1,2,1
50,14,4,1,1,0
50,15,3,1,1,0
50,15,4,1,1,0
50,16,3,4,4,0
50,16,6,1,1,0
50,17,3,1,1,0
50,17,6,1,1,0
50,23,2,1,1,0
50,24,3,1,1,0
50,24,4,0,1,1
50,26,4,1,1,0
50,27,3,1,1,0
50,28,3,1,1,0
50,29,4,1,1,0
50,30,1,1,1,0
50,30,4,1,1,0
50,31,1,1,1,0
50,31,3,2,2,0
50,33,4,1,2,1
50,33,6,0,1,1
50,34,4,0,1,1
50,34,6,2,2,0
50,35,6,1,1,0
50,36,1,1,1,0
50,36,5,0,1,1
50,37,0,2,2,0
50,37,4,1,1,0
50,37,5,0,1,1
50,37,6,0,1,1
50,38,0,2,3,1
50,38,2,0,1,1
50,38,3,0,1,1
50,38,4,1,1,0
50,39,0,2,4,2
50,39,1,3,7,4
50,39,2,1,2,1
50,39,4,1,1,0
50,39,6,2,2,0
50,40,0,0,3,3
50,40,1,1,3,2
50,40,2,0,2,2
50,40,3,0,2,2
50,40,4,0,3,3
50,40,6,1,4,3
50,41,0,0,1,1
50,41,1,0,2,2
50,41,2,0,1,1
50,41,3,3,9,6
50,41,4,0,1,1
50,41,5,0,1,1
50,41,6,3,4,1
50,42,0,0,1,1
50,42,1,0,2,2
50,42,2,0,3,3
50,42,3,0,7,7
50,42,4,2,2,0
50,42,5,0,1,1
50,42,6,2,3,1
50,43,0,0,7,7
50,43,1,0,6,6
50,43,2,0,3,3
50,43,3,1,3,2
50,43,4,2,3,1
50,43,6,1,3,2
50,44,0,0,9,9
50,44,1,0,6,6
50,44,2,0,5,5
50,44,3,1,5,4
50,44,4,1,4,3
50,44,5,0,3,3
50,45,0,2,7,5
50,45,1,0,7,7
50,45,2,0,6,6
50,45,3,4,11,7
50,45,4,1,8,7
50,45,5,1,7,6
50,45,6,3,4,1
50,46,0,3,7,4
50,46,1,0,6,6
50,46,2,1,6,5
50,46,3,0,3,3
50,46,4,1,7,6
50,46,5,1,5,4
50,46,6,0,2,2
50,47,0,2,15,13
50,47,1,0,8,8
50,47,2,2,11,9
50,47,3,0,9,9
50,47,4,2,13,11
50,47,5,1,7,6
50,47,6,1,6,5
50,48,0,1,12,11
50,48,1,2,9,7
50,48,2,1,10,9
50,48,3,0,4,4
50,48,4,0,6,6
50,48,5,2,3,1
50,48,6,1,4,3
50,49,0,2,8,6
50,49,1,0,9,9
50,49,2,2,5,3
50,49,3,0,7,7
50,49,4,2,15,13
50,49,5,1,4,3
50,49,6,0,6,6
50,50,0,0,4,4
50,50,1,0,4,4
50,50,2,6,10,4
50,50,3,0,4,4
50,50,4,1,4,3
50,50,5,2,7,5
50,50,6,3,11,8
50,51,0,4,7,3
50,51,1,1,5,4
50,51,2,0,5,5
50,51,3,1,7,6
50,51,4,2,5,3
50,51,5,6,14,8
50,51,6,2,8,6
50,52,0,4,7,3
50,52,1,0,2,2
50,52,2,0,4,4
50,52,3,1,5,4
50,52,4,1,6,5
50,52,5,1,4,3
50,52,6,2,9,7
50,53,0,0,4,4
50,53,1,2,9,7
50,53,2,1,4,3
50,53,3,0,4,4
50,53,4,1,10,9
50,53,5,1,5,4
50,53,6,0,6,6
50,54,0,3,7,4
50,54,1,0,5,5
50,54,2,1,9,8
50,54,3,1,8,7
50,54,4,2,10,8
50,54,5,0,2,2
50,54,6,2,4,2
50,55,0,0,8,8
50,55,1,4,8,4
50,55,2,0,6,6
50,55,3,0,7,7
50,55,4,2,7,5
50,55,5,3,7,4
50,55,6,2,4,2
50,56,0,0,4,4
50,56,1,3,6,3
50,56,2,0,3,3
50,56,3,1,5,4
50,56,4,0,4,4
50,56,5,1,6,5
50,56,6,1,10,9
50,57,0,4,9,5
50,57,1,6,10,4
50,57,2,0,3,3
50,57,3,1,7,6
50,57,4,2,6,4
50,57,5,4,7,3
50,57,6,0,3,3
50,58,0,5,9,4
50,58,1,2,6,4
50,58,2,2,5,3
50,58,3,3,6,3
50,58,4,0,5,5
50,58,5,0,6,6
50,58,6,0,1,1
50,59,0,2,5,3
50,59,1,0,2,2
50,59,2,4,7,3
50,59,3,5,9,4
50,59,4,4,8,4
50,59,5,0,3,3
50,59,6,3,6,3
50,60,0,0,2,2
50,60,1,3,5,2
50,60,2,3,6,3
50,60,3,2,5,3
50,60,4,1,1,0
50,60,5,0,5,5
50,60,6,3,10,7
50,61,0,0,1,1
50,61,1,2,5,3
50,61,2,0,2,2
50,61,3,1,5,4
50,61,4,0,5,5
50,61,5,0,3,3
50,61,6,1,6,5
50,62,0,0,2,2
50,62,1,2,6,4
50,62,2,0,2,2
50,62,3,0,3,3
50,62,4,3,4,1
50,62,5,0,4,4
50,62,6,3,5,2
50,63,0,3,5,2
50,63,1,3,6,3
50,63,2,4,6,2
50,63,3,3,8,5
50,63,4,1,6,5
50,63,5,2,3,1
50,63,6,1,6,5
50,64,0,5,6,1
50,64,1,0,3,3
50,64,2,8,13,5
50,64,3,2,4,2
50,64,4,5,8,3
50,64,5,5,7,2
50,64,6,0,2,2
50,65,0,1,6,5
50,65,1,1,3,2
50,65,2,5,8,3
50,65,3,3,5,2
50,65,4,10,15,5
50,65,5,2,5,3
50,65,6,0,3,3
50,66,0,0,2,2
50,66,1,1,2,1
50,66,2,4,8,4
50,66,3,9,14,5
50,66,4,7,10,3
50,66,5,2,6,4
50,66,6,7,11,4
50,67,0,0,7,7
50,67,1,5,8,3
50,67,2,5,6,1
50,67,3,0,4,4
50,67,4,5,8,3
50,67,5,5,5,0
50,67,6,5,7,2
50,68,0,2,5,3
50,68,1,3,8,5
50,68,2,1,2,1
50,68,3,0,4,4
50,68,4,1,5,4
50,68,5,6,11,5
50,68,6,12,17,5
50,69,0,7,14,7
50,69,1,1,5,4
50,69,2,1,2,1
50,69,3,0,3,3
50,69,4,1,3,2
50,69,5,4,8,4
50,69,6,4,9,5
50,70,0,7,10,3
50,70,1,0,1,1
50,70,2,1,1,0
50,70,3,1,5,4
50,70,4,2,4,2
50,70,5,1,6,5
50,70,6,3,5,2
50,71,0,2,5,3
50,71,1,1,4,3
50,71,2,0,4,4
50,71,3,4,6,2
50,71,5,0,5,5
50,71,6,2,5,3
50,72,0,0,1,1
50,72,1,6,10,4
50,72,2,2,8,6
50,72,3,3,6,3
50,72,4,2,4,2
50,72,5,1,2,1
50,72,6,0,7,7
50,73,0,0,8,8
50,73,1,7,11,4
50,73,2,1,5,4
50,73,3,0,1,1
50,73,4,1,5,4
50,73,5,1,4,3
50,73,6,2,5,3
50,74,0,1,5,4
50,74,1,0,4,4
50,74,2,1,7,6
50,74,3,3,7,4
50,74,4,0,1,1
50,74,5,2,11,9
50,74,6,0,5,5
50,75,0,3,7,4
50,75,1,2,9,7
50,75,2,4,8,4
50,75,3,4,8,4
50,75,4,4,6,2
50,75,5,0,3,3
50,75,6,0,9,9
50,76,0,0,3,3
50,76,1,5,10,5
50,76,2,3,11,8
50,76,3,1,4,3
50,76,4,2,7,5
50,76,5,2,7,5
50,76,6,1,8,7
50,77,0,1,4,3
50,77,1,8,14,6
50,77,2,5,9,4
50,77,3,2,7,5
50,77,4,3,6,3
50,77,5,11,16,5
50,77,6,0,3,3
50,78,0,2,3,1
50,78,1,0,6,6
50,78,2,1,4,3
50,78,3,1,1,0
50,78,4,5,11,6
50,78,5,5,12,7
50,78,6,1,8,7
50,79,0,2,5,3
50,79,1,2,6,4
50,79,2,1,4,3
50,79,3,0,4,4
50,79,4,0,4,4
50,79,5,8,11,3
50,79,6,1,3,2
50,80,0,12,17,5
50,80,1,3,3,0
50,80,2,3,4,1
50,80,3,1,2,1
50,80,4,0,3,3
50,80,5,8,13,5
50,80,6,1,3,2
50,81,0,4,10,6
50,81,1,2,5,3
50,81,2,0,6,6
50,81,3,2,5,3
50,81,4,1,2,1
50,81,5,3,7,4
50,81,6,2,6,4
50,82,0,0,1,1
50,82,1,0,4,4
50,82,2,0,8,8
50,82,3,2,4,2
50,82,4,1,10,9
50,82,5,0,9,9
50,82,6,5,9,4
50,83,0,5,7,2
50,83,1,1,6,5
50,83,2,0,4,4
50,83,3,5,7,2
50,83,4,1,9,8
50,83,5,3,7,4
50,83,6,2,10,8
50,84,0,2,5,3
50,84,1,2,8,6
50,84,2,0,4,4
50,84,3,3,7,4
50,84,4,1,6,5
50,84,5,6,11,5
50,84,6,4,9,5
50,85,0,1,2,1
50,85,1,2,7,5
50,85,2,0,3,3
50,85,3,0,2,2
50,85,4,6,14,8
50,85,5,0,6,6
50,85,6,4,7,3
50,86,0,0,3,3
50,86,1,1,2,1
50,86,2,0,3,3
50,86,3,1,3,2
50,86,4,8,10,2
50,86,5,0,3,3
50,86,6,1,10,9
50,87,0,0,3,3
50,87,1,0,6,6
50,87,2,11,19,8
50,87,3,1,3,2
50,87,4,2,9,7
50,87,5,0,4,4
50,87,6,3,8,5
50,88,0,1,1,0
50,88,1,0,4,4
50,88,2,5,5,0
50,88,3,4,5,1
50,88,4,1,3,2
50,88,5,0,6,6
50,88,6,1,5,4
50,89,0,2,4,2
50,89,1,0,3,3
50,89,2,4,11,7
50,89,3,4,6,2
50,89,4,0,4,4
50,89,5,0,3,3
50,89,6,1,4,3
50,90,0,0,3,3
50,90,1,2,6,4
50,90,2,4,6,2
50,90,3,3,7,4
50,90,4,1,2,1
50,90,5,1,2,1
50,90,6,1,3,2
50,91,0,4,7,3
50,91,1,2,4,2
50,91,2,6,8,2
50,91,3,1,4,3
50,91,4,0,4,4
50,91,5,0,2,2
50,91,6,1,6,5
50,92,0,5,9,4
50,92,1,0,1,1
50,92,2,9,10,1
50,92,3,3,9,6
50,92,4,0,3,3
50,92,5,4,11,7
50,92,6,1,5,4
50,93,0,1,5,4
50,93,1,1,4,3
50,93,2,0,1,1
50,93,3,0,3,3
50,93,4,1,8,7
50,93,5,4,9,5
50,93,6,1,4,3
50,94,0,3,7,4
50,94,1,2,5,3
50,94,2,3,8,5
50,94,3,1,9,8
50,94,4,2,6,4
50,94,5,4,8,4
50,94,6,8,14,6
50,95,0,4,9,5
50,95,1,0,1,1
50,95,2,0,3,3
50,95,3,0,5,5
50,95,4,0,2,2
50,95,5,3,8,5
50,95,6,0,5,5
50,96,0,4,7,3
50,96,1,1,6,5
50,96,2,0,5,5
50,96,3,3,5,2
50,96,4,0,6,6
50,96,5,0,7,7
50,96,6,4,6,2
50,97,0,1,4,3
50,97,1,1,2,1
50,97,2,0,5,5
50,97,3,13,21,8
50,97,4,0,3,3
50,97,5,1,5,4
50,97,6,1,5,4
50,98,0,2,6,4
50,98,1,3,11,8
50,98,2,0,5,5
50,98,3,0,5,5
50,98,4,0,6,6
50,98,5,1,5,4
50,98,6,1,7,6
50,99,0,3,7,4
50,99,1,0,3,3
50,99,2,0,2,2
50,99,3,2,12,10
50,99,4,3,8,5
50,99,5,0,6,6
50,100,0,2,6,4
50,100,1,0,6,6
50,100,2,0,5,5
50,100,3,0,10,10
50,100,4,1,11,10
50,100,5,0,7,7
50,100,6,3,6,3
50,101,0,2,10,8
50,101,1,0,5,5
50,101,2,0,8,8
50,101,3,0,7,7
50,101,4,1,7,6
50,101,5,2,9,7
50,101,6,1,6,5
50,102,0,0,5,5
50,102,1,0,8,8
50,102,2,0,7,7
50,102,3,1,11,10
50,102,4,2,4,2
50,102,5,0,5,5
50,102,6,3,6,3
50,103,0,0,7,7
50,103,1,0,1,1
50,103,2,0,8,8
50,103,3,2,12,10
50,103,4,1,6,5
50,103,5,1,14,13
50,103,6,3,11,8
50,104,0,0,2,2
50,104,1,0,3,3
50,104,2,0,6,6
50,104,3,2,6,4
50,104,4,1,11,10
50,104,5,0,5,5
50,104,6,0,8,8
50,105,0,1,9,8
50,105,1,0,10,10
50,105,2,0,3,3
50,105,3,3,8,5
50,105,4,1,9,8
50,105,5,0,6,6
50,105,6,0,8,8
50,106,0,0,2,2
50,106,1,1,3,2
50,106,2,0,4,4
50,106,3,1,3,2
50,106,4,0,2,2
50,106,5,2,5,3
50,106,6,0,3,3
50,107,0,2,6,4
50,107,1,2,6,4
50,107,2,1,9,8
50,107,3,0,10,10
50,107,4,2,8,6
50,107,5,0,7,7
50,107,6,2,6,4
50,108,0,4,8,4
50,108,1,2,6,4
50,108,2,1,4,3
50,108,3,1,6,5
50,108,4,0,6,6
50,108,5,0,5,5
50,108,6,2,4,2
50,109,0,1,9,8
50,109,1,0,6,6
50,109,2,0,4,4
50,109,3,1,8,7
50,109,4,2,7,5
50,109,5,0,2,2
50,109,6,1,4,3
50,110,0,3,10,7
50,110,1,2,8,6
50,110,2,3,6,3
50,110,3,4,7,3
50,110,4,0,1,1
50,110,5,0,3,3
50,110,6,1,8,7
50,111,0,1,7,6
50,111,1,1,7,6
50,111,2,1,6,5
50,111,3,4,9,5
50,111,4,0,4,4
50,111,5,2,9,7
50,111,6,0,8,8
50,112,0,1,8,7
50,112,1,2,5,3
50,112,2,0,3,3
50,112,3,0,8,8
50,112,4,3,11,8
50,112,5,1,8,7
50,112,6,0,4,4
50,113,0,1,5,4
50,113,1,0,5,5
50,113,2,1,11,10
50,113,3,0,5,5
50,113,4,7,10,3
50,113,5,1,5,4
50,113,6,0,3,3
50,114,0,0,1,1
50,114,1,0,3,3
50,114,2,1,2,1
50,114,3,1,3,2
50,114,4,6,12,6
50,114,5,0,2,2
50,114,6,0,2,2
50,115,0,1,6,5
50,115,1,0,4,4
50,115,2,0,7,7
50,115,3,0,3,3
50,115,4,6,11,5
50,115,5,1,3,2
50,115,6,1,4,3
50,116,0,4,7,3
50,116,1,0,6,6
50,116,2,0,6,6
50,116,3,1,3,2
50,116,4,4,12,8
50,116,5,2,3,1
50,116,6,1,6,5
50,117,0,2,10,8
50,117,1,0,3,3
50,117,2,0,3,3
50,117,3,2,5,3
50,117,4,2,7,5
50,117,5,1,8,7
50,117,6,0,5,5
50,118,0,2,7,5
50,118,1,2,5,3
50,118,2,1,7,6
50,118,3,0,3,3
50,118,4,4,7,3
50,118,5,5,12,7
50,118,6,3,8,5
50,119,0,0,1,1
50,119,1,1,7,6
50,119,2,3,12,9
50,119,3,6,9,3
50,119,4,1,5,4
50,119,5,1,6,5
50,119,6,2,5,3
50,120,0,2,4,2
50,120,1,0,4,4
50,120,2,0,2,2
50,120,3,1,6,5
50,120,4,0,7,7
50,120,5,4,7,3
50,120,6,1,5,4
50,121,0,4,7,3
50,121,1,2,7,5
50,121,2,4,8,4
50,121,3,0,2,2
50,121,4,0,3,3
50,121,5,3,10,7
50,121,6,4,9,5
50,122,0,3,9,6
50,122,1,1,2,1
50,122,2,2,9,7
50,122,3,1,3,2
50,122,4,4,13,9
50,122,5,0,2,2
50,122,6,0,3,3
50,123,0,3,10,7
50,123,1,4,9,5
50,123,2,4,6,2
50,123,3,4,7,3
50,123,4,5,7,2
50,123,5,1,3,2
50,123,6,2,8,6
50,124,0,1,4,3
50,124,1,2,6,4
50,124,2,0,2,2
50,124,3,0,2,2
50,124,4,1,9,8
50,124,5,0,8,8
50,124,6,5,11,6
50,125,0,2,5,3
50,125,1,2,6,4
50,125,2,6,15,9
50,125,3,0,3,3
50,125,4,1,7,6
50,125,5,1,7,6
50,125,6,2,5,3
50,126,0,1,2,1
50,126,1,0,3,3
50,126,2,1,5,4
50,126,3,2,5,3
50,126,4,2,6,4
50,126,5,2,4,2
50,126,6,0,3,3
50,127,0,1,5,4
50,127,1,2,3,1
50,127,2,0,5,5
50,127,3,2,4,2
50,127,4,0,3,3
50,127,5,2,5,3
50,127,6,0,5,5
50,128,0,2,5,3
50,128,1,0,1,1
50,128,2,0,4,4
50,128,3,9,10,1
50,128,4,0,1,1
50,128,5,3,8,5
50,128,6,0,5,5
50,129,0,2,7,5
50,129,1,2,7,5
50,129,2,2,5,3
50,129,3,3,3,0
50,129,4,0,1,1
50,129,5,0,2,2
50,129,6,0,4,4
50,130,0,1,4,3
50,130,1,5,11,6
50,130,2,2,5,3
50,130,3,5,10,5
50,130,4,0,3,3
50,130,5,1,2,1
50,130,6,1,4,3
50,131,0,1,3,2
50,131,1,6,8,2
50,131,2,0,2,2
50,131,3,1,2,1
50,131,4,0,1,1
50,131,5,0,2,2
50,131,6,0,1,1
50,132,0,1,5,4
50,132,1,1,5,4
50,132,2,2,4,2
50,132,3,3,5,2
50,132,4,0,1,1
50,132,5,0,2,2
50,132,6,1,3,2
50,133,1,2,3,1
50,133,2,3,4,1
50,133,3,9,13,4
50,133,4,1,4,3
50,133,6,1,4,3
50,134,0,0,1,1
50,134,1,0,2,2
50,134,2,3,5,2
50,134,3,4,4,0
50,134,4,3,4,1
50,134,5,1,3,2
50,134,6,1,5,4
50,135,0,3,6,3
50,135,1,0,1,1
50,135,2,3,3,0
50,135,3,0,1,1
50,135,4,1,4,3
50,135,5,0,1,1
50,135,6,1,5,4
50,136,0,0,1,1
50,136,1,2,6,4
50,136,2,0,1,1
50,136,3,0,4,4
50,136,4,0,1,1
50,136,5,1,3,2
50,136,6,0,2,2
50,137,1,4,6,2
50,137,2,1,2,1
50,137,3,0,3,3
50,137,4,0,4,4
50,137,5,2,7,5
50,137,6,2,3,1
50,138,0,2,2,0
50,138,1,3,6,3
50,138,2,3,4,1
50,138,3,0,3,3
50,138,4,3,3,0
50,138,6,3,5,2
50,139,0,1,4,3
50,139,1,0,1,1
50,139,3,1,3,2
50,139,4,0,3,3
50,139,6,0,1,1
50,140,0,0,1,1
50,140,1,0,3,3
50,140,2,0,2,2
50,140,3,1,1,0
50,140,4,0,2,2
50,140,5,0,1,1
50,140,6,0,1,1
50,141,0,0,1,1
50,141,1,2,4,2
50,141,3,1,3,2
50,141,4,11,13,2
50,141,5,3,4,1
50,141,6,1,2,1
50,142,0,0,2,2
50,142,1,3,3,0
50,142,2,0,2,2
50,142,3,0,1,1
50,142,4,0,1,1
50,142,5,1,2,1
50,142,6,0,1,1
50,143,0,0,3,3
50,143,1,3,5,2
50,143,2,5,5,0
50,143,3,2,2,0
50,143,4,3,7,4
50,143,5,4,4,0
50,143,6,0,1,1
51,0,0,241,623,382
51,0,1,226,604,378
51,0,2,255,667,412
51,0,3,193,589,396
51,0,4,191,1273,1082
51,0,5,292,901,609
51,0,6,470,1003,533
51,1,0,254,618,364
51,1,1,232,571,339
51,1,2,311,696,385
51,1,3,230,626,396
51,1,4,453,1801,1348
51,1,5,333,863,530
51,1,6,563,1037,474
51,2,0,285,622,337
51,2,1,238,556,318
51,2,2,202,537,335
51,2,3,258,587,329
51,2,4,1828,2753,925
51,2,5,298,768,470
51,2,6,492,919,427
51,3,0,237,529,292
51,3,1,206,496,290
51,3,2,195,507,312
51,3,3,212,528,316
51,3,4,3202,3977,775
51,3,5,286,709,423
51,3,6,515,945,430
51,4,0,149,445,296
51,4,1,138,418,280
51,4,2,124,413,289
51,4,3,224,528,304
51,4,4,3888,4628,740
51,4,5,287,717,430
51,4,6,430,810,380
51,5,0,124,368,244
51,5,1,101,370,269
51,5,2,137,417,280
51,5,3,182,449,267
51,5,4,4029,4723,694
51,5,5,255,619,364
51,5,6,312,660,348
51,6,0,117,349,232
51,6,1,118,323,205
51,6,2,112,357,245
51,6,3,125,389,264
51,6,4,3749,4369,620
51,6,5,263,625,362
51,6,6,421,771,350
51,7,0,110,301,191
51,7,1,89,328,239
51,7,2,143,391,248
51,7,3,141,364,223
51,7,4,3627,4260,633
51,7,5,254,552,298
51,7,6,266,602,336
51,8,0,132,333,201
51,8,1,112,330,218
51,8,2,133,369,236
51,8,3,149,401,252
51,8,4,3259,3868,609
51,8,5,180,466,286
51,8,6,202,502,300
51,9,0,82,284,202
51,9,1,86,297,211
51,9,2,98,315,217
51,9,3,155,358,203
51,9,4,3029,3581,552
51,9,5,172,468,296
51,9,6,183,457,274
51,10,0,84,267,183
51,10,1,87,280,193
51,10,2,112,342,230
51,10,3,120,311,191
51,10,4,2437,3005,568
51,10,5,203,451,248
51,10,6,186,490,304
51,11,0,86,250,164
51,11,1,105,304,199
51,11,2,59,260,201
51,11,3,97,300,203
51,11,4,1918,2437,519
51,11,5,164,433,269
51,11,6,174,401,227
51,12,0,112,292,180
51,12,1,94,255,161
51,12,2,96,303,207
51,12,3,103,268,165
51,12,4,1646,2032,386
51,12,5,176,416,240
51,12,6,194,430,236
51,13,0,83,236,153
51,13,1,82,245,163
51,13,2,94,260,166
51,13,3,96,262,166
51,13,4,1481,1837,356
51,13,5,289,491,202
51,13,6,170,383,213
51,14,0,106,246,140
51,14,1,51,188,137
51,14,2,103,248,145
51,14,3,83,243,160
51,14,4,1354,1648,294
51,14,5,216,399,183
51,14,6,130,351,221
51,15,0,85,220,135
51,15,1,46,184,138
51,15,2,84,250,166
51,15,3,95,253,158
51,15,4,1074,1341,267
51,15,5,178,367,189
51,15,6,137,323,186
51,16,0,78,208,130
51,16,1,67,206,139
51,16,2,84,225,141
51,16,3,50,176,126
51,16,4,782,1037,255
51,16,5,146,309,163
51,16,6,132,312,180
51,17,0,81,205,124
51,17,1,54,176,122
51,17,2,100,243,143
51,17,3,65,207,142
51,17,4,734,963,229
51,17,5,107,262,155
51,17,6,142,294,152
51,18,0,49,145,96
51,18,1,86,184,98
51,18,2,52,202,150
51,18,3,96,215,119
51,18,4,581,761,180
51,18,5,139,298,159
51,18,6,120,264,144
51,19,0,43,157,114
51,19,1,29,121,92
51,19,2,61,165,104
51,19,3,64,161,97
51,19,4,478,658,180
51,19,5,119,247,128
51,19,6,109,252,143
51,20,0,44,129,85
51,20,1,23,123,100
51,20,2,47,130,83
51,20,3,46,155,109
51,20,4,331,487,156
51,20,5,103,214,111
51,20,6,90,215,125
51,21,0,37,137,100
51,21,1,16,103,87
51,21,2,44,138,94
51,21,3,61,163,102
51,21,4,299,436,137
51,21,5,132,262,130
51,21,6,89,234,145
51,22,0,59,161,102
51,22,1,38,134,96
51,22,2,41,121,80
51,22,3,30,122,92
51,22,4,177,298,121
51,22,5,141,248,107
51,22,6,92,197,105
51,23,0,85,150,65
51,23,1,51,148,97
51,23,2,25,133,108
51,23,3,65,158,93
51,23,4,193,305,112
51,23,5,87,206,119
51,23,6,97,225,128
51,24,0,61,144,83
51,24,1,53,142,89
51,24,2,56,139,83
51,24,3,81,183,102
51,24,4,204,318,114
51,24,5,61,148,87
51,24,6,97,198,101
51,25,0,45,121,76
51,25,1,42,116,74
51,25,2,42,120,78
51,25,3,41,122,81
51,25,4,171,280,109
51,25,5,55,147,92
51,25,6,97,182,85
51,26,0,47,115,68
51,26,1,35,114,79
51,26,2,37,122,85
51,26,3,36,112,76
51,26,4,190,314,124
51,26,5,60,148,88
51,26,6,99,199,100
51,27,0,37,103,66
51,27,1,28,111,83
51,27,2,40,125,85
51,27,3,42,111,69
51,27,4,199,303,104
51,27,5,63,154,91
51,27,6,64,165,101
51,28,0,26,96,70
51,28,1,22,84,62
51,28,2,35,128,93
51,28,3,23,100,77
51,28,4,202,289,87
51,28,5,50,136,86
51,28,6,81,178,97
51,29,0,26,90,64
51,29,1,29,97,68
51,29,2,12,77,65
51,29,3,8,88,80
51,29,4,170,258,88
51,29,5,33,104,71
51,29,6,39,138,99
51,30,0,23,76,53
51,30,1,18,85,67
51,30,2,6,77,71
51,30,3,10,90,80
51,30,4,196,279,83
51,30,5,22,93,71
51,30,6,45,135,90
51,31,0,13,97,84
51,31,1,16,105,89
51,31,2,14,75,61
51,31,3,8,98,90
51,31,4,216,290,74
51,31,5,16,102,86
51,31,6,52,137,85
51,32,0,29,108,79
51,32,1,19,92,73
51,32,2,13,102,89
51,32,3,17,73,56
51,32,4,206,275,69
51,32,5,16,88,72
51,32,6,29,100,71
51,33,0,54,138,84
51,33,1,19,111,92
51,33,2,17,98,81
51,33,3,16,91,75
51,33,4,196,267,71
51,33,5,30,113,83
51,33,6,37,123,86
51,34,0,32,119,87
51,34,1,23,100,77
51,34,2,17,106,89
51,34,3,18,80,62
51,34,4,270,330,60
51,34,5,32,111,79
51,34,6,28,116,88
51,35,0,49,136,87
51,35,1,7,80,73
51,35,2,19,90,71
51,35,3,17,92,75
51,35,4,246,323,77
51,35,5,28,101,73
51,35,6,43,132,89
51,36,0,71,153,82
51,36,1,26,113,87
51,36,2,37,127,90
51,36,3,25,102,77
51,36,4,298,380,82
51,36,5,20,103,83
51,36,6,61,129,68
51,37,0,79,158,79
51,37,1,50,146,96
51,37,2,61,137,76
51,37,3,36,120,84
51,37,4,345,431,86
51,37,5,33,117,84
51,37,6,46,142,96
51,38,0,57,147,90
51,38,1,69,171,102
51,38,2,82,176,94
51,38,3,42,124,82
51,38,4,382,482,100
51,38,5,50,148,98
51,38,6,51,140,89
51,39,0,12,286,274
51,39,1,3,210,207
51,39,2,9,232,223
51,39,3,10,205,195
51,39,4,294,448,154
51,39,5,15,129,114
51,39,6,43,186,143
51,40,0,25,342,317
51,40,1,11,279,268
51,40,2,9,292,283
51,40,3,11,271,260
51,40,4,261,431,170
51,40,5,8,191,183
51,40,6,39,205,166
51,41,0,55,453,398
51,41,1,10,371,361
51,41,2,12,370,358
51,41,3,9,340,331
51,41,4,242,565,323
51,41,5,10,186,176
51,41,6,35,221,186
51,42,0,89,706,617
51,42,1,13,508,495
51,42,2,13,532,519
51,42,3,16,526,510
51,42,4,245,643,398
51,42,5,16,273,257
51,42,6,36,273,237
51,43,0,120,888,768
51,43,1,18,683,665
51,43,2,21,712,691
51,43,3,19,631,612
51,43,4,243,775,532
51,43,5,10,283,273
51,43,6,35,314,279
51,44,0,291,1231,940
51,44,1,32,941,909
51,44,2,22,942,920
51,44,3,24,855,831
51,44,4,187,838,651
51,44,5,38,464,426
51,44,6,51,373,322
51,45,0,423,1494,1071
51,45,1,72,1118,1046
51,45,2,97,1237,1140
51,45,3,57,1077,1020
51,45,4,205,1002,797
51,45,5,16,503,487
51,45,6,40,457,417
51,46,0,713,1831,1118
51,46,1,193,1309,1116
51,46,2,272,1555,1283
51,46,3,119,1283,1164
51,46,4,185,1076,891
51,46,5,19,489,470
51,46,6,37,458,421
51,47,0,1023,2213,1190
51,47,1,337,1656,1319
51,47,2,444,1850,1406
51,47,3,148,1490,1342
51,47,4,143,1148,1005
51,47,5,16,540,524
51,47,6,23,496,473
51,48,0,1334,2573,1239
51,48,1,596,1959,1363
51,48,2,527,1999,1472
51,48,3,278,1753,1475
51,48,4,256,1376,1120
51,48,5,23,638,615
51,48,6,20,554,534
51,49,0,1128,2447,1319
51,49,1,685,2092,1407
51,49,2,494,1939,1445
51,49,3,212,1717,1505
51,49,4,157,1347,1190
51,49,5,17,661,644
51,49,6,22,589,567
51,50,0,749,2258,1509
51,50,1,390,1955,1565
51,50,2,258,1833,1575
51,50,3,112,1619,1507
51,50,4,93,1303,1210
51,50,5,17,784,767
51,50,6,20,659,639
51,51,0,628,2121,1493
51,51,1,331,1850,1519
51,51,2,214,1816,1602
51,51,3,80,1529,1449
51,51,4,120,1348,1228
51,51,5,17,792,775
51,51,6,18,687,669
51,52,0,411,1797,1386
51,52,1,202,1554,1352
51,52,2,86,1450,1364
51,52,3,51,1324,1273
51,52,4,93,1181,1088
51,52,5,29,804,775
51,52,6,14,651,637
51,53,0,117,1422,1305
51,53,1,53,1329,1276
51,53,2,29,1207,1178
51,53,3,36,1250,1214
51,53,4,39,1030,991
51,53,5,17,727,710
51,53,6,16,664,648
51,54,0,57,1307,1250
51,54,1,28,1320,1292
51,54,2,31,1307,1276
51,54,3,34,1292,1258
51,54,4,31,1029,998
51,54,5,15,785,770
51,54,6,23,738,715
51,55,0,45,1282,1237
51,55,1,40,1250,1210
51,55,2,30,1247,1217
51,55,3,30,1214,1184
51,55,4,34,1103,1069
51,55,5,24,850,826
51,55,6,10,724,714
51,56,0,20,1215,1195
51,56,1,24,1273,1249
51,56,2,38,1268,1230
51,56,3,33,1209,1176
51,56,4,33,1123,1090
51,56,5,28,927,899
51,56,6,11,758,747
51,57,0,38,1111,1073
51,57,1,28,1227,1199
51,57,2,26,1206,1180
51,57,3,15,1187,1172
51,57,4,42,1112,1070
51,57,5,28,995,967
51,57,6,13,889,876
51,58,0,26,1125,1099
51,58,1,34,1178,1144
51,58,2,37,1285,1248
51,58,3,24,1098,1074
51,58,4,36,1058,1022
51,58,5,34,1014,980
51,58,6,24,869,845
51,59,0,36,1067,1031
51,59,1,29,1165,1136
51,59,2,38,1198,1160
51,59,3,24,1113,1089
51,59,4,45,1083,1038
51,59,5,25,913,888
51,59,6,27,894,867
51,60,0,34,1069,1035
51,60,1,23,1104,1081
51,60,2,42,1181,1139
51,60,3,23,1124,1101
51,60,4,65,1104,1039
51,60,5,19,1000,981
51,60,6,27,909,882
51,61,0,38,1126,1088
51,61,1,31,1092,1061
51,61,2,34,1215,1181
51,61,3,33,1051,1018
51,61,4,75,1127,1052
51,61,5,26,934,908
51,61,6,18,934,916
51,62,0,25,1117,1092
51,62,1,19,1057,1038
51,62,2,36,1154,1118
51,62,3,30,1086,1056
51,62,4,55,1120,1065
51,62,5,25,1019,994
51,62,6,28,884,856
51,63,0,36,1138,1102
51,63,1,14,1026,1012
51,63,2,43,1152,1109
51,63,3,26,1132,1106
51,63,4,72,1126,1054
51,63,5,23,994,971
51,63,6,17,945,928
51,64,0,29,1078,1049
51,64,1,20,1186,1166
51,64,2,38,1216,1178
51,64,3,25,1151,1126
51,64,4,53,1153,1100
51,64,5,32,1034,1002
51,64,6,20,991,971
51,65,0,22,1107,1085
51,65,1,30,1100,1070
51,65,2,42,1177,1135
51,65,3,16,1139,1123
51,65,4,82,1193,1111
51,65,5,29,1023,994
51,65,6,27,1018,991
51,66,0,27,1169,1142
51,66,1,36,1180,1144
51,66,2,73,1305,1232
51,66,3,30,1194,1164
51,66,4,85,1232,1147
51,66,5,38,1115,1077
51,66,6,29,1084,1055
51,67,0,32,1196,1164
51,67,1,31,1206,1175
51,67,2,102,1345,1243
51,67,3,28,1241,1213
51,67,4,88,1220,1132
51,67,5,33,1104,1071
51,67,6,37,1157,1120
51,68,0,31,1267,1236
51,68,1,26,1142,1116
51,68,2,130,1381,1251
51,68,3,33,1291,1258
51,68,4,131,1287,1156
51,68,5,30,1181,1151
51,68,6,15,1156,1141
51,69,0,28,1264,1236
51,69,1,32,1303,1271
51,69,2,227,1511,1284
51,69,3,21,1338,1317
51,69,4,140,1329,1189
51,69,5,39,1245,1206
51,69,6,28,1141,1113
51,70,0,33,1260,1227
51,70,1,59,1315,1256
51,70,2,223,1547,1324
51,70,3,41,1272,1231
51,70,4,154,1360,1206
51,70,5,46,1198,1152
51,70,6,43,1202,1159
51,71,0,29,1217,1188
51,71,1,33,1178,1145
51,71,2,211,1449,1238
51,71,3,37,1237,1200
51,71,4,156,1326,1170
51,71,5,29,1234,1205
51,71,6,31,1134,1103
51,72,0,25,1164,1139
51,72,1,34,1274,1240
51,72,2,65,1255,1190
51,72,3,25,1174,1149
51,72,4,141,1366,1225
51,72,5,38,1260,1222
51,72,6,39,1235,1196
51,73,0,22,1212,1190
51,73,1,36,1128,1092
51,73,2,39,1202,1163
51,73,3,39,1171,1132
51,73,4,104,1171,1067
51,73,5,32,1269,1237
51,73,6,41,1224,1183
51,74,0,44,1263,1219
51,74,1,35,1170,1135
51,74,2,63,1267,1204
51,74,3,33,1134,1101
51,74,4,102,1222,1120
51,74,5,32,1363,1331
51,74,6,37,1173,1136
51,75,0,52,1223,1171
51,75,1,44,1222,1178
51,75,2,51,1237,1186
51,75,3,32,1111,1079
51,75,4,144,1303,1159
51,75,5,42,1315,1273
51,75,6,32,1289,1257
51,76,0,40,1203,1163
51,76,1,37,1165,1128
51,76,2,58,1293,1235
51,76,3,31,1138,1107
51,76,4,136,1243,1107
51,76,5,39,1284,1245
51,76,6,36,1222,1186
51,77,0,69,1366,1297
51,77,1,49,1241,1192
51,77,2,66,1367,1301
51,77,3,37,1268,1231
51,77,4,125,1284,1159
51,77,5,46,1397,1351
51,77,6,35,1285,1250
51,78,0,63,1311,1248
51,78,1,136,1393,1257
51,78,2,69,1372,1303
51,78,3,40,1335,1295
51,78,4,202,1518,1316
51,78,5,62,1427,1365
51,78,6,35,1385,1350
51,79,0,118,1434,1316
51,79,1,143,1390,1247
51,79,2,66,1453,1387
51,79,3,56,1371,1315
51,79,4,238,1646,1408
51,79,5,91,1531,1440
51,79,6,32,1408,1376
51,80,0,147,1418,1271
51,80,1,193,1479,1286
51,80,2,141,1494,1353
51,80,3,63,1460,1397
51,80,4,238,1541,1303
51,80,5,150,1726,1576
51,80,6,62,1430,1368
51,81,0,122,1490,1368
51,81,1,192,1506,1314
51,81,2,256,1718,1462
51,81,3,62,1428,1366
51,81,4,234,1621,1387
51,81,5,124,1613,1489
51,81,6,45,1514,1469
51,82,0,124,1569,1445
51,82,1,222,1589,1367
51,82,2,185,1559,1374
51,82,3,148,1581,1433
51,82,4,427,1816,1389
51,82,5,82,1665,1583
51,82,6,42,1524,1482
51,83,0,184,1539,1355
51,83,1,222,1622,1400
51,83,2,232,1643,1411
51,83,3,115,1477,1362
51,83,4,364,1738,1374
51,83,5,180,1889,1709
51,83,6,55,1639,1584
51,84,0,152,1662,1510
51,84,1,268,1540,1272
51,84,2,205,1658,1453
51,84,3,200,1593,1393
51,84,4,472,1847,1375
51,84,5,163,1888,1725
51,84,6,57,1634,1577
51,85,0,197,1681,1484
51,85,1,311,1644,1333
51,85,2,272,1734,1462
51,85,3,109,1511,1402
51,85,4,440,1870,1430
51,85,5,225,1771,1546
51,85,6,117,1730,1613
51,86,0,293,1777,1484
51,86,1,329,1690,1361
51,86,2,364,1745,1381
51,86,3,154,1556,1402
51,86,4,423,1802,1379
51,86,5,245,1967,1722
51,86,6,96,1745,1649
51,87,0,262,1730,1468
51,87,1,275,1737,1462
51,87,2,282,1867,1585
51,87,3,186,1636,1450
51,87,4,536,1940,1404
51,87,5,246,1948,1702
51,87,6,126,1795,1669
51,88,0,236,1653,1417
51,88,1,292,1636,1344
51,88,2,409,1925,1516
51,88,3,164,1600,1436
51,88,4,618,2045,1427
51,88,5,205,1923,1718
51,88,6,180,1990,1810
51,89,0,445,1881,1436
51,89,1,385,1774,1389
51,89,2,377,1835,1458
51,89,3,205,1604,1399
51,89,4,587,1980,1393
51,89,5,222,1941,1719
51,89,6,181,1906,1725
51,90,0,760,2190,1430
51,90,1,390,1792,1402
51,90,2,605,2102,1497
51,90,3,244,1715,1471
51,90,4,831,2239,1408
51,90,5,282,2027,1745
51,90,6,319,2155,1836
51,91,0,1240,2516,1276
51,91,1,714,2051,1337
51,91,2,938,2420,1482
51,91,3,329,1787,1458
51,91,4,769,2125,1356
51,91,5,336,2046,1710
51,91,6,446,2181,1735
51,92,0,1253,2590,1337
51,92,1,1148,2478,1330
51,92,2,999,2336,1337
51,92,3,380,1784,1404
51,92,4,844,2185,1341
51,92,5,340,2130,1790
51,92,6,679,2332,1653
51,93,0,383,2289,1906
51,93,1,391,2036,1645
51,93,2,470,2147,1677
51,93,3,119,1989,1870
51,93,4,199,2227,2028
51,93,5,288,2037,1749
51,93,6,418,2212,1794
51,94,0,361,1926,1565
51,94,1,407,1850,1443
51,94,2,418,1845,1427
51,94,3,131,1752,1621
51,94,4,262,2084,1822
51,94,5,471,2218,1747
51,94,6,865,2460,1595
51,95,0,555,2149,1594
51,95,1,494,2038,1544
51,95,2,667,2115,1448
51,95,3,234,1793,1559
51,95,4,342,2138,1796
51,95,5,706,2445,1739
51,95,6,1077,2676,1599
51,96,0,440,2244,1804
51,96,1,342,2187,1845
51,96,2,571,2178,1607
51,96,3,62,1866,1804
51,96,4,771,2397,1626
51,96,5,114,2306,2192
51,96,6,197,2495,2298
51,97,0,751,2400,1649
51,97,1,636,2260,1624
51,97,2,1052,2590,1538
51,97,3,75,1727,1652
51,97,4,957,2514,1557
51,97,5,130,2141,2011
51,97,6,424,2232,1808
51,98,0,805,2464,1659
51,98,1,742,2373,1631
51,98,2,617,2109,1492
51,98,3,61,1754,1693
51,98,4,1077,2687,1610
51,98,5,199,2243,2044
51,98,6,664,2565,1901
51,99,0,713,2364,1651
51,99,1,415,2106,1691
51,99,2,707,2336,1629
51,99,3,81,1880,1799
51,99,4,1080,2775,1695
51,99,5,248,2373,2125
51,99,6,798,2654,1856
51,100,0,545,2201,1656
51,100,1,495,2198,1703
51,100,2,691,2333,1642
51,100,3,113,1943,1830
51,100,4,1118,2811,1693
51,100,5,228,2259,2031
51,100,6,765,2573,1808
51,101,0,799,2653,1854
51,101,1,751,2569,1818
51,101,2,789,2566,1777
51,101,3,382,2431,2049
51,101,4,1325,3147,1822
51,101,5,366,2580,2214
51,101,6,782,2738,1956
51,102,0,1902,3687,1785
51,102,1,1242,3325,2083
51,102,2,1438,3321,1883
51,102,3,1384,3514,2130
51,102,4,1891,3694,1803
51,102,5,473,2625,2152
51,102,6,590,2629,2039
51,103,0,1955,3486,1531
51,103,1,1306,3058,1752
51,103,2,1355,2978,1623
51,103,3,1596,3399,1803
51,103,4,2037,3616,1579
51,103,5,582,2768,2186
51,103,6,623,2604,1981
51,104,0,2271,3750,1479
51,104,1,1767,3483,1716
51,104,2,1827,3448,1621
51,104,3,1164,3017,1853
51,104,4,2087,3778,1691
51,104,5,618,2632,2014
51,104,6,473,2379,1906
51,105,0,2358,3825,1467
51,105,1,2534,4147,1613
51,105,2,2353,3940,1587
51,105,3,1772,3682,1910
51,105,4,2316,3915,1599
51,105,5,630,2776,2146
51,105,6,316,2162,1846
51,106,0,2013,3405,1392
51,106,1,2290,3885,1595
51,106,2,2057,3484,1427
51,106,3,1095,2709,1614
51,106,4,1784,3374,1590
51,106,5,327,2393,2066
51,106,6,140,1932,1792
51,107,0,1753,3183,1430
51,107,1,1767,3281,1514
51,107,2,1742,3201,1459
51,107,3,1064,2761,1697
51,107,4,1553,3304,1751
51,107,5,129,1920,1791
51,107,6,59,1751,1692
51,108,0,1460,3030,1570
51,108,1,1605,3258,1653
51,108,2,1757,3281,1524
51,108,3,945,2741,1796
51,108,4,1386,3197,1811
51,108,5,55,1824,1769
51,108,6,50,1673,1623
51,109,0,1044,2724,1680
51,109,1,849,2551,1702
51,109,2,1188,2707,1519
51,109,3,637,2364,1727
51,109,4,841,2688,1847
51,109,5,65,1823,1758
51,109,6,47,1645,1598
51,110,0,624,2374,1750
51,110,1,564,2369,1805
51,110,2,609,2062,1453
51,110,3,442,2207,1765
51,110,4,514,2327,1813
51,110,5,50,1629,1579
51,110,6,44,1403,1359
51,111,0,96,1741,1645
51,111,1,241,1980,1739
51,111,2,383,1829,1446
51,111,3,79,1672,1593
51,111,4,135,1922,1787
51,111,5,63,1760,1697
51,111,6,40,1537,1497
51,112,0,54,1592,1538
51,112,1,106,1692,1586
51,112,2,311,1725,1414
51,112,3,62,1593,1531
51,112,4,102,1851,1749
51,112,5,46,1688,1642
51,112,6,42,1538,1496
51,113,0,55,1549,1494
51,113,1,80,1603,1523
51,113,2,364,1765,1401
51,113,3,48,1454,1406
51,113,4,80,1643,1563
51,113,5,57,1654,1597
51,113,6,46,1549,1503
51,114,0,49,1387,1338
51,114,1,128,1614,1486
51,114,2,650,2070,1420
51,114,3,44,1436,1392
51,114,4,84,1645,1561
51,114,5,44,1554,1510
51,114,6,80,1632,1552
51,115,0,75,1471,1396
51,115,1,170,1647,1477
51,115,2,459,1883,1424
51,115,3,62,1536,1474
51,115,4,110,1686,1576
51,115,5,60,1569,1509
51,115,6,170,1575,1405
51,116,0,40,1399,1359
51,116,1,255,1599,1344
51,116,2,665,2126,1461
51,116,3,46,1473,1427
51,116,4,85,1689,1604
51,116,5,57,1477,1420
51,116,6,251,1798,1547
51,117,0,89,1483,1394
51,117,1,196,1623,1427
51,117,2,581,2000,1419
51,117,3,55,1479,1424
51,117,4,132,1724,1592
51,117,5,77,1577,1500
51,117,6,274,1734,1460
51,118,0,155,1542,1387
51,118,1,263,1627,1364
51,118,2,406,1893,1487
51,118,3,71,1468,1397
51,118,4,175,1814,1639
51,118,5,117,1650,1533
51,118,6,596,2025,1429
51,119,0,339,1701,1362
51,119,1,422,1849,1427
51,119,2,275,1879,1604
51,119,3,72,1553,1481
51,119,4,250,1815,1565
51,119,5,375,1874,1499
51,119,6,875,2269,1394
51,120,0,126,1738,1612
51,120,1,184,1904,1720
51,120,2,349,2083,1734
51,120,3,96,1842,1746
51,120,4,111,1950,1839
51,120,5,215,2096,1881
51,120,6,433,2213,1780
51,121,0,259,1791,1532
51,121,1,559,2091,1532
51,121,2,341,2138,1797
51,121,3,164,1687,1523
51,121,4,187,1982,1795
51,121,5,407,2193,1786
51,121,6,720,2293,1573
51,122,0,380,1913,1533
51,122,1,853,2532,1679
51,122,2,483,2237,1754
51,122,3,181,1821,1640
51,122,4,220,2092,1872
51,122,5,405,2250,1845
51,122,6,700,2238,1538
51,123,0,543,2000,1457
51,123,1,1021,2671,1650
51,123,2,825,2501,1676
51,123,3,272,1785,1513
51,123,4,290,2112,1822
51,123,5,469,2278,1809
51,123,6,904,2419,1515
51,124,0,656,2067,1411
51,124,1,878,2377,1499
51,124,2,986,2584,1598
51,124,3,461,1945,1484
51,124,4,534,2338,1804
51,124,5,678,2412,1734
51,124,6,843,2224,1381
51,125,0,959,2313,1354
51,125,1,1134,2608,1474
51,125,2,914,2474,1560
51,125,3,640,2073,1433
51,125,4,833,2631,1798
51,125,5,704,2382,1678
51,125,6,959,2330,1371
51,126,0,1217,2584,1367
51,126,1,1127,2600,1473
51,126,2,1015,2663,1648
51,126,3,832,2280,1448
51,126,4,1003,2701,1698
51,126,5,762,2471,1709
51,126,6,935,2239,1304
51,127,0,1246,2516,1270
51,127,1,1094,2425,1331
51,127,2,1407,2923,1516
51,127,3,947,2326,1379
51,127,4,996,2680,1684
51,127,5,1178,2928,1750
51,127,6,1080,2361,1281
51,128,0,1101,2317,1216
51,128,1,1301,2602,1301
51,128,2,1267,2740,1473
51,128,3,937,2201,1264
51,128,4,1074,2649,1575
51,128,5,983,2676,1693
51,128,6,903,2161,1258
51,129,0,1031,2167,1136
51,129,1,1257,2494,1237
51,129,2,1259,2685,1426
51,129,3,780,2032,1252
51,129,4,1038,2559,1521
51,129,5,798,2340,1542
51,129,6,1052,2281,1229
51,130,0,1114,2209,1095
51,130,1,1376,2592,1216
51,130,2,1243,2707,1464
51,130,3,1083,2328,1245
51,130,4,1036,2522,1486
51,130,5,968,2517,1549
51,130,6,1075,2272,1197
51,131,0,774,1883,1109
51,131,1,1134,2323,1189
51,131,2,958,2443,1485
51,131,3,846,2055,1209
51,131,4,928,2456,1528
51,131,5,1245,2648,1403
51,131,6,708,1952,1244
51,132,0,848,2014,1166
51,132,1,1093,2317,1224
51,132,2,789,2154,1365
51,132,3,913,2114,1201
51,132,4,1020,2566,1546
51,132,5,2082,3480,1398
51,132,6,848,2092,1244
51,133,0,700,1688,988
51,133,1,866,1985,1119
51,133,2,502,1749,1247
51,133,3,680,1765,1085
51,133,4,984,2380,1396
51,133,5,1960,3271,1311
51,133,6,729,1788,1059
51,134,0,309,1234,925
51,134,1,404,1400,996
51,134,2,150,1255,1105
51,134,3,245,1309,1064
51,134,4,696,2001,1305
51,134,5,1425,2650,1225
51,134,6,260,1270,1010
51,135,0,112,972,860
51,135,1,291,1168,877
51,135,2,57,1017,960
51,135,3,165,1017,852
51,135,4,622,1889,1267
51,135,5,1120,2311,1191
51,135,6,202,1112,910
51,136,0,40,806,766
51,136,1,196,1003,807
51,136,2,46,958,912
51,136,3,142,1016,874
51,136,4,445,1644,1199
51,136,5,778,1826,1048
51,136,6,266,1161,895
51,137,0,42,686,644
51,137,1,49,723,674
51,137,2,32,801,769
51,137,3,51,722,671
51,137,4,208,1296,1088
51,137,5,351,1339,988
51,137,6,250,987,737
51,138,0,32,592,560
51,138,1,54,685,631
51,138,2,32,709,677
51,138,3,60,721,661
51,138,4,125,1008,883
51,138,5,358,1211,853
51,138,6,286,916,630
51,139,0,48,566,518
51,139,1,54,627,573
51,139,2,27,577,550
51,139,3,102,680,578
51,139,4,152,980,828
51,139,5,454,1220,766
51,139,6,231,788,557
51,140,0,53,504,451
51,140,1,83,609,526
51,140,2,24,599,575
51,140,3,139,692,553
51,140,4,133,875,742
51,140,5,391,1093,702
51,140,6,192,707,515
51,141,0,147,655,508
51,141,1,175,703,528
51,141,2,91,698,607
51,141,3,231,755,524
51,141,4,204,890,686
51,141,5,454,1129,675
51,141,6,218,725,507
51,142,0,258,689,431
51,142,1,141,603,462
51,142,2,121,630,509
51,142,3,257,732,475
51,142,4,225,842,617
51,142,5,448,1121,673
51,142,6,200,658,458
51,143,0,164,527,363
51,143,1,209,644,435
51,143,2,162,599,437
51,143,3,284,685,401
51,143,4,224,769,545
51,143,5,362,906,544
51,143,6,184,606,422
52,0,1,1,1,0
52,0,2,0,1,1
52,0,6,1,1,0
52,1,1,1,1,0
52,1,4,0,1,1
52,1,5,0,1,1
52,1,6,1,2,1
52,2,0,0,2,2
52,2,2,1,1,0
52,3,3,3,4,1
52,4,5,0,1,1
52,5,4,1,1,0
52,6,1,0,1,1
52,6,2,2,2,0
52,6,5,0,1,1
52,6,6,1,2,1
52,7,0,1,2,1
52,10,0,0,1,1
52,10,1,1,1,0
52,10,6,0,1,1
52,11,1,0,2,2
52,13,1,2,2,0
52,14,0,1,1,0
52,15,6,0,1,1
52,16,0,4,4,0
52,17,0,1,2,1
52,19,0,1,1,0
52,19,1,0,1,1
52,21,0,1,1,0
52,21,6,0,1,1
52,25,1,1,1,0
52,31,5,1,1,0
52,33,5,0,1,1
52,36,0,0,1,1
52,37,0,1,2,1
52,37,3,1,1,0
52,37,5,1,2,1
52,37,6,1,1,0
52,38,0,1,1,0
52,38,1,0,1,1
52,38,2,0,1,1
52,38,6,3,4,1
52,39,0,0,2,2
52,39,1,0,1,1
52,39,3,0,1,1
52,39,4,0,1,1
52,40,0,0,2,2
52,40,1,0,2,2
52,40,2,0,2,2
52,40,3,0,1,1
52,40,4,1,3,2
52,40,6,0,2,2
52,41,0,1,2,1
52,41,1,3,5,2
52,41,2,0,2,2
52,41,3,1,2,1
52,41,5,2,4,2
52,42,0,0,1,1
52,42,1,0,5,5
52,42,2,0,5,5
52,42,3,0,7,7
52,42,4,0,1,1
52,42,5,0,1,1
52,43,0,2,4,2
52,43,1,0,5,5
52,43,2,0,5,5
52,43,3,1,5,4
52,43,4,0,4,4
52,43,5,2,3,1
52,43,6,0,2,2
52,44,0,5,10,5
52,44,1,2,7,5
52,44,2,1,5,4
52,44,3,1,9,8
52,44,4,0,5,5
52,44,5,0,1,1
52,44,6,2,2,0
52,45,0,9,15,6
52,45,1,1,11,10
52,45,2,2,15,13
52,45,3,0,5,5
52,45,4,2,13,11
52,45,5,0,1,1
52,45,6,0,2,2
52,46,0,2,7,5
52,46,1,0,3,3
52,46,2,3,10,7
52,46,3,1,4,3
52,46,4,0,6,6
52,46,5,0,4,4
52,46,6,1,2,1
52,47,0,1,7,6
52,47,1,4,12,8
52,47,2,0,3,3
52,47,3,1,7,6
52,47,4,0,5,5
52,47,5,0,6,6
52,47,6,2,2,0
52,48,0,2,7,5
52,48,1,6,19,13
52,48,2,1,10,9
52,48,3,2,11,9
52,48,4,2,6,4
52,48,5,0,4,4
52,48,6,1,5,4
52,49,0,4,9,5
52,49,1,0,7,7
52,49,2,0,8,8
52,49,3,5,10,5
52,49,4,0,8,8
52,49,5,0,4,4
52,49,6,5,6,1
52,50,0,5,13,8
52,50,1,6,17,11
52,50,2,0,7,7
52,50,3,0,7,7
52,50,4,0,12,12
52,50,5,0,5,5
52,50,6,0,2,2
52,51,0,6,18,12
52,51,1,6,12,6
52,51,2,2,11,9
52,51,3,0,8,8
52,51,4,2,7,5
52,51,5,7,9,2
52,51,6,0,1,1
52,52,0,3,8,5
52,52,1,5,14,9
52,52,2,2,8,6
52,52,3,5,12,7
52,52,4,3,9,6
52,52,5,2,4,2
52,52,6,0,3,3
52,53,0,1,5,4
52,53,1,0,6,6
52,53,2,1,5,4
52,53,3,1,6,5
52,53,4,2,7,5
52,53,5,1,2,1
52,53,6,4,7,3
52,54,0,0,2,2
52,54,1,0,2,2
52,54,2,5,8,3
52,54,3,1,2,1
52,54,4,4,7,3
52,54,5,0,1,1
52,54,6,2,4,2
52,55,0,0,5,5
52,55,1,1,7,6
52,55,2,4,7,3
52,55,3,2,3,1
52,55,4,1,3,2
52,55,5,0,3,3
52,55,6,0,5,5
52,56,0,4,11,7
52,56,1,1,6,5
52,56,2,6,12,6
52,56,3,4,9,5
52,56,4,1,4,3
52,56,5,1,7,6
52,56,6,0,5,5
52,57,0,3,4,1
52,57,1,3,5,2
52,57,2,5,9,4
52,57,3,6,8,2
52,57,4,0,2,2
52,57,5,2,5,3
52,57,6,0,2,2
52,58,1,3,7,4
52,58,2,2,7,5
52,58,3,2,4,2
52,58,4,0,2,2
52,58,5,2,7,5
52,58,6,0,3,3
52,59,0,4,9,5
52,59,1,2,4,2
52,59,2,0,4,4
52,59,3,4,9,5
52,59,4,0,4,4
52,59,5,3,7,4
52,59,6,1,3,2
52,60,0,2,3,1
52,60,1,2,5,3
52,60,2,0,4,4
52,60,3,2,6,4
52,60,4,1,6,5
52,60,5,3,9,6
52,60,6,2,9,7
52,61,0,1,5,4
52,61,1,1,3,2
52,61,2,1,7,6
52,61,3,1,3,2
52,61,4,8,11,3
52,61,5,0,2,2
52,61,6,7,11,4
52,62,0,0,1,1
52,62,1,0,3,3
52,62,2,2,3,1
52,62,3,3,8,5
52,62,4,1,5,4
52,62,5,0,7,7
52,62,6,0,5,5
52,63,0,1,3,2
52,63,1,0,1,1
52,63,2,4,4,0
52,63,3,0,4,4
52,63,4,0,1,1
52,63,5,5,8,3
52,64,0,1,2,1
52,64,1,0,2,2
52,64,2,1,2,1
52,64,3,3,3,0
52,64,4,1,3,2
52,64,5,4,7,3
52,64,6,1,3,2
52,65,0,2,5,3
52,65,1,1,1,0
52,65,2,4,5,1
52,65,3,3,5,2
52,65,4,1,6,5
52,65,5,1,10,9
52,65,6,7,12,5
52,66,0,0,5,5
52,66,1,0,3,3
52,66,2,1,5,4
52,66,3,1,2,1
52,66,4,0,2,2
52,66,5,0,6,6
52,66,6,1,3,2
52,67,0,4,7,3
52,67,1,0,2,2
52,67,2,0,1,1
52,67,3,1,2,1
52,67,4,1,2,1
52,67,5,0,2,2
52,67,6,0,4,4
52,68,0,1,1,0
52,68,1,1,3,2
52,68,2,0,3,3
52,68,3,2,3,1
52,68,4,2,4,2
52,68,5,1,3,2
52,68,6,0,5,5
52,69,0,3,5,2
52,69,1,2,2,0
52,69,2,1,3,2
52,69,3,1,2,1
52,69,4,1,3,2
52,69,5,0,3,3
52,69,6,1,2,1
52,70,1,1,2,1
52,70,2,3,7,4
52,70,3,4,8,4
52,70,4,1,4,3
52,70,5,0,2,2
52,70,6,2,4,2
52,71,0,0,2,2
52,71,1,4,5,1
52,71,2,2,5,3
52,71,3,3,9,6
52,71,4,1,2,1
52,71,5,1,3,2
52,71,6,1,5,4
52,72,0,1,4,3
52,72,1,0,2,2
52,72,2,6,11,5
52,72,3,2,4,2
52,72,4,5,7,2
52,72,5,1,5,4
52,72,6,3,6,3
52,73,0,0,2,2
52,73,1,1,4,3
52,73,2,0,1,1
52,73,3,3,7,4
52,73,4,4,8,4
52,73,5,0,6,6
52,73,6,7,12,5
52,74,0,4,7,3
52,74,1,2,5,3
52,74,2,1,5,4
52,74,3,3,7,4
52,74,4,0,4,4
52,74,5,3,7,4
52,74,6,3,11,8
52,75,0,4,7,3
52,75,1,2,6,4
52,75,2,3,6,3
52,75,3,2,7,5
52,75,4,2,8,6
52,75,5,0,10,10
52,75,6,8,16,8
52,76,0,0,3,3
52,76,1,0,3,3
52,76,2,1,3,2
52,76,3,1,4,3
52,76,4,0,5,5
52,76,5,2,4,2
52,76,6,0,5,5
52,77,0,5,7,2
52,77,1,5,14,9
52,77,2,2,4,2
52,77,3,0,4,4
52,77,4,2,8,6
52,77,5,0,4,4
52,77,6,8,12,4
52,78,0,0,1,1
52,78,1,0,1,1
52,78,2,1,2,1
52,78,3,3,8,5
52,78,4,2,4,2
52,78,5,1,7,6
52,78,6,1,4,3
52,79,0,2,4,2
52,79,1,1,2,1
52,79,2,1,2,1
52,79,3,3,8,5
52,79,4,1,5,4
52,79,5,1,5,4
52,79,6,2,11,9
52,80,0,0,1,1
52,80,1,2,5,3
52,80,2,0,2,2
52,80,3,3,6,3
52,80,4,1,5,4
52,80,5,2,4,2
52,80,6,6,9,3
52,81,0,4,5,1
52,81,1,0,2,2
52,81,2,0,1,1
52,81,3,6,10,4
52,81,4,4,6,2
52,81,5,1,4,3
52,81,6,8,14,6
52,82,0,3,6,3
52,82,1,2,4,2
52,82,2,1,3,2
52,82,3,2,4,2
52,82,4,1,3,2
52,82,5,0,3,3
52,82,6,5,11,6
52,83,0,0,3,3
52,83,1,1,2,1
52,83,2,0,4,4
52,83,3,1,3,2
52,83,4,0,2,2
52,83,5,1,3,2
52,83,6,2,3,1
52,84,0,2,3,1
52,84,1,0,3,3
52,84,2,1,3,2
52,84,3,4,7,3
52,84,4,3,8,5
52,84,5,1,5,4
52,84,6,7,11,4
52,85,0,0,1,1
52,85,1,0,3,3
52,85,2,2,3,1
52,85,3,2,5,3
52,85,4,2,4,2
52,85,5,0,1,1
52,85,6,6,9,3
52,86,0,3,4,1
52,86,1,1,1,0
52,86,2,0,4,4
52,86,3,1,5,4
52,86,4,1,5,4
52,86,5,0,2,2
52,86,6,3,5,2
52,87,0,0,4,4
52,87,1,3,4,1
52,87,2,3,5,2
52,87,3,1,2,1
52,87,4,5,8,3
52,87,5,0,5,5
52,87,6,1,3,2
52,88,0,3,5,2
52,88,1,1,2,1
52,88,2,1,3,2
52,88,3,0,3,3
52,88,4,0,2,2
52,88,5,0,2,2
52,88,6,1,4,3
52,89,0,0,1,1
52,89,1,1,3,2
52,89,2,0,2,2
52,89,3,0,1,1
52,89,4,3,4,1
52,89,5,2,6,4
52,89,6,0,4,4
52,90,0,1,2,1
52,90,1,2,3,1
52,90,2,1,2,1
52,90,3,1,4,3
52,90,4,0,1,1
52,90,5,1,7,6
52,90,6,0,2,2
52,91,0,5,7,2
52,91,1,5,11,6
52,91,2,3,6,3
52,91,3,6,9,3
52,91,4,0,2,2
52,91,5,2,6,4
52,91,6,3,10,7
52,92,0,0,2,2
52,92,2,2,6,4
52,92,3,2,6,4
52,92,4,2,5,3
52,92,5,0,6,6
52,92,6,1,3,2
52,93,0,2,5,3
52,93,2,0,6,6
52,93,3,0,1,1
52,93,4,0,4,4
52,93,5,0,3,3
52,93,6,1,5,4
52,94,0,0,2,2
52,94,1,0,2,2
52,94,2,0,2,2
52,94,3,0,3,3
52,94,4,0,5,5
52,94,5,1,9,8
52,94,6,0,4,4
52,95,0,0,2,2
52,95,1,2,3,1
52,95,2,0,6,6
52,95,3,1,6,5
52,95,4,2,6,4
52,95,5,0,4,4
52,95,6,0,4,4
52,96,0,0,2,2
52,96,1,1,5,4
52,96,2,0,4,4
52,96,3,1,6,5
52,96,4,1,7,6
52,96,5,0,7,7
52,96,6,0,6,6
52,97,0,1,4,3
52,97,1,0,3,3
52,97,2,0,2,2
52,97,3,1,3,2
52,97,4,1,6,5
52,97,5,1,5,4
52,97,6,0,5,5
52,98,0,0,6,6
52,98,1,0,8,8
52,98,2,1,6,5
52,98,3,1,7,6
52,98,4,2,4,2
52,98,5,0,10,10
52,98,6,0,8,8
52,99,0,0,3,3
52,99,1,0,2,2
52,99,2,0,3,3
52,99,3,0,5,5
52,99,4,0,6,6
52,99,5,1,8,7
52,99,6,1,6,5
52,100,0,1,7,6
52,100,1,2,6,4
52,100,2,1,2,1
52,100,3,0,7,7
52,100,4,0,5,5
52,100,5,0,8,8
52,100,6,0,6,6
52,101,0,3,6,3
52,101,1,0,5,5
52,101,2,0,2,2
52,101,3,1,3,2
52,101,4,0,3,3
52,101,5,0,3,3
52,101,6,0,5,5
52,102,0,0,6,6
52,102,1,0,1,1
52,102,2,1,5,4
52,102,3,0,4,4
52,102,4,1,4,3
52,102,5,0,5,5
52,102,6,1,7,6
52,103,0,1,5,4
52,103,1,0,5,5
52,103,2,1,3,2
52,103,3,0,4,4
52,103,4,0,6,6
52,103,5,1,13,12
52,103,6,0,4,4
52,104,0,0,8,8
52,104,1,2,4,2
52,104,2,0,4,4
52,104,3,0,2,2
52,104,4,2,9,7
52,104,5,1,4,3
52,104,6,0,8,8
52,105,0,1,4,3
52,105,1,0,1,1
52,105,2,0,3,3
52,105,3,0,5,5
52,105,4,0,5,5
52,105,5,0,6,6
52,105,6,3,9,6
52,106,0,0,3,3
52,106,1,1,4,3
52,106,2,0,4,4
52,106,3,0,5,5
52,106,4,0,3,3
52,106,5,0,5,5
52,106,6,0,6,6
52,107,0,0,3,3
52,107,1,0,6,6
52,107,2,0,4,4
52,107,3,0,2,2
52,107,4,1,10,9
52,107,5,0,2,2
52,107,6,3,6,3
52,108,0,0,5,5
52,108,1,8,14,6
52,108,2,1,6,5
52,108,3,2,6,4
52,108,4,3,8,5
52,108,5,2,15,13
52,108,6,0,5,5
52,109,0,0,6,6
52,109,1,2,12,10
52,109,2,2,6,4
52,109,3,3,6,3
52,109,4,0,8,8
52,109,5,6,13,7
52,109,6,1,8,7
52,110,0,2,7,5
52,110,1,0,6,6
52,110,2,0,1,1
52,110,3,1,6,5
52,110,4,4,10,6
52,110,5,9,13,4
52,110,6,1,8,7
52,111,0,0,6,6
52,111,1,0,7,7
52,111,2,2,8,6
52,111,3,1,1,0
52,111,4,0,2,2
52,111,5,0,2,2
52,111,6,0,5,5
52,112,0,2,6,4
52,112,1,0,4,4
52,112,2,0,9,9
52,112,3,0,6,6
52,112,4,0,4,4
52,112,5,0,11,11
52,112,6,0,10,10
52,113,1,0,4,4
52,113,2,0,5,5
52,113,3,0,3,3
52,113,4,0,3,3
52,113,5,1,7,6
52,113,6,1,5,4
52,114,0,0,3,3
52,114,1,0,2,2
52,114,2,0,1,1
52,114,3,5,6,1
52,114,4,0,5,5
52,114,5,0,1,1
52,114,6,1,3,2
52,115,0,0,2,2
52,115,1,0,3,3
52,115,2,1,5,4
52,115,3,0,2,2
52,115,4,0,1,1
52,115,6,2,2,0
52,116,0,0,2,2
52,116,2,1,3,2
52,116,3,0,1,1
52,116,4,1,6,5
52,116,5,0,4,4
52,116,6,1,5,4
52,117,0,0,1,1
52,117,1,0,2,2
52,117,2,0,3,3
52,117,3,3,4,1
52,117,4,0,4,4
52,117,5,1,5,4
52,117,6,1,3,2
52,118,0,0,2,2
52,118,1,1,6,5
52,118,2,0,6,6
52,118,3,2,5,3
52,118,4,4,10,6
52,118,5,0,2,2
52,118,6,0,2,2
52,119,0,0,4,4
52,119,1,0,1,1
52,119,2,0,4,4
52,119,3,1,4,3
52,119,4,4,5,1
52,119,5,1,7,6
52,119,6,0,2,2
52,120,0,0,2,2
52,120,1,1,5,4
52,120,2,0,5,5
52,120,3,0,2,2
52,120,4,0,5,5
52,120,5,0,3,3
52,120,6,0,1,1
52,121,0,0,3,3
52,121,1,0,5,5
52,121,2,0,3,3
52,121,3,0,3,3
52,121,4,0,4,4
52,121,5,0,4,4
52,121,6,0,5,5
52,122,0,0,1,1
52,122,1,0,2,2
52,122,2,1,5,4
52,122,3,0,3,3
52,122,4,0,5,5
52,122,5,0,5,5
52,122,6,0,5,5
52,123,0,0,3,3
52,123,1,0,5,5
52,123,2,4,6,2
52,123,3,1,3,2
52,123,4,0,2,2
52,123,5,2,2,0
52,123,6,0,1,1
52,124,0,2,5,3
52,124,2,0,3,3
52,124,4,0,2,2
52,124,5,1,3,2
52,124,6,0,2,2
52,125,0,1,5,4
52,125,1,0,5,5
52,125,2,0,2,2
52,125,3,0,2,2
52,125,4,0,2,2
52,125,5,1,3,2
52,126,0,0,3,3
52,126,1,0,3,3
52,126,2,0,2,2
52,126,3,0,4,4
52,126,4,1,4,3
52,126,5,1,4,3
52,126,6,0,2,2
52,127,0,1,7,6
52,127,1,2,3,1
52,127,2,0,2,2
52,127,3,0,3,3
52,127,4,0,1,1
52,127,5,1,4,3
52,127,6,1,3,2
52,128,0,0,5,5
52,128,1,1,4,3
52,128,2,1,5,4
52,128,3,0,2,2
52,128,4,0,1,1
52,128,5,1,6,5
52,128,6,0,1,1
52,129,0,1,4,3
52,129,1,0,3,3
52,129,2,0,2,2
52,129,3,0,2,2
52,129,5,2,5,3
52,129,6,0,6,6
52,130,0,2,3,1
52,130,1,0,3,3
52,130,2,2,6,4
52,130,3,0,1,1
52,130,4,0,1,1
52,130,5,1,3,2
52,130,6,0,2,2
52,131,0,0,1,1
52,131,1,0,1,1
52,131,2,0,3,3
52,131,3,3,4,1
52,131,4,0,2,2
52,131,5,2,2,0
52,131,6,0,5,5
52,132,0,0,3,3
52,132,2,0,3,3
52,132,3,0,2,2
52,132,4,0,1,1
52,132,5,4,5,1
52,132,6,0,1,1
52,133,1,2,6,4
52,133,2,2,4,2
52,133,3,1,4,3
52,133,4,1,4,3
52,133,5,0,2,2
52,133,6,0,2,2
52,134,0,1,4,3
52,134,1,0,3,3
52,134,2,0,2,2
52,134,4,1,3,2
52,134,5,0,1,1
52,134,6,0,1,1
52,135,0,2,4,2
52,135,1,1,1,0
52,135,2,0,1,1
52,135,3,3,6,3
52,135,4,0,2,2
52,135,5,0,2,2
52,135,6,2,3,1
52,136,1,0,3,3
52,136,2,1,4,3
52,136,4,0,1,1
52,136,6,0,1,1
52,137,0,1,1,0
52,137,2,1,1,0
52,137,3,0,1,1
52,137,4,0,1,1
52,137,6,2,3,1
52,138,2,3,3,0
52,138,3,2,3,1
52,138,4,1,2,1
52,138,5,1,3,2
52,138,6,1,1,0
52,139,1,0,1,1
52,139,2,0,1,1
52,139,3,0,1,1
52,139,5,0,1,1
52,139,6,2,2,0
52,140,0,0,1,1
52,140,1,1,2,1
52,140,2,0,1,1
52,140,6,0,1,1
52,141,0,1,1,0
52,141,1,0,1,1
52,141,2,0,1,1
52,141,3,1,1,0
52,142,1,1,1,0
52,142,2,5,5,0
52,142,3,0,1,1
52,142,6,1,1,0
52,143,0,1,1,0
52,143,4,1,3,2
52,143,5,2,3,1
52,143,6,0,1,1
53,0,0,2,16,14
53,0,1,0,2,2
53,0,2,1,12,11
53,0,3,0,6,6
53,0,4,1,9,8
53,0,5,1,11,10
53,0,6,0,10,10
53,1,0,4,8,4
53,1,1,1,11,10
53,1,2,3,17,14
53,1,3,0,12,12
53,1,4,2,7,5
53,1,5,3,13,10
53,1,6,0,11,11
53,2,0,4,8,4
53,2,1,1,6,5
53,2,3,2,10,8
53,2,4,0,4,4
53,2,5,0,5,5
53,2,6,2,12,10
53,3,0,0,3,3
53,3,1,0,4,4
53,3,2,0,4,4
53,3,3,2,6,4
53,3,4,4,16,12
53,3,5,0,11,11
53,3,6,1,13,12
53,4,0,2,3,1
53,4,1,1,2,1
53,4,2,0,1,1
53,4,3,0,1,1
53,4,4,1,5,4
53,4,5,0,1,1
53,4,6,0,3,3
53,5,0,1,2,1
53,5,1,1,3,2
53,5,2,0,3,3
53,5,3,0,1,1
53,5,4,2,9,7
53,5,5,0,2,2
53,5,6,3,11,8
53,6,0,0,2,2
53,6,1,1,4,3
53,6,2,0,1,1
53,6,3,0,1,1
53,6,4,0,7,7
53,6,5,0,3,3
53,6,6,0,1,1
53,7,0,0,3,3
53,7,1,1,6,5
53,7,2,2,7,5
53,7,3,0,1,1
53,7,4,3,8,5
53,7,5,0,1,1
53,8,0,1,3,2
53,8,1,2,6,4
53,8,2,1,4,3
53,8,3,1,2,1
53,8,4,0,5,5
53,8,5,0,3,3
53,8,6,4,8,4
53,9,0,3,5,2
53,9,1,1,5,4
53,9,3,0,2,2
53,9,4,0,2,2
53,9,5,0,2,2
53,9,6,1,6,5
53,10,0,0,2,2
53,10,1,0,4,4
53,10,4,2,6,4
53,10,5,0,4,4
53,10,6,0,1,1
53,11,0,1,3,2
53,11,1,0,1,1
53,11,3,1,1,0
53,11,4,0,2,2
53,11,5,1,2,1
53,11,6,1,3,2
53,12,0,3,4,1
53,12,3,2,2,0
53,12,4,0,2,2
53,12,5,0,1,1
53,12,6,2,4,2
53,13,0,0,2,2
53,13,1,0,2,2
53,13,3,2,3,1
53,13,4,0,1,1
53,13,5,1,2,1
53,13,6,1,3,2
53,14,0,2,3,1
53,14,1,1,1,0
53,14,2,1,1,0
53,14,3,2,4,2
53,14,5,2,3,1
53,14,6,0,3,3
53,15,0,2,3,1
53,15,1,0,2,2
53,15,3,0,1,1
53,15,4,0,1,1
53,15,5,1,2,1
53,15,6,3,4,1
53,16,0,0,1,1
53,16,1,1,2,1
53,16,2,0,1,1
53,16,3,1,1,0
53,16,4,1,6,5
53,16,6,1,1,0
53,17,0,1,2,1
53,17,4,2,4,2
53,17,5,1,1,0
53,17,6,0,1,1
53,18,0,1,2,1
53,18,1,1,1,0
53,18,4,0,2,2
53,18,5,0,1,1
53,18,6,1,1,0
53,19,1,0,1,1
53,19,4,1,2,1
53,19,5,0,1,1
53,20,6,1,2,1
53,21,6,0,2,2
53,22,1,0,1,1
53,22,4,0,1,1
53,22,6,0,1,1
53,23,6,0,1,1
53,24,1,1,1,0
53,24,4,3,6,3
53,25,0,0,1,1
53,25,1,0,1,1
53,25,2,0,1,1
53,25,5,2,3,1
53,25,6,3,4,1
53,26,3,0,1,1
53,26,5,4,5,1
53,26,6,1,1,0
53,27,4,3,5,2
53,28,0,2,2,0
53,28,4,1,2,1
53,28,5,3,3,0
53,29,3,2,2,0
53,30,4,0,1,1
53,31,1,2,2,0
53,31,2,0,1,1
53,31,5,1,2,1
53,31,6,1,1,0
53,32,0,2,2,0
53,32,1,1,4,3
53,32,5,0,1,1
53,32,6,1,1,0
53,33,0,1,1,0
53,33,4,1,2,1
53,34,1,1,2,1
53,34,3,1,2,1
53,34,4,2,2,0
53,34,5,0,1,1
53,34,6,1,2,1
53,35,0,0,1,1
53,35,2,2,2,0
53,35,4,1,1,0
53,36,0,0,1,1
53,36,1,2,2,0
53,36,2,1,1,0
53,36,3,3,3,0
53,36,4,5,7,2
53,36,5,1,1,0
53,37,0,2,4,2
53,37,1,1,1,0
53,37,2,1,2,1
53,37,3,0,2,2
53,37,4,4,8,4
53,37,5,3,5,2
53,38,0,0,2,2
53,38,1,1,3,2
53,38,2,4,9,5
53,38,3,3,4,1
53,38,4,4,4,0
53,38,6,3,5,2
53,39,0,0,8,8
53,39,1,1,13,12
53,39,2,1,10,9
53,39,3,2,6,4
53,39,4,5,7,2
53,39,5,1,6,5
53,39,6,0,4,4
53,40,0,0,15,15
53,40,1,0,8,8
53,40,2,1,12,11
53,40,3,0,12,12
53,40,4,9,23,14
53,40,5,0,1,1
53,40,6,0,5,5
53,41,0,2,18,16
53,41,1,1,11,10
53,41,2,2,16,14
53,41,3,1,14,13
53,41,4,10,28,18
53,41,5,3,6,3
53,41,6,6,14,8
53,42,0,0,17,17
53,42,1,1,8,7
53,42,2,5,26,21
53,42,3,1,21,20
53,42,4,0,12,12
53,42,5,0,6,6
53,42,6,8,15,7
53,43,0,1,37,36
53,43,1,0,28,28
53,43,2,5,29,24
53,43,3,1,36,35
53,43,4,2,17,15
53,43,5,1,10,9
53,43,6,2,9,7
53,44,0,3,40,37
53,44,1,1,28,27
53,44,2,1,36,35
53,44,3,0,29,29
53,44,4,2,27,25
53,44,5,0,10,10
53,44,6,4,18,14
53,45,0,4,61,57
53,45,1,2,56,54
53,45,2,3,54,51
53,45,3,3,45,42
53,45,4,9,47,38
53,45,5,2,23,21
53,45,6,4,15,11
53,46,0,12,79,67
53,46,1,2,60,58
53,46,2,3,58,55
53,46,3,5,57,52
53,46,4,7,42,35
53,46,5,2,37,35
53,46,6,6,20,14
53,47,0,10,80,70
53,47,1,3,68,65
53,47,2,5,69,64
53,47,3,3,73,70
53,47,4,8,67,59
53,47,5,3,33,30
53,47,6,3,22,19
53,48,0,8,89,81
53,48,1,8,102,94
53,48,2,19,96,77
53,48,3,17,95,78
53,48,4,8,68,60
53,48,5,9,47,38
53,48,6,2,24,22
53,49,0,37,111,74
53,49,1,26,106,80
53,49,2,26,111,85
53,49,3,23,112,89
53,49,4,3,63,60
53,49,5,2,27,25
53,49,6,1,27,26
53,50,0,54,145,91
53,50,1,48,134,86
53,50,2,41,133,92
53,50,3,27,120,93
53,50,4,29,84,55
53,50,5,5,33,28
53,50,6,3,40,37
53,51,0,86,153,67
53,51,1,124,197,73
53,51,2,89,179,90
53,51,3,57,149,92
53,51,4,43,113,70
53,51,5,2,36,34
53,51,6,2,34,32
53,52,0,89,163,74
53,52,1,96,177,81
53,52,2,67,158,91
53,52,3,55,143,88
53,52,4,39,113,74
53,52,5,5,42,37
53,52,6,4,38,34
53,53,0,52,113,61
53,53,1,66,140,74
53,53,2,44,131,87
53,53,3,37,119,82
53,53,4,36,94,58
53,53,5,5,43,38
53,53,6,0,30,30
53,54,0,65,131,66
53,54,1,43,103,60
53,54,2,32,92,60
53,54,3,22,94,72
53,54,4,45,111,66
53,54,5,2,35,33
53,54,6,0,30,30
53,55,0,62,115,53
53,55,1,45,104,59
53,55,2,50,114,64
53,55,3,61,142,81
53,55,4,27,74,47
53,55,5,0,36,36
53,55,6,1,36,35
53,56,0,46,94,48
53,56,1,54,102,48
53,56,2,41,90,49
53,56,3,70,124,54
53,56,4,35,80,45
53,56,5,1,35,34
53,56,6,0,24,24
53,57,0,51,75,24
53,57,1,46,87,41
53,57,2,46,76,30
53,57,3,54,96,42
53,57,4,35,70,35
53,57,5,3,49,46
53,57,6,1,32,31
53,58,0,41,74,33
53,58,1,38,78,40
53,58,2,75,103,28
53,58,3,23,67,44
53,58,4,36,63,27
53,58,5,2,42,40
53,58,6,0,26,26
53,59,0,39,71,32
53,59,1,34,68,34
53,59,2,36,75,39
53,59,3,22,56,34
53,59,4,27,67,40
53,59,5,6,50,44
53,59,6,2,39,37
53,60,0,9,44,35
53,60,1,28,65,37
53,60,2,19,58,39
53,60,3,22,63,41
53,60,4,15,44,29
53,60,5,4,45,41
53,60,6,4,25,21
53,61,0,7,36,29
53,61,1,8,41,33
53,61,2,3,41,38
53,61,3,6,45,39
53,61,4,20,57,37
53,61,5,5,47,42
53,61,6,1,34,33
53,62,0,6,32,26
53,62,1,5,29,24
53,62,2,4,34,30
53,62,3,12,34,22
53,62,4,12,41,29
53,62,5,3,33,30
53,62,6,2,27,25
53,63,0,5,30,25
53,63,1,3,37,34
53,63,2,1,26,25
53,63,3,7,43,36
53,63,4,26,60,34
53,63,5,12,38,26
53,63,6,6,50,44
53,64,0,2,33,31
53,64,1,1,25,24
53,64,2,1,27,26
53,64,3,2,25,23
53,64,4,17,38,21
53,64,5,12,43,31
53,64,6,5,27,22
53,65,0,4,35,31
53,65,1,2,35,33
53,65,2,1,31,30
53,65,3,0,32,32
53,65,4,12,37,25
53,65,5,3,28,25
53,65,6,6,41,35
53,66,0,3,33,30
53,66,1,4,44,40
53,66,2,2,28,26
53,66,3,3,29,26
53,66,4,16,44,28
53,66,5,8,46,38
53,66,6,4,41,37
53,67,0,1,29,28
53,67,1,6,28,22
53,67,2,3,23,20
53,67,3,7,29,22
53,67,4,10,39,29
53,67,5,4,46,42
53,67,6,11,42,31
53,68,0,1,25,24
53,68,1,1,21,20
53,68,2,2,27,25
53,68,3,3,41,38
53,68,4,27,64,37
53,68,5,5,37,32
53,68,6,8,38,30
53,69,0,0,14,14
53,69,1,3,32,29
53,69,2,5,37,32
53,69,3,4,38,34
53,69,4,5,25,20
53,69,5,7,31,24
53,69,6,1,31,30
53,70,0,5,32,27
53,70,1,1,25,24
53,70,2,8,33,25
53,70,3,5,40,35
53,70,4,8,48,40
53,70,5,14,46,32
53,70,6,5,38,33
53,71,0,11,44,33
53,71,1,3,41,38
53,71,2,8,42,34
53,71,3,8,52,44
53,71,4,14,50,36
53,71,5,3,39,36
53,71,6,5,40,35
53,72,0,8,43,35
53,72,1,7,42,35
53,72,2,4,40,36
53,72,3,2,30,28
53,72,4,24,53,29
53,72,5,1,24,23
53,72,6,1,30,29
53,73,0,5,39,34
53,73,1,10,50,40
53,73,2,3,23,20
53,73,3,3,33,30
53,73,4,6,38,32
53,73,5,5,43,38
53,73,6,4,47,43
53,74,0,4,33,29
53,74,1,4,44,40
53,74,2,3,34,31
53,74,3,4,34,30
53,74,4,17,51,34
53,74,5,6,39,33
53,74,6,8,39,31
53,75,0,2,26,24
53,75,1,11,38,27
53,75,2,2,40,38
53,75,3,7,30,23
53,75,4,26,70,44
53,75,5,19,55,36
53,75,6,6,39,33
53,76,0,4,33,29
53,76,1,9,28,19
53,76,2,3,39,36
53,76,3,3,35,32
53,76,4,7,39,32
53,76,5,20,59,39
53,76,6,1,45,44
53,77,0,2,22,20
53,77,1,8,50,42
53,77,2,13,40,27
53,77,3,0,26,26
53,77,4,19,62,43
53,77,5,22,53,31
53,77,6,5,34,29
53,78,0,2,30,28
53,78,1,9,36,27
53,78,2,8,38,30
53,78,3,0,28,28
53,78,4,23,63,40
53,78,5,22,62,40
53,78,6,6,39,33
53,79,0,1,24,23
53,79,1,6,35,29
53,79,2,6,46,40
53,79,3,7,43,36
53,79,4,14,52,38
53,79,5,19,54,35
53,79,6,5,46,41
53,80,0,4,30,26
53,80,1,8,36,28
53,80,2,4,37,33
53,80,3,7,46,39
53,80,4,11,39,28
53,80,5,19,51,32
53,80,6,10,47,37
53,81,0,8,37,29
53,81,1,3,30,27
53,81,2,3,30,27
53,81,3,3,41,38
53,81,4,11,45,34
53,81,5,12,39,27
53,81,6,12,46,34
53,82,0,4,29,25
53,82,1,11,41,30
53,82,2,0,26,26
53,82,3,0,25,25
53,82,4,8,36,28
53,82,5,17,53,36
53,82,6,8,65,57
53,83,0,2,19,17
53,83,1,1,31,30
53,83,2,7,30,23
53,83,3,1,27,26
53,83,4,9,33,24
53,83,5,10,38,28
53,83,6,6,44,38
53,84,0,2,27,25
53,84,1,5,27,22
53,84,2,2,29,27
53,84,3,2,37,35
53,84,4,10,45,35
53,84,5,6,37,31
53,84,6,5,39,34
53,85,0,2,18,16
53,85,1,0,24,24
53,85,2,3,25,22
53,85,3,1,31,30
53,85,4,9,28,19
53,85,5,4,41,37
53,85,6,5,44,39
53,86,0,2,26,24
53,86,1,4,24,20
53,86,2,2,21,19
53,86,3,0,21,21
53,86,4,8,48,40
53,86,5,4,30,26
53,86,6,7,42,35
53,87,0,2,32,30
53,87,1,2,29,27
53,87,2,8,33,25
53,87,3,0,29,29
53,87,4,10,41,31
53,87,5,6,43,37
53,87,6,4,36,32
53,88,0,3,27,24
53,88,1,1,35,34
53,88,2,4,30,26
53,88,3,1,21,20
53,88,4,14,49,35
53,88,5,1,38,37
53,88,6,0,37,37
53,89,0,1,24,23
53,89,1,0,26,26
53,89,2,7,32,25
53,89,3,4,50,46
53,89,4,3,40,37
53,89,5,3,37,34
53,89,6,4,30,26
53,90,0,0,28,28
53,90,1,2,28,26
53,90,2,5,38,33
53,90,3,11,49,38
53,90,4,14,55,41
53,90,5,5,36,31
53,90,6,6,41,35
53,91,0,3,22,19
53,91,1,5,25,20
53,91,2,4,31,27
53,91,3,2,23,21
53,91,4,6,36,30
53,91,5,4,30,26
53,91,6,1,35,34
53,92,0,14,47,33
53,92,1,5,36,31
53,92,2,8,49,41
53,92,3,2,29,27
53,92,4,3,33,30
53,92,5,3,44,41
53,92,6,0,34,34
53,93,0,0,38,38
53,93,1,0,34,34
53,93,2,2,33,31
53,93,3,2,27,25
53,93,4,1,34,33
53,93,5,2,33,31
53,93,6,3,31,28
53,94,0,1,26,25
53,94,1,1,29,28
53,94,2,3,28,25
53,94,3,3,35,32
53,94,4,0,31,31
53,94,5,1,28,27
53,94,6,1,34,33
53,95,0,2,39,37
53,95,1,1,37,36
53,95,2,1,32,31
53,95,3,1,41,40
53,95,4,0,27,27
53,95,5,5,44,39
53,95,6,5,26,21
53,96,0,3,28,25
53,96,1,0,38,38
53,96,2,4,36,32
53,96,3,1,33,32
53,96,4,0,32,32
53,96,5,2,48,46
53,96,6,3,45,42
53,97,0,3,35,32
53,97,1,0,31,31
53,97,2,1,26,25
53,97,3,2,32,30
53,97,4,0,24,24
53,97,5,0,37,37
53,97,6,1,35,34
53,98,0,1,32,31
53,98,1,1,36,35
53,98,2,3,36,33
53,98,3,2,49,47
53,98,4,0,35,35
53,98,5,3,34,31
53,98,6,4,56,52
53,99,0,5,41,36
53,99,1,2,31,29
53,99,2,1,53,52
53,99,3,0,46,46
53,99,4,3,37,34
53,99,5,3,42,39
53,99,6,1,33,32
53,100,0,0,44,44
53,100,1,0,32,32
53,100,2,0,50,50
53,100,3,1,44,43
53,100,4,3,38,35
53,100,5,3,36,33
53,100,6,0,37,37
53,101,0,0,45,45
53,101,1,3,46,43
53,101,2,4,53,49
53,101,3,2,65,63
53,101,4,1,55,54
53,101,5,3,53,50
53,101,6,1,38,37
53,102,0,1,60,59
53,102,1,2,90,88
53,102,2,7,93,86
53,102,3,4,81,77
53,102,4,0,58,58
53,102,5,1,44,43
53,102,6,0,46,46
53,103,0,5,54,49
53,103,1,6,76,70
53,103,2,2,56,54
53,103,3,1,70,69
53,103,4,6,67,61
53,103,5,2,54,52
53,103,6,1,42,41
53,104,0,2,51,49
53,104,1,5,77,72
53,104,2,3,61,58
53,104,3,2,70,68
53,104,4,0,76,76
53,104,5,5,49,44
53,104,6,1,41,40
53,105,0,2,92,90
53,105,1,7,84,77
53,105,2,8,120,112
53,105,3,5,125,120
53,105,4,7,97,90
53,105,5,2,54,52
53,105,6,1,58,57
53,106,0,1,82,81
53,106,1,6,93,87
53,106,2,19,84,65
53,106,3,7,93,86
53,106,4,4,81,77
53,106,5,0,49,49
53,106,6,3,50,47
53,107,0,3,79,76
53,107,1,0,65,65
53,107,2,11,78,67
53,107,3,4,83,79
53,107,4,1,76,75
53,107,5,1,28,27
53,107,6,2,38,36
53,108,0,1,104,103
53,108,1,1,106,105
53,108,2,7,113,106
53,108,3,6,104,98
53,108,4,9,98,89
53,108,5,1,57,56
53,108,6,1,53,52
53,109,0,1,91,90
53,109,1,6,97,91
53,109,2,5,78,73
53,109,3,5,91,86
53,109,4,1,68,67
53,109,5,3,50,47
53,109,6,1,32,31
53,110,0,1,80,79
53,110,1,0,65,65
53,110,2,9,89,80
53,110,3,7,85,78
53,110,4,2,65,63
53,110,5,10,48,38
53,110,6,1,44,43
53,111,0,1,72,71
53,111,1,2,93,91
53,111,2,9,81,72
53,111,3,4,88,84
53,111,4,4,67,63
53,111,5,3,64,61
53,111,6,1,38,37
53,112,0,2,59,57
53,112,1,2,55,53
53,112,2,2,69,67
53,112,3,2,58,56
53,112,4,8,65,57
53,112,5,6,50,44
53,112,6,0,35,35
53,113,0,2,67,65
53,113,1,4,56,52
53,113,2,5,56,51
53,113,3,2,67,65
53,113,4,3,49,46
53,113,5,3,33,30
53,113,6,1,35,34
53,114,0,10,50,40
53,114,1,2,50,48
53,114,2,7,54,47
53,114,3,1,42,41
53,114,4,10,56,46
53,114,5,1,42,41
53,114,6,4,42,38
53,115,0,10,55,45
53,115,1,5,42,37
53,115,2,7,61,54
53,115,3,4,48,44
53,115,4,6,51,45
53,115,5,2,36,34
53,115,6,2,20,18
53,116,0,3,53,50
53,116,1,1,49,48
53,116,2,7,53,46
53,116,3,3,37,34
53,116,4,11,52,41
53,116,5,2,26,24
53,116,6,1,23,22
53,117,0,7,49,42
53,117,1,4,43,39
53,117,2,2,39,37
53,117,3,1,43,42
53,117,4,7,44,37
53,117,5,1,20,19
53,117,6,2,20,18
53,118,0,3,44,41
53,118,1,5,43,38
53,118,2,4,52,48
53,118,3,3,51,48
53,118,4,5,36,31
53,118,5,3,32,29
53,118,6,1,37,36
53,119,0,7,44,37
53,119,1,4,44,40
53,119,2,5,42,37
53,119,3,3,41,38
53,119,4,3,31,28
53,119,5,2,29,27
53,119,6,2,35,33
53,120,0,0,40,40
53,120,1,0,55,55
53,120,2,4,52,48
53,120,3,3,47,44
53,120,4,3,38,35
53,120,5,3,21,18
53,120,6,0,39,39
53,121,0,0,45,45
53,121,1,2,43,41
53,121,2,0,50,50
53,121,3,0,41,41
53,121,4,3,46,43
53,121,5,0,32,32
53,121,6,1,28,27
53,122,0,0,33,33
53,122,1,2,33,31
53,122,2,2,36,34
53,122,3,1,42,41
53,122,4,2,45,43
53,122,5,0,19,19
53,122,6,2,25,23
53,123,0,6,62,56
53,123,1,3,58,55
53,123,2,0,67,67
53,123,3,1,63,62
53,123,4,0,33,33
53,123,5,3,27,24
53,123,6,3,31,28
53,124,0,3,55,52
53,124,1,3,50,47
53,124,2,2,46,44
53,124,3,2,47,45
53,124,4,2,38,36
53,124,5,0,16,16
53,124,6,2,24,22
53,125,0,0,14,14
53,125,1,5,35,30
53,125,2,1,39,38
53,125,3,2,31,29
53,125,4,0,19,19
53,125,5,1,14,13
53,125,6,1,15,14
53,126,0,3,38,35
53,126,1,7,40,33
53,126,2,5,40,35
53,126,3,4,31,27
53,126,4,1,25,24
53,126,5,3,22,19
53,126,6,3,35,32
53,127,0,10,44,34
53,127,1,5,40,35
53,127,2,12,41,29
53,127,3,3,23,20
53,127,4,4,29,25
53,127,5,0,17,17
53,127,6,1,16,15
53,128,0,9,32,23
53,128,1,19,40,21
53,128,2,8,40,32
53,128,3,5,40,35
53,128,4,1,21,20
53,128,5,0,23,23
53,128,6,1,21,20
53,129,0,2,33,31
53,129,1,4,21,17
53,129,2,4,23,19
53,129,3,12,50,38
53,129,4,0,22,22
53,129,5,0,16,16
53,129,6,0,14,14
53,130,0,2,16,14
53,130,1,6,29,23
53,130,2,0,12,12
53,130,3,4,24,20
53,130,4,2,28,26
53,130,5,2,16,14
53,130,6,1,12,11
53,131,0,2,15,13
53,131,1,1,22,21
53,131,2,4,28,24
53,131,3,4,30,26
53,131,4,0,19,19
53,131,5,1,19,18
53,131,6,1,7,6
53,132,0,2,19,17
53,132,1,2,15,13
53,132,2,2,29,27
53,132,3,2,24,22
53,132,4,0,15,15
53,132,5,0,12,12
53,132,6,3,18,15
53,133,0,1,16,15
53,133,1,3,26,23
53,133,2,4,23,19
53,133,3,1,19,18
53,133,4,0,17,17
53,133,5,1,21,20
53,133,6,1,16,15
53,134,0,0,14,14
53,134,1,4,25,21
53,134,2,0,11,11
53,134,3,2,19,17
53,134,4,1,21,20
53,134,5,1,12,11
53,134,6,1,10,9
53,135,0,0,13,13
53,135,1,3,19,16
53,135,2,0,15,15
53,135,3,3,17,14
53,135,4,0,14,14
53,135,5,0,14,14
53,135,6,1,16,15
53,136,0,1,11,10
53,136,1,4,13,9
53,136,2,0,12,12
53,136,3,1,12,11
53,136,4,1,10,9
53,136,5,3,13,10
53,136,6,2,12,10
53,137,0,3,11,8
53,137,1,0,7,7
53,137,2,1,13,12
53,137,3,1,9,8
53,137,4,0,12,12
53,137,5,0,7,7
53,137,6,0,14,14
53,138,0,0,8,8
53,138,1,1,8,7
53,138,2,0,10,10
53,138,3,1,19,18
53,138,4,0,19,19
53,138,5,0,9,9
53,138,6,1,9,8
53,139,0,0,7,7
53,139,1,1,16,15
53,139,2,0,3,3
53,139,3,0,9,9
53,139,4,1,5,4
53,139,5,2,7,5
53,139,6,2,7,5
53,140,0,1,14,13
53,140,1,2,14,12
53,140,2,1,12,11
53,140,3,1,7,6
53,140,4,0,11,11
53,140,5,1,9,8
53,140,6,1,4,3
53,141,0,2,9,7
53,141,1,0,13,13
53,141,2,2,11,9
53,141,3,0,7,7
53,141,4,1,6,5
53,141,5,2,20,18
53,141,6,3,10,7
53,142,0,1,5,4
53,142,1,0,3,3
53,142,2,1,15,14
53,142,3,0,6,6
53,142,4,0,9,9
53,142,5,1,3,2
53,142,6,3,13,10
53,143,0,0,3,3
53,143,1,1,7,6
53,143,2,0,10,10
53,143,3,0,3,3
53,143,4,0,8,8
53,143,5,1,2,1
53,143,6,4,8,4
54,0,0,2,30,28
54,0,1,2,26,24
54,0,2,8,33,25
54,0,3,0,24,24
54,0,4,1,36,35
54,0,5,1,39,38
54,0,6,5,46,41
54,1,0,2,31,29
54,1,1,1,33,32
54,1,2,1,24,23
54,1,3,3,32,29
54,1,4,3,39,36
54,1,5,0,26,26
54,1,6,4,28,24
54,2,0,2,20,18
54,2,1,0,16,16
54,2,2,2,27,25
54,2,3,2,23,21
54,2,4,7,39,32
54,2,5,4,27,23
54,2,6,0,23,23
54,3,0,4,28,24
54,3,1,1,23,22
54,3,2,0,22,22
54,3,3,11,42,31
54,3,4,1,26,25
54,3,5,4,28,24
54,3,6,3,31,28
54,4,0,3,21,18
54,4,1,2,16,14
54,4,2,6,29,23
54,4,3,1,20,19
54,4,4,2,19,17
54,4,5,1,21,20
54,4,6,4,32,28
54,5,0,1,26,25
54,5,1,1,16,15
54,5,2,1,18,17
54,5,3,6,27,21
54,5,4,0,37,37
54,5,5,2,24,22
54,5,6,4,28,24
54,6,0,1,12,11
54,6,1,0,15,15
54,6,2,3,18,15
54,6,3,2,19,17
54,6,4,8,28,20
54,6,5,1,21,20
54,6,6,10,30,20
54,7,0,0,1,1
54,7,1,0,7,7
54,7,2,0,10,10
54,7,3,2,17,15
54,7,4,0,15,15
54,7,5,12,27,15
54,7,6,6,33,27
54,8,0,2,5,3
54,8,1,4,18,14
54,8,2,0,12,12
54,8,3,2,12,10
54,8,4,1,18,17
54,8,5,4,24,20
54,8,6,3,28,25
54,9,0,3,13,10
54,9,1,1,10,9
54,9,2,2,13,11
54,9,3,4,14,10
54,9,4,1,16,15
54,9,5,2,13,11
54,9,6,1,15,14
54,10,0,5,14,9
54,10,1,0,11,11
54,10,2,3,10,7
54,10,3,1,9,8
54,10,4,3,21,18
54,10,5,5,17,12
54,10,6,6,15,9
54,11,0,11,19,8
54,11,1,0,10,10
54,11,2,3,9,6
54,11,3,1,8,7
54,11,4,1,11,10
54,11,5,1,13,12
54,11,6,3,18,15
54,12,0,7,16,9
54,12,1,0,4,4
54,12,2,0,9,9
54,12,3,0,6,6
54,12,4,3,22,19
54,12,5,0,7,7
54,12,6,11,19,8
54,13,0,5,8,3
54,13,1,3,9,6
54,13,2,3,10,7
54,13,3,1,12,11
54,13,4,2,18,16
54,13,5,3,15,12
54,13,6,5,10,5
54,14,0,5,8,3
54,14,1,3,14,11
54,14,2,1,7,6
54,14,3,0,5,5
54,14,4,2,10,8
54,14,5,1,11,10
54,14,6,1,9,8
54,15,0,4,6,2
54,15,1,8,17,9
54,15,2,5,10,5
54,15,3,2,7,5
54,15,4,5,15,10
54,15,5,1,9,8
54,15,6,1,5,4
54,16,0,1,5,4
54,16,1,1,3,2
54,16,2,3,11,8
54,16,3,1,4,3
54,16,4,2,8,6
54,16,5,2,6,4
54,16,6,5,10,5
54,17,0,1,3,2
54,17,1,3,4,1
54,17,2,1,5,4
54,17,3,0,3,3
54,17,4,1,6,5
54,17,5,1,6,5
54,17,6,2,8,6
54,18,0,1,5,4
54,18,1,0,1,1
54,18,2,1,7,6
54,18,3,1,3,2
54,18,4,4,9,5
54,18,5,4,11,7
54,18,6,1,4,3
54,19,0,1,2,1
54,19,2,1,5,4
54,19,3,1,1,0
54,19,4,3,7,4
54,19,5,1,6,5
54,19,6,2,4,2
54,20,0,0,1,1
54,20,1,6,7,1
54,20,2,1,1,0
54,20,3,0,2,2
54,20,4,1,3,2
54,20,5,2,6,4
54,20,6,1,2,1
54,21,0,2,3,1
54,21,1,5,5,0
54,21,2,0,2,2
54,21,3,1,2,1
54,21,4,5,6,1
54,21,5,2,6,4
54,21,6,0,4,4
54,22,0,1,1,0
54,22,1,0,2,2
54,22,2,1,3,2
54,22,3,0,2,2
54,22,4,2,5,3
54,22,5,1,3,2
54,22,6,2,4,2
54,23,0,1,3,2
54,23,2,1,1,0
54,23,3,2,4,2
54,23,4,7,8,1
54,23,5,0,1,1
54,23,6,1,3,2
54,24,0,1,3,2
54,24,1,1,2,1
54,24,2,0,3,3
54,24,5,0,1,1
54,24,6,0,1,1
54,25,0,0,1,1
54,25,3,2,3,1
54,25,4,0,2,2
54,25,5,3,4,1
54,25,6,0,4,4
54,26,0,2,2,0
54,26,2,2,3,1
54,26,3,2,3,1
54,26,4,0,1,1
54,26,5,1,1,0
54,26,6,0,2,2
54,27,0,1,1,0
54,27,1,0,2,2
54,27,2,2,3,1
54,28,0,0,1,1
54,28,2,3,4,1
54,28,3,2,2,0
54,28,5,2,2,0
54,28,6,2,3,1
54,29,0,1,1,0
54,29,3,1,1,0
54,29,5,1,2,1
54,29,6,0,1,1
54,30,1,3,3,0
54,30,3,0,1,1
54,30,4,0,1,1
54,30,6,1,1,0
54,31,0,0,1,1
54,31,2,0,1,1
54,31,3,1,2,1
54,31,4,5,6,1
54,31,5,0,1,1
54,31,6,2,4,2
54,32,2,0,2,2
54,32,3,4,5,1
54,32,4,0,1,1
54,32,6,3,3,0
54,33,0,1,2,1
54,33,1,0,2,2
54,33,2,1,2,1
54,33,3,2,3,1
54,33,4,1,2,1
54,33,5,1,2,1
54,33,6,2,3,1
54,34,0,5,5,0
54,34,1,1,3,2
54,34,2,5,5,0
54,34,3,2,4,2
54,34,5,0,1,1
54,34,6,0,2,2
54,35,0,1,1,0
54,35,1,1,4,3
54,35,2,2,3,1
54,35,3,0,1,1
54,35,4,2,3,1
54,35,5,0,3,3
54,35,6,1,1,0
54,36,0,1,4,3
54,36,1,0,2,2
54,36,2,3,3,0
54,36,3,1,6,5
54,36,5,0,1,1
54,37,0,4,6,2
54,37,1,3,5,2
54,37,2,3,5,2
54,37,3,0,1,1
54,37,4,3,4,1
54,37,5,2,2,0
54,37,6,2,2,0
54,38,0,1,10,9
54,38,1,2,5,3
54,38,2,2,4,2
54,38,3,2,7,5
54,38,4,1,5,4
54,38,5,0,2,2
54,38,6,0,3,3
54,39,0,0,18,18
54,39,1,5,22,17
54,39,2,0,23,23
54,39,3,0,21,21
54,39,4,4,16,12
54,39,5,2,5,3
54,39,6,0,5,5
54,40,0,2,29,27
54,40,1,2,26,24
54,40,2,0,13,13
54,40,3,2,36,34
54,40,4,3,20,17
54,40,5,0,4,4
54,40,6,0,5,5
54,41,0,0,29,29
54,41,1,0,36,36
54,41,2,2,30,28
54,41,3,2,27,25
54,41,4,2,22,20
54,41,5,0,10,10
54,41,6,0,11,11
54,42,0,1,20,19
54,42,1,1,27,26
54,42,2,1,24,23
54,42,3,0,22,22
54,42,4,1,23,22
54,42,5,2,10,8
54,42,6,0,8,8
54,43,0,1,38,37
54,43,1,0,38,38
54,43,2,2,41,39
54,43,3,1,43,42
54,43,4,0,30,30
54,43,5,0,18,18
54,43,6,0,10,10
54,44,0,0,48,48
54,44,1,0,50,50
54,44,2,0,53,53
54,44,3,3,42,39
54,44,4,1,33,32
54,44,5,0,23,23
54,44,6,2,27,25
54,45,0,0,55,55
54,45,1,0,44,44
54,45,2,4,48,44
54,45,3,0,49,49
54,45,4,0,37,37
54,45,5,3,24,21
54,45,6,0,24,24
54,46,0,2,55,53
54,46,1,2,61,59
54,46,2,3,60,57
54,46,3,0,78,78
54,46,4,0,41,41
54,46,5,0,31,31
54,46,6,2,28,26
54,47,0,1,64,63
54,47,1,0,67,67
54,47,2,2,58,56
54,47,3,2,75,73
54,47,4,3,57,54
54,47,5,0,36,36
54,47,6,1,33,32
54,48,0,1,63,62
54,48,1,0,60,60
54,48,2,1,68,67
54,48,3,8,83,75
54,48,4,0,48,48
54,48,5,0,44,44
54,48,6,1,35,34
54,49,0,1,63,62
54,49,1,1,91,90
54,49,2,1,80,79
54,49,3,5,93,88
54,49,4,1,62,61
54,49,5,0,37,37
54,49,6,0,42,42
54,50,0,2,72,70
54,50,1,1,64,63
54,50,2,2,57,55
54,50,3,2,77,75
54,50,4,3,55,52
54,50,5,0,42,42
54,50,6,0,34,34
54,51,0,2,50,48
54,51,1,0,71,71
54,51,2,0,64,64
54,51,3,2,68,66
54,51,4,1,55,54
54,51,5,1,44,43
54,51,6,1,29,28
54,52,0,1,64,63
54,52,1,2,57,55
54,52,2,2,66,64
54,52,3,1,55,54
54,52,4,1,55,54
54,52,5,0,54,54
54,52,6,2,37,35
54,53,0,2,51,49
54,53,1,1,65,64
54,53,2,1,51,50
54,53,3,2,69,67
54,53,4,0,46,46
54,53,5,3,47,44
54,53,6,2,36,34
54,54,0,1,53,52
54,54,1,1,58,57
54,54,2,1,51,50
54,54,3,2,63,61
54,54,4,4,61,57
54,54,5,0,34,34
54,54,6,0,35,35
54,55,0,0,47,47
54,55,1,1,56,55
54,55,2,0,49,49
54,55,3,1,65,64
54,55,4,1,48,47
54,55,5,0,33,33
54,55,6,1,45,44
54,56,0,2,51,49
54,56,1,1,60,59
54,56,2,3,63,60
54,56,3,5,76,71
54,56,4,1,42,41
54,56,5,3,39,36
54,56,6,3,53,50
54,57,0,3,36,33
54,57,1,1,43,42
54,57,2,1,43,42
54,57,3,2,46,44
54,57,4,2,33,31
54,57,5,2,33,31
54,57,6,0,28,28
54,58,0,2,35,33
54,58,1,0,27,27
54,58,2,2,47,45
54,58,3,2,46,44
54,58,4,2,39,37
54,58,5,0,33,33
54,58,6,0,42,42
54,59,0,0,26,26
54,59,1,0,34,34
54,59,2,4,47,43
54,59,3,1,45,44
54,59,4,0,37,37
54,59,5,3,45,42
54,59,6,1,32,31
54,60,0,0,38,38
54,60,1,0,28,28
54,60,2,1,40,39
54,60,3,1,43,42
54,60,4,0,27,27
54,60,5,1,39,38
54,60,6,0,32,32
54,61,0,0,25,25
54,61,1,0,34,34
54,61,2,1,39,38
54,61,3,0,37,37
54,61,4,3,28,25
54,61,5,0,34,34
54,61,6,1,37,36
54,62,0,2,37,35
54,62,1,2,36,34
54,62,2,0,28,28
54,62,3,1,43,42
54,62,4,1,31,30
54,62,5,0,38,38
54,62,6,2,36,34
54,63,0,2,36,34
54,63,1,1,39,38
54,63,2,2,48,46
54,63,3,0,51,51
54,63,4,1,28,27
54,63,5,1,44,43
54,63,6,1,33,32
54,64,0,0,41,41
54,64,1,1,30,29
54,64,2,2,31,29
54,64,3,1,39,38
54,64,4,0,36,36
54,64,5,2,45,43
54,64,6,1,43,42
54,65,0,1,37,36
54,65,1,2,37,35
54,65,2,1,48,47
54,65,3,0,35,35
54,65,4,0,46,46
54,65,5,3,33,30
54,65,6,1,38,37
54,66,0,6,46,40
54,66,1,0,31,31
54,66,2,7,46,39
54,66,3,1,49,48
54,66,4,0,40,40
54,66,5,1,39,38
54,66,6,0,47,47
54,67,0,1,25,24
54,67,1,0,47,47
54,67,2,9,46,37
54,67,3,0,36,36
54,67,4,1,34,33
54,67,5,4,47,43
54,67,6,0,37,37
54,68,0,1,48,47
54,68,1,3,49,46
54,68,2,4,38,34
54,68,3,0,47,47
54,68,4,2,28,26
54,68,5,0,40,40
54,68,6,2,49,47
54,69,0,1,35,34
54,69,1,2,40,38
54,69,2,3,53,50
54,69,3,1,49,48
54,69,4,3,53,50
54,69,5,3,47,44
54,69,6,0,39,39
54,70,0,1,39,38
54,70,1,0,41,41
54,70,2,4,48,44
54,70,3,1,39,38
54,70,4,2,47,45
54,70,5,0,58,58
54,70,6,1,40,39
54,71,0,1,32,31
54,71,1,3,41,38
54,71,2,4,62,58
54,71,3,2,51,49
54,71,4,2,41,39
54,71,5,3,53,50
54,71,6,0,44,44
54,72,0,4,38,34
54,72,1,1,35,34
54,72,2,4,38,34
54,72,3,0,42,42
54,72,4,3,43,40
54,72,5,5,56,51
54,72,6,1,55,54
54,73,0,2,32,30
54,73,1,0,29,29
54,73,2,0,39,39
54,73,3,4,50,46
54,73,4,2,54,52
54,73,5,2,44,42
54,73,6,7,52,45
54,74,0,2,53,51
54,74,1,2,42,40
54,74,2,0,49,49
54,74,3,4,47,43
54,74,4,1,34,33
54,74,5,0,42,42
54,74,6,0,61,61
54,75,0,2,37,35
54,75,1,2,34,32
54,75,2,0,39,39
54,75,3,1,45,44
54,75,4,0,45,45
54,75,5,1,47,46
54,75,6,2,49,47
54,76,0,0,42,42
54,76,1,0,42,42
54,76,2,0,46,46
54,76,3,0,51,51
54,76,4,1,42,41
54,76,5,1,57,56
54,76,6,3,53,50
54,77,0,2,60,58
54,77,1,0,40,40
54,77,2,4,63,59
54,77,3,2,40,38
54,77,4,1,42,41
54,77,5,5,49,44
54,77,6,1,66,65
54,78,0,3,50,47
54,78,1,3,37,34
54,78,2,1,45,44
54,78,3,2,40,38
54,78,4,4,55,51
54,78,5,0,56,56
54,78,6,1,61,60
54,79,0,1,52,51
54,79,1,2,38,36
54,79,2,1,47,46
54,79,3,0,45,45
54,79,4,1,57,56
54,79,5,0,47,47
54,79,6,1,59,58
54,80,0,3,46,43
54,80,1,1,47,46
54,80,2,2,51,49
54,80,3,4,41,37
54,80,4,1,51,50
54,80,5,2,51,49
54,80,6,2,59,57
54,81,0,2,45,43
54,81,1,4,58,54
54,81,2,0,47,47
54,81,3,0,55,55
54,81,4,2,56,54
54,81,5,4,57,53
54,81,6,2,55,53
54,82,0,0,50,50
54,82,1,1,35,34
54,82,2,2,62,60
54,82,3,2,41,39
54,82,4,1,52,51
54,82,5,1,47,46
54,82,6,6,54,48
54,83,0,1,51,50
54,83,1,1,50,49
54,83,2,0,57,57
54,83,3,1,59,58
54,83,4,0,32,32
54,83,5,2,53,51
54,83,6,2,59,57
54,84,0,2,33,31
54,84,1,0,41,41
54,84,2,1,56,55
54,84,3,0,55,55
54,84,4,2,45,43
54,84,5,3,56,53
54,84,6,1,49,48
54,85,0,1,44,43
54,85,1,1,48,47
54,85,2,0,47,47
54,85,3,5,47,42
54,85,4,1,51,50
54,85,5,3,57,54
54,85,6,0,50,50
54,86,0,4,59,55
54,86,1,1,49,48
54,86,2,0,51,51
54,86,3,0,46,46
54,86,4,1,51,50
54,86,5,3,42,39
54,86,6,3,59,56
54,87,0,0,40,40
54,87,1,2,52,50
54,87,2,0,57,57
54,87,3,3,42,39
54,87,4,5,53,48
54,87,5,0,47,47
54,87,6,1,61,60
54,88,0,0,31,31
54,88,1,3,43,40
54,88,2,2,58,56
54,88,3,0,37,37
54,88,4,6,47,41
54,88,5,4,56,52
54,88,6,0,55,55
54,89,0,0,33,33
54,89,1,2,61,59
54,89,2,3,60,57
54,89,3,1,58,57
54,89,4,9,58,49
54,89,5,0,55,55
54,89,6,18,80,62
54,90,0,1,45,44
54,90,1,0,48,48
54,90,2,0,53,53
54,90,3,1,36,35
54,90,4,4,58,54
54,90,5,0,44,44
54,90,6,0,52,52
54,91,0,0,37,37
54,91,1,3,55,52
54,91,2,0,59,59
54,91,3,0,48,48
54,91,4,3,41,38
54,91,5,2,57,55
54,91,6,0,64,64
54,92,0,2,42,40
54,92,1,6,44,38
54,92,2,1,52,51
54,92,3,3,54,51
54,92,4,1,48,47
54,92,5,0,50,50
54,92,6,1,43,42
54,93,0,1,57,56
54,93,1,4,59,55
54,93,2,3,79,76
54,93,3,0,47,47
54,93,4,4,73,69
54,93,5,4,66,62
54,93,6,0,54,54
54,94,0,2,71,69
54,94,1,5,63,58
54,94,2,2,60,58
54,94,3,1,46,45
54,94,4,2,59,57
54,94,5,3,54,51
54,94,6,1,61,60
54,95,0,0,50,50
54,95,1,3,74,71
54,95,2,0,74,74
54,95,3,3,60,57
54,95,4,2,51,49
54,95,5,3,68,65
54,95,6,0,55,55
54,96,0,1,59,58
54,96,1,0,64,64
54,96,2,2,75,73
54,96,3,2,65,63
54,96,4,1,51,50
54,96,5,5,97,92
54,96,6,2,71,69
54,97,0,1,53,52
54,97,1,4,67,63
54,97,2,2,71,69
54,97,3,1,68,67
54,97,4,1,59,58
54,97,5,1,70,69
54,97,6,3,82,79
54,98,0,1,74,73
54,98,1,1,75,74
54,98,2,1,93,92
54,98,3,1,79,78
54,98,4,0,56,56
54,98,5,2,87,85
54,98,6,1,79,78
54,99,0,3,70,67
54,99,1,1,64,63
54,99,2,2,77,75
54,99,3,0,67,67
54,99,4,4,92,88
54,99,5,3,65,62
54,99,6,3,64,61
54,100,0,2,74,72
54,100,1,5,100,95
54,100,2,1,68,67
54,100,3,5,87,82
54,100,4,1,65,64
54,100,5,3,84,81
54,100,6,1,91,90
54,101,0,0,66,66
54,101,1,5,80,75
54,101,2,6,100,94
54,101,3,2,106,104
54,101,4,1,88,87
54,101,5,3,62,59
54,101,6,0,68,68
54,102,0,4,95,91
54,102,1,1,69,68
54,102,2,3,108,105
54,102,3,5,101,96
54,102,4,0,113,113
54,102,5,2,81,79
54,102,6,0,85,85
54,103,0,4,84,80
54,103,1,2,79,77
54,103,2,1,75,74
54,103,3,2,76,74
54,103,4,3,74,71
54,103,5,3,92,89
54,103,6,12,71,59
54,104,0,1,66,65
54,104,1,1,71,70
54,104,2,0,73,73
54,104,3,1,84,83
54,104,4,2,82,80
54,104,5,1,78,77
54,104,6,4,91,87
54,105,0,1,58,57
54,105,1,1,75,74
54,105,2,3,78,75
54,105,3,1,70,69
54,105,4,0,89,89
54,105,5,1,68,67
54,105,6,0,76,76
54,106,0,3,73,70
54,106,1,3,79,76
54,106,2,4,65,61
54,106,3,2,61,59
54,106,4,2,65,63
54,106,5,2,55,53
54,106,6,2,67,65
54,107,0,5,78,73
54,107,1,4,74,70
54,107,2,5,77,72
54,107,3,3,89,86
54,107,4,6,90,84
54,107,5,0,65,65
54,107,6,1,64,63
54,108,0,0,75,75
54,108,1,3,75,72
54,108,2,2,100,98
54,108,3,0,82,82
54,108,4,3,81,78
54,108,5,2,91,89
54,108,6,4,80,76
54,109,0,0,66,66
54,109,1,6,82,76
54,109,2,4,92,88
54,109,3,3,77,74
54,109,4,3,60,57
54,109,5,3,68,65
54,109,6,0,68,68
54,110,0,0,59,59
54,110,1,2,74,72
54,110,2,1,77,76
54,110,3,1,70,69
54,110,4,1,63,62
54,110,5,4,63,59
54,110,6,1,61,60
54,111,0,0,65,65
54,111,1,7,74,67
54,111,2,2,72,70
54,111,3,2,67,65
54,111,4,1,70,69
54,111,5,1,65,64
54,111,6,0,72,72
54,112,0,0,85,85
54,112,1,1,73,72
54,112,2,0,63,63
54,112,3,2,68,66
54,112,4,0,83,83
54,112,5,1,76,75
54,112,6,3,77,74
54,113,0,3,68,65
54,113,1,2,70,68
54,113,2,3,80,77
54,113,3,3,91,88
54,113,4,3,72,69
54,113,5,0,79,79
54,113,6,1,82,81
54,114,0,1,53,52
54,114,1,1,57,56
54,114,2,0,54,54
54,114,3,1,59,58
54,114,4,2,63,61
54,114,5,0,69,69
54,114,6,2,58,56
54,115,0,0,55,55
54,115,1,2,57,55
54,115,2,2,62,60
54,115,3,1,58,57
54,115,4,3,67,64
54,115,5,4,72,68
54,115,6,1,60,59
54,116,0,1,58,57
54,116,1,5,61,56
54,116,2,1,56,55
54,116,3,1,60,59
54,116,4,0,62,62
54,116,5,4,53,49
54,116,6,1,35,34
54,117,0,2,74,72
54,117,1,4,65,61
54,117,2,0,58,58
54,117,3,0,49,49
54,117,4,3,63,60
54,117,5,2,76,74
54,117,6,0,56,56
54,118,0,2,49,47
54,118,1,4,62,58
54,118,2,1,79,78
54,118,3,1,50,49
54,118,4,1,63,62
54,118,5,1,64,63
54,118,6,1,39,38
54,119,0,1,50,49
54,119,1,5,56,51
54,119,2,0,59,59
54,119,3,1,63,62
54,119,4,3,57,54
54,119,5,1,69,68
54,119,6,2,62,60
54,120,0,1,58,57
54,120,1,4,68,64
54,120,2,1,69,68
54,120,3,4,66,62
54,120,4,2,71,69
54,120,5,2,77,75
54,120,6,0,77,77
54,121,0,0,61,61
54,121,1,5,73,68
54,121,2,0,61,61
54,121,3,2,60,58
54,121,4,3,78,75
54,121,5,3,70,67
54,121,6,1,58,57
54,122,0,1,46,45
54,122,1,1,52,51
54,122,2,1,50,49
54,122,3,1,63,62
54,122,4,4,66,62
54,122,5,1,69,68
54,122,6,1,60,59
54,123,0,0,56,56
54,123,1,2,59,57
54,123,2,0,55,55
54,123,3,3,47,44
54,123,4,0,50,50
54,123,5,1,62,61
54,123,6,8,53,45
54,124,0,1,41,40
54,124,1,1,52,51
54,124,2,3,68,65
54,124,3,2,42,40
54,124,4,3,62,59
54,124,5,1,58,57
54,124,6,2,45,43
54,125,0,0,43,43
54,125,1,2,48,46
54,125,2,2,61,59
54,125,3,1,35,34
54,125,4,1,52,51
54,125,5,1,56,55
54,125,6,5,53,48
54,126,0,0,50,50
54,126,1,0,56,56
54,126,2,2,65,63
54,126,3,2,49,47
54,126,4,0,46,46
54,126,5,1,61,60
54,126,6,3,61,58
54,127,0,0,53,53
54,127,1,3,60,57
54,127,2,1,71,70
54,127,3,0,44,44
54,127,4,2,65,63
54,127,5,2,60,58
54,127,6,3,67,64
54,128,0,1,62,61
54,128,1,2,74,72
54,128,2,3,63,60
54,128,3,1,77,76
54,128,4,2,48,46
54,128,5,1,49,48
54,128,6,3,68,65
54,129,0,0,55,55
54,129,1,3,55,52
54,129,2,2,82,80
54,129,3,1,56,55
54,129,4,4,55,51
54,129,5,2,61,59
54,129,6,4,68,64
54,130,0,0,54,54
54,130,1,0,59,59
54,130,2,3,57,54
54,130,3,5,63,58
54,130,4,2,46,44
54,130,5,1,56,55
54,130,6,2,54,52
54,131,0,1,35,34
54,131,1,3,43,40
54,131,2,2,54,52
54,131,3,1,40,39
54,131,4,1,46,45
54,131,5,0,67,67
54,131,6,1,44,43
54,132,0,0,34,34
54,132,1,1,58,57
54,132,2,4,63,59
54,132,3,2,49,47
54,132,4,1,54,53
54,132,5,3,55,52
54,132,6,2,46,44
54,133,0,0,53,53
54,133,1,2,42,40
54,133,2,0,42,42
54,133,3,2,38,36
54,133,4,3,48,45
54,133,5,1,73,72
54,133,6,3,41,38
54,134,0,1,44,43
54,134,1,0,41,41
54,134,2,0,47,47
54,134,3,1,33,32
54,134,4,3,51,48
54,134,5,0,45,45
54,134,6,2,65,63
54,135,0,1,44,43
54,135,1,2,47,45
54,135,2,3,57,54
54,135,3,1,60,59
54,135,4,0,50,50
54,135,5,0,46,46
54,135,6,0,45,45
54,136,0,0,27,27
54,136,1,0,32,32
54,136,2,0,36,36
54,136,3,2,52,50
54,136,4,0,56,56
54,136,5,4,48,44
54,136,6,0,34,34
54,137,0,0,33,33
54,137,1,1,49,48
54,137,2,0,46,46
54,137,3,1,35,34
54,137,4,4,65,61
54,137,5,1,47,46
54,137,6,1,38,37
54,138,0,0,26,26
54,138,1,0,26,26
54,138,2,0,32,32
54,138,3,0,32,32
54,138,4,3,33,30
54,138,5,2,47,45
54,138,6,3,47,44
54,139,0,0,33,33
54,139,1,1,45,44
54,139,2,0,30,30
54,139,3,4,44,40
54,139,4,0,23,23
54,139,5,3,52,49
54,139,6,2,38,36
54,140,0,2,38,36
54,140,1,0,34,34
54,140,2,2,37,35
54,140,3,2,42,40
54,140,4,1,24,23
54,140,5,1,37,36
54,140,6,1,35,34
54,141,0,2,26,24
54,141,1,1,25,24
54,141,2,0,31,31
54,141,3,1,34,33
54,141,4,2,46,44
54,141,5,0,35,35
54,141,6,1,30,29
54,142,0,3,39,36
54,142,1,1,32,31
54,142,2,1,27,26
54,142,3,3,38,35
54,142,4,3,29,26
54,142,5,2,34,32
54,142,6,0,35,35
54,143,0,4,22,18
54,143,1,9,39,30
54,143,2,5,36,31
54,143,3,1,35,34
54,143,4,0,32,32
54,143,5,1,27,26
54,143,6,5,23,18
55,0,0,7,8,1
55,0,1,1,7,6
55,0,2,1,6,5
55,0,3,3,8,5
55,0,4,5,10,5
55,0,5,4,12,8
55,0,6,0,7,7
55,1,0,3,8,5
55,1,1,4,4,0
55,1,2,7,10,3
55,1,3,4,8,4
55,1,4,2,9,7
55,1,5,0,5,5
55,1,6,9,14,5
55,2,0,2,6,4
55,2,1,0,2,2
55,2,2,5,8,3
55,2,3,2,5,3
55,2,4,6,12,6
55,2,5,2,6,4
55,2,6,9,17,8
55,3,0,1,3,2
55,3,1,2,5,3
55,3,2,2,5,3
55,3,3,0,7,7
55,3,4,5,15,10
55,3,5,0,4,4
55,3,6,2,7,5
55,4,0,0,3,3
55,4,1,0,1,1
55,4,2,3,11,8
55,4,3,0,1,1
55,4,4,6,11,5
55,4,5,7,14,7
55,4,6,5,7,2
55,5,0,0,3,3
55,5,1,2,6,4
55,5,2,2,5,3
55,5,3,7,7,0
55,5,4,1,11,10
55,5,5,4,10,6
55,5,6,3,4,1
55,6,0,0,1,1
55,6,1,0,2,2
55,6,2,0,3,3
55,6,3,3,3,0
55,6,4,2,7,5
55,6,5,1,9,8
55,6,6,3,5,2
55,7,0,0,2,2
55,7,1,3,4,1
55,7,2,0,3,3
55,7,3,2,2,0
55,7,4,4,8,4
55,7,5,0,2,2
55,7,6,0,2,2
55,8,0,0,1,1
55,8,1,1,4,3
55,8,2,1,3,2
55,8,3,0,3,3
55,8,4,1,1,0
55,8,5,1,7,6
55,8,6,4,6,2
55,9,0,0,1,1
55,9,1,1,1,0
55,9,2,0,2,2
55,9,3,2,2,0
55,9,4,0,2,2
55,9,5,0,1,1
55,9,6,1,3,2
55,10,0,1,2,1
55,10,1,1,1,0
55,10,2,1,4,3
55,10,4,0,2,2
55,10,6,1,2,1
55,11,0,0,1,1
55,11,1,1,1,0
55,11,2,0,2,2
55,11,4,0,2,2
55,11,5,1,3,2
55,11,6,0,2,2
55,12,0,1,1,0
55,12,2,0,1,1
55,12,4,0,2,2
55,12,5,1,2,1
55,13,1,1,1,0
55,13,2,0,1,1
55,13,3,0,1,1
55,13,5,1,2,1
55,14,0,2,2,0
55,14,2,0,1,1
55,14,3,2,3,1
55,14,4,0,1,1
55,14,5,0,1,1
55,15,2,2,2,0
55,15,4,5,6,1
55,15,5,0,2,2
55,16,0,0,1,1
55,16,3,1,1,0
55,16,4,1,1,0
55,17,2,1,1,0
55,18,2,0,1,1
55,18,3,0,1,1
55,18,5,1,3,2
55,19,0,0,1,1
55,19,1,0,1,1
55,19,6,2,3,1
55,20,0,1,1,0
55,20,2,2,3,1
55,20,6,3,3,0
55,21,2,2,2,0
55,21,5,0,1,1
55,23,3,2,2,0
55,23,6,0,1,1
55,24,6,1,1,0
55,25,5,3,3,0
55,30,4,0,1,1
55,31,0,0,1,1
55,32,4,1,1,0
55,32,5,5,5,0
55,34,3,0,1,1
55,34,4,1,1,0
55,35,4,2,2,0
55,36,0,0,2,2
55,36,1,1,1,0
55,38,3,1,2,1
55,38,4,1,3,2
55,39,2,0,3,3
55,39,3,0,2,2
55,39,4,1,4,3
55,40,0,0,3,3
55,40,1,0,3,3
55,40,2,0,1,1
55,40,4,0,1,1
55,40,6,1,1,0
55,41,0,1,2,1
55,41,1,1,2,1
55,41,6,1,1,0
55,42,0,1,3,2
55,42,2,1,1,0
55,42,3,0,2,2
55,42,4,1,4,3
55,42,5,1,1,0
55,42,6,0,1,1
55,43,0,0,3,3
55,43,1,0,1,1
55,43,2,0,1,1
55,43,3,1,4,3
55,43,4,0,1,1
55,43,5,2,4,2
55,43,6,0,1,1
55,44,0,0,1,1
55,44,1,0,6,6
55,44,2,0,3,3
55,44,3,0,6,6
55,44,4,0,3,3
55,44,6,0,2,2
55,45,0,0,7,7
55,45,1,0,5,5
55,45,2,0,8,8
55,45,3,0,8,8
55,45,4,4,7,3
55,45,5,0,1,1
55,45,6,1,3,2
55,46,0,0,3,3
55,46,1,1,5,4
55,46,2,1,6,5
55,46,3,0,9,9
55,46,4,1,6,5
55,46,6,0,4,4
55,47,0,1,9,8
55,47,1,1,3,2
55,47,2,1,4,3
55,47,3,0,4,4
55,47,4,0,3,3
55,47,5,0,4,4
55,47,6,2,4,2
55,48,0,1,8,7
55,48,1,1,9,8
55,48,2,2,7,5
55,48,3,1,8,7
55,48,4,0,5,5
55,48,5,1,5,4
55,48,6,1,3,2
55,49,0,1,7,6
55,49,1,0,2,2
55,49,2,3,9,6
55,49,3,0,3,3
55,49,4,2,3,1
55,49,5,1,5,4
55,49,6,0,1,1
55,50,0,0,10,10
55,50,1,0,11,11
55,50,2,1,14,13
55,50,3,2,15,13
55,50,4,0,12,12
55,50,5,0,5,5
55,51,0,2,13,11
55,51,1,0,11,11
55,51,2,0,6,6
55,51,3,5,12,7
55,51,4,2,15,13
55,51,5,1,6,5
55,51,6,0,2,2
55,52,0,6,12,6
55,52,1,4,12,8
55,52,2,1,12,11
55,52,3,4,12,8
55,52,4,1,6,5
55,52,5,0,5,5
55,52,6,0,3,3
55,53,0,1,8,7
55,53,1,3,4,1
55,53,2,3,8,5
55,53,3,3,6,3
55,53,4,4,5,1
55,53,5,0,2,2
55,53,6,0,2,2
55,54,0,2,2,0
55,54,1,3,8,5
55,54,2,5,8,3
55,54,3,0,2,2
55,54,4,2,3,1
55,54,5,0,2,2
55,54,6,0,4,4
55,55,0,1,5,4
55,55,1,6,11,5
55,55,2,1,4,3
55,55,3,0,4,4
55,55,4,1,5,4
55,55,5,2,8,6
55,56,0,1,4,3
55,56,1,7,10,3
55,56,2,1,3,2
55,56,3,1,3,2
55,56,4,2,6,4
55,56,5,0,3,3
55,56,6,0,2,2
55,57,0,3,3,0
55,57,1,7,9,2
55,57,2,1,1,0
55,57,3,0,3,3
55,57,5,0,4,4
55,57,6,0,1,1
55,58,0,3,6,3
55,58,1,7,8,1
55,58,2,2,5,3
55,58,3,0,2,2
55,58,4,1,3,2
55,58,5,3,7,4
55,58,6,1,4,3
55,59,0,0,2,2
55,59,1,1,3,2
55,59,2,0,3,3
55,59,3,2,3,1
55,59,4,2,4,2
55,59,5,1,4,3
55,59,6,0,2,2
55,60,1,3,6,3
55,60,3,1,4,3
55,60,4,2,5,3
55,60,5,1,4,3
55,60,6,0,1,1
55,61,0,0,1,1
55,61,1,1,3,2
55,61,2,3,7,4
55,61,3,0,2,2
55,61,4,1,3,2
55,61,5,0,4,4
55,62,0,0,5,5
55,62,1,1,6,5
55,62,2,0,1,1
55,62,3,1,3,2
55,62,4,0,3,3
55,62,5,2,4,2
55,62,6,0,1,1
55,63,1,0,2,2
55,63,2,0,2,2
55,63,3,0,4,4
55,63,4,1,3,2
55,63,5,0,2,2
55,63,6,0,3,3
55,64,0,0,1,1
55,64,1,0,3,3
55,64,3,1,1,0
55,64,4,2,6,4
55,64,5,4,7,3
55,64,6,0,3,3
55,65,0,1,4,3
55,65,1,0,5,5
55,65,2,0,1,1
55,65,3,0,1,1
55,65,4,1,3,2
55,65,5,1,5,4
55,65,6,0,2,2
55,66,0,1,3,2
55,66,1,3,7,4
55,66,2,0,1,1
55,66,3,0,2,2
55,66,4,0,1,1
55,66,5,2,6,4
55,66,6,0,3,3
55,67,0,1,2,1
55,67,1,0,2,2
55,67,2,0,3,3
55,67,3,1,4,3
55,67,4,2,2,0
55,67,5,1,3,2
55,68,0,0,7,7
55,68,1,4,6,2
55,68,2,0,2,2
55,68,5,1,8,7
55,68,6,0,3,3
55,69,0,1,6,5
55,69,1,1,1,0
55,69,2,2,8,6
55,69,3,0,2,2
55,69,4,0,2,2
55,69,5,0,5,5
55,69,6,1,5,4
55,70,0,0,2,2
55,70,1,1,5,4
55,70,3,0,2,2
55,70,4,1,1,0
55,70,5,1,5,4
55,70,6,1,4,3
55,71,0,3,5,2
55,71,1,2,5,3
55,71,2,2,3,1
55,71,3,0,2,2
55,71,4,2,3,1
55,71,5,1,4,3
55,71,6,1,4,3
55,72,0,1,4,3
55,72,1,0,2,2
55,72,2,1,3,2
55,72,3,3,7,4
55,72,4,0,4,4
55,72,5,1,8,7
55,72,6,0,7,7
55,73,0,0,4,4
55,73,1,0,2,2
55,73,2,1,1,0
55,73,3,0,5,5
55,73,4,1,2,1
55,73,5,0,5,5
55,73,6,0,4,4
55,74,0,3,6,3
55,74,1,0,3,3
55,74,2,2,3,1
55,74,3,0,3,3
55,74,4,1,4,3
55,74,5,1,2,1
55,74,6,0,4,4
55,75,0,7,11,4
55,75,1,3,5,2
55,75,2,4,9,5
55,75,3,0,1,1
55,75,4,0,3,3
55,75,5,0,7,7
55,75,6,3,4,1
55,76,0,1,6,5
55,76,1,2,3,1
55,76,2,2,4,2
55,76,3,0,1,1
55,76,4,2,8,6
55,76,5,0,5,5
55,76,6,2,6,4
55,77,0,1,4,3
55,77,3,1,4,3
55,77,4,0,3,3
55,77,5,1,4,3
55,77,6,0,4,4
55,78,0,0,2,2
55,78,1,0,3,3
55,78,2,2,8,6
55,78,3,1,3,2
55,78,4,3,5,2
55,78,5,4,8,4
55,78,6,0,6,6
55,79,0,0,5,5
55,79,1,0,2,2
55,79,2,1,3,2
55,79,3,0,2,2
55,79,4,3,6,3
55,79,5,1,10,9
55,79,6,0,3,3
55,80,0,0,4,4
55,80,2,0,3,3
55,80,3,0,2,2
55,80,4,0,4,4
55,80,5,4,8,4
55,80,6,0,5,5
55,81,0,0,1,1
55,81,1,0,4,4
55,81,2,2,4,2
55,81,3,0,1,1
55,81,4,0,5,5
55,81,5,0,2,2
55,81,6,0,4,4
55,82,0,0,3,3
55,82,1,1,7,6
55,82,2,3,6,3
55,82,3,1,7,6
55,82,4,0,3,3
55,82,5,0,4,4
55,83,0,1,5,4
55,83,1,1,4,3
55,83,2,0,5,5
55,83,3,0,5,5
55,83,4,1,1,0
55,83,5,0,1,1
55,83,6,0,3,3
55,84,0,0,4,4
55,84,1,0,2,2
55,84,2,0,4,4
55,84,3,0,2,2
55,84,4,0,8,8
55,84,5,0,1,1
55,84,6,3,8,5
55,85,0,0,4,4
55,85,1,0,2,2
55,85,2,0,2,2
55,85,4,0,4,4
55,85,5,0,4,4
55,85,6,0,5,5
55,86,0,0,2,2
55,86,1,0,1,1
55,86,2,0,2,2
55,86,3,0,2,2
55,86,4,1,4,3
55,86,5,0,4,4
55,86,6,0,2,2
55,87,0,0,1,1
55,87,1,0,1,1
55,87,2,0,4,4
55,87,3,0,3,3
55,87,4,0,2,2
55,87,5,1,4,3
55,87,6,2,6,4
55,88,0,0,3,3
55,88,1,1,4,3
55,88,2,1,4,3
55,88,3,0,1,1
55,88,4,0,3,3
55,88,5,0,3,3
55,88,6,0,3,3
55,89,0,3,5,2
55,89,2,1,3,2
55,89,3,0,1,1
55,89,4,0,2,2
55,89,5,0,3,3
55,89,6,1,5,4
55,90,0,0,2,2
55,90,1,2,3,1
55,90,2,1,5,4
55,90,3,0,4,4
55,90,4,0,1,1
55,90,5,0,2,2
55,90,6,0,5,5
55,91,0,1,5,4
55,91,1,0,4,4
55,91,2,0,3,3
55,91,3,0,1,1
55,91,4,0,4,4
55,91,6,1,5,4
55,92,0,1,4,3
55,92,1,1,4,3
55,92,2,0,3,3
55,92,3,0,5,5
55,92,4,0,4,4
55,92,5,0,6,6
55,92,6,0,4,4
55,93,0,0,7,7
55,93,1,0,5,5
55,93,2,1,3,2
55,93,3,0,2,2
55,93,4,0,1,1
55,93,5,0,5,5
55,93,6,1,10,9
55,94,0,0,5,5
55,94,1,0,5,5
55,94,2,0,3,3
55,94,3,0,6,6
55,94,4,0,6,6
55,94,5,1,6,5
55,94,6,3,9,6
55,95,0,1,5,4
55,95,1,0,1,1
55,95,2,0,6,6
55,95,3,1,3,2
55,95,4,1,6,5
55,95,5,0,5,5
55,95,6,0,6,6
55,96,0,0,3,3
55,96,1,0,3,3
55,96,2,0,5,5
55,96,3,0,2,2
55,96,4,1,7,6
55,96,5,0,6,6
55,96,6,1,12,11
55,97,0,1,3,2
55,97,1,0,4,4
55,97,2,0,2,2
55,97,3,0,6,6
55,97,4,0,3,3
55,97,5,0,5,5
55,97,6,2,7,5
55,98,0,0,4,4
55,98,2,0,3,3
55,98,3,0,5,5
55,98,4,0,6,6
55,98,5,0,7,7
55,98,6,0,4,4
55,99,0,0,4,4
55,99,1,0,3,3
55,99,3,0,2,2
55,99,4,0,11,11
55,99,5,0,9,9
55,99,6,4,8,4
55,100,0,0,7,7
55,100,1,0,4,4
55,100,2,0,3,3
55,100,3,0,5,5
55,100,4,1,4,3
55,100,5,2,6,4
55,100,6,0,8,8
55,101,0,0,6,6
55,101,1,2,11,9
55,101,2,0,6,6
55,101,3,0,3,3
55,101,4,0,7,7
55,101,5,0,9,9
55,101,6,0,3,3
55,102,0,0,7,7
55,102,1,0,4,4
55,102,2,0,4,4
55,102,3,0,15,15
55,102,4,1,12,11
55,102,5,0,13,13
55,102,6,0,10,10
55,103,0,1,8,7
55,103,1,0,6,6
55,103,2,0,8,8
55,103,3,0,6,6
55,103,4,1,9,8
55,103,5,0,3,3
55,103,6,0,13,13
55,104,0,1,8,7
55,104,1,0,7,7
55,104,2,0,5,5
55,104,3,0,3,3
55,104,4,0,5,5
55,104,5,1,7,6
55,104,6,0,4,4
55,105,0,0,1,1
55,105,1,1,4,3
55,105,2,0,8,8
55,105,3,0,1,1
55,105,4,0,3,3
55,105,5,1,8,7
55,105,6,0,4,4
55,106,0,0,5,5
55,106,1,2,4,2
55,106,2,0,5,5
55,106,3,0,7,7
55,106,4,0,6,6
55,106,5,0,3,3
55,106,6,1,6,5
55,107,0,0,5,5
55,107,1,0,8,8
55,107,2,0,3,3
55,107,3,0,5,5
55,107,4,0,3,3
55,107,5,0,5,5
55,107,6,0,7,7
55,108,0,0,4,4
55,108,1,0,4,4
55,108,2,0,3,3
55,108,3,3,8,5
55,108,4,0,1,1
55,108,5,5,12,7
55,108,6,4,20,16
55,109,0,0,5,5
55,109,1,0,3,3
55,109,2,0,7,7
55,109,3,0,5,5
55,109,4,1,5,4
55,109,5,3,8,5
55,109,6,2,6,4
55,110,0,0,2,2
55,110,1,1,3,2
55,110,2,1,3,2
55,110,3,0,4,4
55,110,4,0,6,6
55,110,5,1,4,3
55,110,6,2,6,4
55,111,0,1,7,6
55,111,1,0,2,2
55,111,2,0,7,7
55,111,3,0,4,4
55,111,4,1,5,4
55,111,5,0,5,5
55,111,6,1,7,6
55,112,0,1,7,6
55,112,1,0,4,4
55,112,2,0,4,4
55,112,3,1,5,4
55,112,4,0,6,6
55,112,5,1,10,9
55,112,6,0,6,6
55,113,0,0,11,11
55,113,1,0,8,8
55,113,2,0,5,5
55,113,3,0,7,7
55,113,4,0,4,4
55,113,5,0,6,6
55,113,6,1,6,5
55,114,0,1,2,1
55,114,1,3,9,6
55,114,2,0,2,2
55,114,3,2,5,3
55,114,4,0,6,6
55,114,5,0,6,6
55,114,6,1,8,7
55,115,0,0,5,5
55,115,1,0,10,10
55,115,2,0,3,3
55,115,3,0,4,4
55,115,4,0,4,4
55,115,5,3,6,3
55,115,6,0,8,8
55,116,0,1,4,3
55,116,1,0,4,4
55,116,2,0,4,4
55,116,3,0,1,1
55,116,4,0,10,10
55,116,5,0,10,10
55,116,6,1,5,4
55,117,0,0,3,3
55,117,1,0,3,3
55,117,2,0,4,4
55,117,3,0,5,5
55,117,4,0,7,7
55,117,5,1,8,7
55,117,6,3,16,13
55,118,0,0,2,2
55,118,1,1,7,6
55,118,2,0,2,2
55,118,3,0,4,4
55,118,4,0,7,7
55,118,5,0,6,6
55,118,6,0,6,6
55,119,0,0,3,3
55,119,1,1,8,7
55,119,2,1,4,3
55,119,3,0,2,2
55,119,4,2,2,0
55,119,5,2,7,5
55,119,6,0,6,6
55,120,0,0,6,6
55,120,1,0,7,7
55,120,2,2,7,5
55,120,3,0,4,4
55,120,4,0,8,8
55,120,5,0,11,11
55,120,6,0,5,5
55,121,0,0,6,6
55,121,1,1,11,10
55,121,2,0,3,3
55,121,3,0,2,2
55,121,4,1,8,7
55,121,5,0,7,7
55,121,6,2,10,8
55,122,0,0,8,8
55,122,1,0,7,7
55,122,2,0,3,3
55,122,3,0,3,3
55,122,4,1,9,8
55,122,5,3,7,4
55,122,6,0,9,9
55,123,0,0,9,9
55,123,1,2,9,7
55,123,2,0,6,6
55,123,3,1,9,8
55,123,4,0,7,7
55,123,5,1,13,12
55,123,6,0,9,9
55,124,0,0,4,4
55,124,1,0,5,5
55,124,2,0,2,2
55,124,3,0,7,7
55,124,4,0,11,11
55,124,5,1,10,9
55,124,6,0,3,3
55,125,0,0,3,3
55,125,1,0,2,2
55,125,2,0,1,1
55,125,3,0,4,4
55,125,4,0,5,5
55,125,5,2,8,6
55,125,6,0,8,8
55,126,0,0,2,2
55,126,1,2,8,6
55,126,2,0,8,8
55,126,3,0,8,8
55,126,4,0,8,8
55,126,5,0,13,13
55,126,6,1,7,6
55,127,0,0,4,4
55,127,1,0,11,11
55,127,2,0,7,7
55,127,3,0,3,3
55,127,4,0,5,5
55,127,5,2,17,15
55,127,6,1,17,16
55,128,0,1,11,10
55,128,1,2,9,7
55,128,2,1,6,5
55,128,3,0,5,5
55,128,4,0,9,9
55,128,5,0,7,7
55,128,6,0,6,6
55,129,0,0,5,5
55,129,1,0,7,7
55,129,2,0,6,6
55,129,3,0,10,10
55,129,4,0,9,9
55,129,5,0,13,13
55,129,6,0,8,8
55,130,0,1,12,11
55,130,1,0,7,7
55,130,2,0,6,6
55,130,3,0,4,4
55,130,4,0,3,3
55,130,5,0,11,11
55,130,6,0,6,6
55,131,0,1,14,13
55,131,1,0,5,5
55,131,2,0,3,3
55,131,3,1,3,2
55,131,4,0,10,10
55,131,5,0,8,8
55,131,6,1,12,11
55,132,0,0,5,5
55,132,1,0,5,5
55,132,2,0,4,4
55,132,3,0,2,2
55,132,4,3,14,11
55,132,5,1,6,5
55,132,6,0,11,11
55,133,0,0,10,10
55,133,1,0,3,3
55,133,2,0,7,7
55,133,3,0,9,9
55,133,4,1,7,6
55,133,5,0,11,11
55,133,6,1,6,5
55,134,0,0,13,13
55,134,1,0,6,6
55,134,2,0,4,4
55,134,3,0,4,4
55,134,4,0,6,6
55,134,5,0,5,5
55,134,6,0,5,5
55,135,0,0,7,7
55,135,1,0,2,2
55,135,2,1,17,16
55,135,3,0,4,4
55,135,4,0,10,10
55,135,5,0,4,4
55,135,6,0,15,15
55,136,0,0,2,2
55,136,1,0,5,5
55,136,2,1,5,4
55,136,3,0,5,5
55,136,4,0,11,11
55,136,5,0,3,3
55,136,6,0,4,4
55,137,0,0,7,7
55,137,1,0,8,8
55,137,2,0,8,8
55,137,3,0,7,7
55,137,4,0,6,6
55,137,5,1,5,4
55,137,6,0,7,7
55,138,0,1,7,6
55,138,1,0,5,5
55,138,2,0,5,5
55,138,3,2,9,7
55,138,4,0,1,1
55,138,5,1,14,13
55,138,6,2,13,11
55,139,0,1,8,7
55,139,1,2,8,6
55,139,2,0,7,7
55,139,3,0,5,5
55,139,4,2,15,13
55,139,5,2,12,10
55,139,6,0,11,11
55,140,0,1,5,4
55,140,1,1,8,7
55,140,2,0,4,4
55,140,3,0,7,7
55,140,4,0,5,5
55,140,5,0,7,7
55,140,6,1,5,4
55,141,0,0,6,6
55,141,1,0,3,3
55,141,2,1,8,7
55,141,3,0,1,1
55,141,4,1,10,9
55,141,5,1,12,11
55,141,6,0,6,6
55,142,0,0,10,10
55,142,1,4,8,4
55,142,2,0,4,4
55,142,3,4,13,9
55,142,4,2,13,11
55,142,5,0,9,9
55,142,6,0,12,12
55,143,0,0,5,5
55,143,1,4,8,4
55,143,2,3,8,5
55,143,3,3,6,3
55,143,4,5,11,6
55,143,5,6,12,6
55,143,6,2,10,8
56,0,0,0,2,2
56,0,2,1,2,1
56,0,3,3,6,3
56,0,4,0,3,3
56,0,5,1,3,2
56,1,0,4,5,1
56,1,2,1,5,4
56,1,3,0,1,1
56,1,4,0,1,1
56,1,6,1,2,1
56,2,0,4,4,0
56,2,1,0,1,1
56,2,2,0,1,1
56,2,4,3,4,1
56,2,5,1,2,1
56,2,6,4,5,1
56,3,0,0,1,1
56,3,1,4,5,1
56,3,2,0,1,1
56,3,4,7,8,1
56,3,6,1,2,1
56,4,1,4,7,3
56,4,2,2,4,2
56,4,3,1,2,1
56,4,5,0,1,1
56,4,6,1,2,1
56,5,0,0,1,1
56,5,1,1,1,0
56,5,4,1,2,1
56,5,6,5,5,0
56,6,1,1,1,0
56,6,2,0,1,1
56,6,3,2,2,0
56,6,5,1,3,2
56,6,6,0,5,5
56,7,2,1,3,2
56,7,3,0,1,1
56,7,5,0,1,1
56,7,6,1,1,0
56,8,0,0,1,1
56,8,1,2,2,0
56,8,3,4,5,1
56,8,6,0,1,1
56,9,1,1,2,1
56,9,3,2,2,0
56,9,5,2,3,1
56,9,6,0,1,1
56,10,1,2,3,1
56,10,3,2,3,1
56,11,1,4,4,0
56,11,2,1,1,0
56,11,4,0,2,2
56,11,5,1,3,2
56,11,6,1,1,0
56,12,1,2,2,0
56,13,1,1,1,0
56,13,2,1,1,0
56,13,4,2,3,1
56,14,1,0,2,2
56,14,3,1,1,0
56,15,1,1,2,1
56,15,3,1,1,0
56,15,6,2,3,1
56,16,6,0,1,1
56,18,2,1,1,0
56,18,3,1,2,1
56,18,6,1,1,0
56,19,2,2,3,1
56,19,5,1,2,1
56,20,4,3,4,1
56,20,6,1,1,0
56,21,2,2,2,0
56,21,4,3,3,0
56,21,6,1,1,0
56,22,0,1,1,0
56,22,4,1,1,0
56,23,2,1,1,0
56,23,3,1,1,0
56,24,0,1,1,0
56,24,3,2,3,1
56,25,2,0,1,1
56,25,3,1,1,0
56,26,0,1,1,0
56,26,3,1,1,0
56,27,0,2,2,0
56,28,2,1,1,0
56,28,3,1,1,0
56,29,0,1,1,0
56,29,3,2,2,0
56,30,0,1,1,0
56,31,0,1,1,0
56,31,2,2,2,0
56,31,5,1,1,0
56,31,6,2,3,1
56,32,2,5,6,1
56,32,3,0,1,1
56,32,6,1,1,0
56,33,2,1,2,1
56,33,4,1,2,1
56,33,5,2,2,0
56,33,6,1,1,0
56,34,2,2,3,1
56,34,3,2,3,1
56,34,4,1,2,1
56,34,5,1,1,0
56,34,6,0,1,1
56,35,0,0,1,1
56,35,1,1,1,0
56,35,2,1,1,0
56,35,3,1,2,1
56,35,4,2,5,3
56,35,5,2,2,0
56,36,1,2,2,0
56,36,3,1,1,0
56,36,4,9,10,1
56,36,5,0,1,1
56,37,0,0,1,1
56,37,1,0,1,1
56,37,3,1,1,0
56,37,4,3,4,1
56,37,6,1,1,0
56,38,0,2,3,1
56,38,1,0,3,3
56,38,2,0,1,1
56,38,3,2,3,1
56,38,4,0,1,1
56,38,6,5,5,0
56,39,0,1,4,3
56,39,1,1,6,5
56,39,2,2,7,5
56,39,3,0,2,2
56,39,4,0,2,2
56,39,5,1,1,0
56,39,6,5,8,3
56,40,0,1,4,3
56,40,1,2,6,4
56,40,3,1,7,6
56,40,4,0,3,3
56,40,5,2,3,1
56,40,6,1,3,2
56,41,0,1,6,5
56,41,1,1,6,5
56,41,2,0,3,3
56,41,3,0,2,2
56,41,4,0,1,1
56,41,5,0,5,5
56,41,6,2,4,2
56,42,0,1,9,8
56,42,1,3,20,17
56,42,2,0,7,7
56,42,3,0,11,11
56,42,4,0,4,4
56,42,5,0,7,7
56,42,6,2,8,6
56,43,0,3,15,12
56,43,1,2,14,12
56,43,2,1,9,8
56,43,3,4,19,15
56,43,4,3,12,9
56,43,5,2,4,2
56,43,6,0,4,4
56,44,0,2,18,16
56,44,1,2,12,10
56,44,2,0,8,8
56,44,3,3,14,11
56,44,4,5,21,16
56,44,5,0,3,3
56,44,6,0,6,6
56,45,0,1,25,24
56,45,1,1,22,21
56,45,2,0,13,13
56,45,3,2,11,9
56,45,4,4,19,15
56,45,5,1,7,6
56,45,6,1,7,6
56,46,0,4,25,21
56,46,1,3,31,28
56,46,2,2,27,25
56,46,3,11,36,25
56,46,4,0,18,18
56,46,5,0,9,9
56,46,6,2,16,14
56,47,0,4,26,22
56,47,1,1,23,22
56,47,2,2,35,33
56,47,3,5,30,25
56,47,4,2,29,27
56,47,5,0,13,13
56,47,6,1,10,9
56,48,0,4,23,19
56,48,1,2,15,13
56,48,2,2,32,30
56,48,3,6,23,17
56,48,4,3,19,16
56,48,5,0,14,14
56,48,6,0,13,13
56,49,0,4,23,19
56,49,1,0,15,15
56,49,2,1,13,12
56,49,3,3,13,10
56,49,4,3,9,6
56,49,5,1,10,9
56,49,6,0,7,7
56,50,0,0,18,18
56,50,1,4,21,17
56,50,2,4,14,10
56,50,3,1,13,12
56,50,4,0,16,16
56,50,5,0,14,14
56,50,6,0,11,11
56,51,0,2,23,21
56,51,1,8,30,22
56,51,2,2,26,24
56,51,3,1,18,17
56,51,4,1,20,19
56,51,5,0,8,8
56,51,6,0,14,14
56,52,0,3,24,21
56,52,1,1,13,12
56,52,2,0,13,13
56,52,3,5,16,11
56,52,4,5,22,17
56,52,5,0,11,11
56,52,6,2,13,11
56,53,0,4,15,11
56,53,1,2,22,20
56,53,2,1,12,11
56,53,3,1,13,12
56,53,4,1,19,18
56,53,5,1,18,17
56,53,6,0,8,8
56,54,0,1,24,23
56,54,1,1,6,5
56,54,2,1,15,14
56,54,3,1,17,16
56,54,4,2,24,22
56,54,5,1,12,11
56,54,6,0,10,10
56,55,0,0,9,9
56,55,1,0,11,11
56,55,2,1,6,5
56,55,3,0,13,13
56,55,4,3,22,19
56,55,5,2,14,12
56,55,6,0,9,9
56,56,0,3,16,13
56,56,1,0,18,18
56,56,2,1,13,12
56,56,3,3,14,11
56,56,4,5,14,9
56,56,5,0,12,12
56,56,6,2,8,6
56,57,0,3,9,6
56,57,1,5,12,7
56,57,2,0,9,9
56,57,3,2,15,13
56,57,4,2,12,10
56,57,5,1,12,11
56,57,6,3,12,9
56,58,0,5,12,7
56,58,1,0,12,12
56,58,2,0,7,7
56,58,3,0,2,2
56,58,4,1,11,10
56,58,5,0,11,11
56,58,6,1,14,13
56,59,0,3,7,4
56,59,1,4,14,10
56,59,2,0,6,6
56,59,3,0,8,8
56,59,4,3,13,10
56,59,5,0,10,10
56,59,6,1,12,11
56,60,0,6,15,9
56,60,1,1,8,7
56,60,2,0,6,6
56,60,3,3,17,14
56,60,4,1,16,15
56,60,5,0,11,11
56,60,6,0,7,7
56,61,0,4,14,10
56,61,1,0,8,8
56,61,2,1,14,13
56,61,3,1,12,11
56,61,4,2,16,14
56,61,5,0,17,17
56,61,6,2,6,4
56,62,0,3,14,11
56,62,1,1,12,11
56,62,2,0,13,13
56,62,3,1,12,11
56,62,4,1,17,16
56,62,5,1,16,15
56,62,6,1,13,12
56,63,0,2,6,4
56,63,1,3,15,12
56,63,2,0,11,11
56,63,3,0,7,7
56,63,4,0,10,10
56,63,5,2,20,18
56,63,6,3,19,16
56,64,0,5,15,10
56,64,1,1,8,7
56,64,2,3,15,12
56,64,3,1,7,6
56,64,4,1,11,10
56,64,5,4,13,9
56,64,6,1,11,10
56,65,0,1,14,13
56,65,1,1,5,4
56,65,2,0,7,7
56,65,3,5,17,12
56,65,4,0,19,19
56,65,5,1,24,23
56,65,6,0,7,7
56,66,0,0,13,13
56,66,1,0,6,6
56,66,2,0,6,6
56,66,3,4,18,14
56,66,4,1,22,21
56,66,5,2,25,23
56,66,6,2,8,6
56,67,0,4,16,12
56,67,1,0,10,10
56,67,2,1,8,7
56,67,3,0,12,12
56,67,4,0,18,18
56,67,5,0,13,13
56,67,6,1,24,23
56,68,0,2,16,14
56,68,1,0,7,7
56,68,2,2,13,11
56,68,3,1,8,7
56,68,4,3,12,9
56,68,5,1,8,7
56,68,6,0,20,20
56,69,0,0,12,12
56,69,1,7,20,13
56,69,2,4,13,9
56,69,3,3,19,16
56,69,4,2,12,10
56,69,5,2,9,7
56,69,6,5,24,19
56,70,0,3,11,8
56,70,1,2,17,15
56,70,2,1,10,9
56,70,3,0,12,12
56,70,4,3,32,29
56,70,5,0,17,17
56,70,6,3,30,27
56,71,0,3,15,12
56,71,1,0,12,12
56,71,2,2,16,14
56,71,3,2,12,10
56,71,4,3,20,17
56,71,5,3,21,18
56,71,6,7,26,19
56,72,0,1,13,12
56,72,1,4,11,7
56,72,2,1,9,8
56,72,3,4,20,16
56,72,4,5,23,18
56,72,5,3,21,18
56,72,6,3,19,16
56,73,0,1,10,9
56,73,1,0,9,9
56,73,2,1,21,20
56,73,3,2,18,16
56,73,4,1,14,13
56,73,5,3,14,11
56,73,6,0,18,18
56,74,0,0,14,14
56,74,1,1,13,12
56,74,2,2,14,12
56,74,3,1,17,16
56,74,4,4,21,17
56,74,5,0,12,12
56,74,6,0,14,14
56,75,0,4,24,20
56,75,1,1,20,19
56,75,2,0,11,11
56,75,3,2,11,9
56,75,4,5,20,15
56,75,5,1,23,22
56,75,6,1,20,19
56,76,0,1,14,13
56,76,1,8,25,17
56,76,2,4,11,7
56,76,3,3,18,15
56,76,4,2,15,13
56,76,5,2,19,17
56,76,6,4,19,15
56,77,0,6,19,13
56,77,1,5,13,8
56,77,2,0,15,15
56,77,3,4,14,10
56,77,4,0,17,17
56,77,5,3,21,18
56,77,6,3,28,25
56,78,0,2,12,10
56,78,1,1,12,11
56,78,2,3,12,9
56,78,3,0,5,5
56,78,4,1,11,10
56,78,5,3,26,23
56,78,6,0,19,19
56,79,0,6,18,12
56,79,1,2,19,17
56,79,2,1,14,13
56,79,3,0,5,5
56,79,4,0,9,9
56,79,5,3,30,27
56,79,6,1,22,21
56,80,0,0,9,9
56,80,1,1,12,11
56,80,2,1,8,7
56,80,3,2,13,11
56,80,4,2,18,16
56,80,5,4,20,16
56,80,6,3,21,18
56,81,0,0,7,7
56,81,1,4,12,8
56,81,2,3,14,11
56,81,3,3,14,11
56,81,4,2,11,9
56,81,5,2,23,21
56,81,6,2,21,19
56,82,0,2,12,10
56,82,1,3,9,6
56,82,2,1,10,9
56,82,3,3,12,9
56,82,4,1,17,16
56,82,5,1,12,11
56,82,6,1,12,11
56,83,0,6,17,11
56,83,1,5,20,15
56,83,2,2,8,6
56,83,3,10,22,12
56,83,4,2,19,17
56,83,5,3,21,18
56,83,6,2,16,14
56,84,0,1,12,11
56,84,1,3,9,6
56,84,2,4,18,14
56,84,3,8,20,12
56,84,4,4,18,14
56,84,5,5,30,25
56,84,6,0,21,21
56,85,0,0,11,11
56,85,1,2,16,14
56,85,2,1,10,9
56,85,3,1,19,18
56,85,4,2,18,16
56,85,5,0,10,10
56,85,6,5,26,21
56,86,0,2,17,15
56,86,1,5,20,15
56,86,2,4,23,19
56,86,3,0,17,17
56,86,4,4,23,19
56,86,5,7,21,14
56,86,6,2,22,20
56,87,0,3,13,10
56,87,1,4,16,12
56,87,2,5,18,13
56,87,3,3,17,14
56,87,4,3,19,16
56,87,5,1,33,32
56,87,6,0,17,17
56,88,0,1,12,11
56,88,1,4,21,17
56,88,2,5,19,14
56,88,3,6,24,18
56,88,4,3,18,15
56,88,5,0,22,22
56,88,6,3,22,19
56,89,0,1,14,13
56,89,1,3,14,11
56,89,2,0,7,7
56,89,3,11,19,8
56,89,4,9,25,16
56,89,5,5,19,14
56,89,6,2,26,24
56,90,0,8,20,12
56,90,1,5,23,18
56,90,2,4,16,12
56,90,3,7,18,11
56,90,4,1,21,20
56,90,5,5,24,19
56,90,6,7,24,17
56,91,0,7,24,17
56,91,1,1,10,9
56,91,2,5,13,8
56,91,3,7,23,16
56,91,4,4,24,20
56,91,5,1,20,19
56,91,6,2,30,28
56,92,0,5,23,18
56,92,1,4,16,12
56,92,2,1,9,8
56,92,3,4,11,7
56,92,4,3,22,19
56,92,5,0,20,20
56,92,6,5,29,24
56,93,0,1,12,11
56,93,1,1,20,19
56,93,2,1,15,14
56,93,3,1,21,20
56,93,4,2,19,17
56,93,5,4,26,22
56,93,6,6,28,22
56,94,0,0,12,12
56,94,1,6,26,20
56,94,2,0,14,14
56,94,3,0,7,7
56,94,4,0,23,23
56,94,5,5,27,22
56,94,6,15,45,30
56,95,0,1,17,16
56,95,1,6,25,19
56,95,2,2,18,16
56,95,3,4,28,24
56,95,4,2,29,27
56,95,5,0,28,28
56,95,6,4,25,21
56,96,0,2,22,20
56,96,1,6,30,24
56,96,2,1,23,22
56,96,3,3,21,18
56,96,4,3,28,25
56,96,5,2,28,26
56,96,6,2,29,27
56,97,0,1,12,11
56,97,1,4,35,31
56,97,2,5,18,13
56,97,3,6,24,18
56,97,4,1,30,29
56,97,5,5,35,30
56,97,6,1,24,23
56,98,0,5,27,22
56,98,1,9,27,18
56,98,2,2,27,25
56,98,3,3,32,29
56,98,4,12,43,31
56,98,5,15,45,30
56,98,6,1,32,31
56,99,0,5,27,22
56,99,1,4,33,29
56,99,2,1,26,25
56,99,3,2,35,33
56,99,4,12,44,32
56,99,5,7,36,29
56,99,6,2,40,38
56,100,0,1,14,13
56,100,1,4,18,14
56,100,2,1,12,11
56,100,3,2,25,23
56,100,4,14,30,16
56,100,5,2,24,22
56,100,6,3,27,24
56,101,0,1,12,11
56,101,1,1,19,18
56,101,2,0,24,24
56,101,3,1,25,24
56,101,4,7,33,26
56,101,5,14,33,19
56,101,6,1,24,23
56,102,0,4,27,23
56,102,1,0,23,23
56,102,2,1,30,29
56,102,3,0,27,27
56,102,4,8,28,20
56,102,5,8,51,43
56,102,6,2,32,30
56,103,0,3,21,18
56,103,1,1,15,14
56,103,2,1,27,26
56,103,3,6,32,26
56,103,4,6,28,22
56,103,5,3,33,30
56,103,6,0,29,29
56,104,0,2,26,24
56,104,1,4,25,21
56,104,2,2,20,18
56,104,3,1,32,31
56,104,4,6,42,36
56,104,5,0,23,23
56,104,6,0,23,23
56,105,0,1,16,15
56,105,1,3,27,24
56,105,2,5,26,21
56,105,3,1,29,28
56,105,4,1,32,31
56,105,5,1,21,20
56,105,6,5,28,23
56,106,0,5,27,22
56,106,1,1,16,15
56,106,2,0,18,18
56,106,3,2,19,17
56,106,4,8,33,25
56,106,5,6,36,30
56,106,6,2,32,30
56,107,0,4,22,18
56,107,1,0,19,19
56,107,2,4,29,25
56,107,3,1,18,17
56,107,4,5,24,19
56,107,5,1,19,18
56,107,6,4,27,23
56,108,0,3,25,22
56,108,1,1,18,17
56,108,2,3,14,11
56,108,3,0,19,19
56,108,4,4,33,29
56,108,5,5,29,24
56,108,6,0,13,13
56,109,0,5,22,17
56,109,1,0,13,13
56,109,2,1,17,16
56,109,3,3,14,11
56,109,4,3,23,20
56,109,5,4,20,16
56,109,6,2,19,17
56,110,0,1,17,16
56,110,1,1,15,14
56,110,2,2,22,20
56,110,3,1,15,14
56,110,4,1,16,15
56,110,5,5,28,23
56,110,6,0,18,18
56,111,0,2,16,14
56,111,1,1,15,14
56,111,2,2,13,11
56,111,3,1,17,16
56,111,4,5,21,16
56,111,5,9,38,29
56,111,6,1,17,16
56,112,0,0,10,10
56,112,1,4,24,20
56,112,2,2,22,20
56,112,3,1,9,8
56,112,4,0,11,11
56,112,5,2,17,15
56,112,6,9,23,14
56,113,0,1,14,13
56,113,1,1,16,15
56,113,2,0,22,22
56,113,3,0,13,13
56,113,4,0,17,17
56,113,5,2,25,23
56,113,6,5,31,26
56,114,0,7,22,15
56,114,1,1,15,14
56,114,2,1,12,11
56,114,3,1,26,25
56,114,4,5,30,25
56,114,5,7,22,15
56,114,6,3,15,12
56,115,0,2,18,16
56,115,1,3,17,14
56,115,2,2,15,13
56,115,3,1,13,12
56,115,4,1,13,12
56,115,5,1,15,14
56,115,6,6,14,8
56,116,0,5,20,15
56,116,1,2,13,11
56,116,2,6,26,20
56,116,3,1,13,12
56,116,4,0,16,16
56,116,5,5,28,23
56,116,6,5,21,16
56,117,0,2,17,15
56,117,1,2,19,17
56,117,2,3,15,12
56,117,3,4,19,15
56,117,4,6,23,17
56,117,5,5,19,14
56,117,6,2,15,13
56,118,0,1,21,20
56,118,1,0,16,16
56,118,2,5,19,14
56,118,3,7,17,10
56,118,4,2,18,16
56,118,5,6,15,9
56,118,6,3,13,10
56,119,0,2,14,12
56,119,1,7,24,17
56,119,2,9,20,11
56,119,3,5,17,12
56,119,4,3,20,17
56,119,5,7,21,14
56,119,6,1,9,8
56,120,0,4,18,14
56,120,1,3,21,18
56,120,2,2,15,13
56,120,3,3,22,19
56,120,4,2,14,12
56,120,5,5,11,6
56,120,6,2,7,5
56,121,0,2,19,17
56,121,1,5,19,14
56,121,2,0,15,15
56,121,3,2,13,11
56,121,4,0,18,18
56,121,5,9,20,11
56,121,6,5,31,26
56,122,0,1,16,15
56,122,1,4,9,5
56,122,2,3,15,12
56,122,3,1,11,10
56,122,4,11,28,17
56,122,5,5,21,16
56,122,6,0,29,29
56,123,0,1,15,14
56,123,1,6,18,12
56,123,2,3,11,8
56,123,3,0,8,8
56,123,4,3,22,19
56,123,5,1,11,10
56,123,6,4,18,14
56,124,0,2,12,10
56,124,1,4,16,12
56,124,2,7,17,10
56,124,3,1,14,13
56,124,4,3,22,19
56,124,5,0,12,12
56,124,6,0,9,9
56,125,0,0,13,13
56,125,1,0,7,7
56,125,2,3,13,10
56,125,3,2,14,12
56,125,4,3,17,14
56,125,5,4,14,10
56,125,6,3,17,14
56,126,0,8,20,12
56,126,1,0,9,9
56,126,2,0,12,12
56,126,3,5,17,12
56,126,4,8,17,9
56,126,5,4,18,14
56,126,6,3,23,20
56,127,0,3,13,10
56,127,1,1,11,10
56,127,2,14,28,14
56,127,3,2,11,9
56,127,4,4,18,14
56,127,5,4,14,10
56,127,6,1,8,7
56,128,0,2,11,9
56,128,1,3,14,11
56,128,2,7,16,9
56,128,3,3,10,7
56,128,4,10,20,10
56,128,5,0,14,14
56,128,6,1,9,8
56,129,0,3,9,6
56,129,1,8,16,8
56,129,2,4,15,11
56,129,3,1,5,4
56,129,4,9,18,9
56,129,5,3,19,16
56,129,6,1,10,9
56,130,0,4,15,11
56,130,1,3,16,13
56,130,2,0,4,4
56,130,3,2,9,7
56,130,4,7,14,7
56,130,5,2,8,6
56,130,6,1,6,5
56,131,0,0,8,8
56,131,1,1,8,7
56,131,2,7,15,8
56,131,3,1,8,7
56,131,4,1,7,6
56,131,5,0,6,6
56,131,6,1,5,4
56,132,0,0,8,8
56,132,1,4,12,8
56,132,2,6,12,6
56,132,3,2,7,5
56,132,4,1,8,7
56,132,5,1,5,4
56,132,6,0,10,10
56,133,0,1,11,10
56,133,1,0,2,2
56,133,2,3,5,2
56,133,3,0,6,6
56,133,4,0,4,4
56,133,5,2,7,5
56,133,6,2,6,4
56,134,0,0,6,6
56,134,1,2,6,4
56,134,2,6,12,6
56,134,3,3,13,10
56,134,5,1,5,4
56,134,6,0,5,5
56,135,0,2,6,4
56,135,1,5,10,5
56,135,2,1,6,5
56,135,3,0,4,4
56,135,4,2,11,9
56,135,5,0,9,9
56,135,6,0,2,2
56,136,0,0,1,1
56,136,1,2,3,1
56,136,2,0,5,5
56,136,3,3,7,4
56,136,4,1,8,7
56,136,5,2,12,10
56,136,6,1,3,2
56,137,0,0,4,4
56,137,1,5,16,11
56,137,2,3,8,5
56,137,3,0,3,3
56,137,4,1,8,7
56,137,5,0,5,5
56,137,6,2,12,10
56,138,0,2,4,2
56,138,1,2,4,2
56,138,2,4,10,6
56,138,3,3,9,6
56,138,4,5,6,1
56,138,5,0,3,3
56,138,6,3,9,6
56,139,0,0,1,1
56,139,1,1,5,4
56,139,2,4,13,9
56,139,3,5,8,3
56,139,4,0,3,3
56,139,5,3,7,4
56,139,6,0,1,1
56,140,0,0,2,2
56,140,1,0,2,2
56,140,3,4,6,2
56,140,4,0,4,4
56,140,5,1,2,1
56,140,6,0,3,3
56,141,0,2,3,1
56,141,1,0,3,3
56,141,2,1,4,3
56,141,3,1,4,3
56,141,4,0,1,1
56,141,5,0,4,4
56,141,6,0,2,2
56,142,0,3,5,2
56,142,1,0,1,1
56,142,2,1,1,0
56,142,3,3,7,4
56,142,4,0,1,1
56,142,5,2,3,1
56,142,6,2,6,4
56,143,0,0,1,1
56,143,1,7,15,8
56,143,2,0,3,3
56,143,3,0,4,4
56,143,4,0,1,1
56,143,5,0,1,1
56,143,6,0,2,2
57,0,0,0,9,9
57,0,1,1,13,12
57,0,2,4,19,15
57,0,3,0,11,11
57,0,4,1,15,14
57,0,5,1,16,15
57,0,6,1,14,13
57,1,0,0,10,10
57,1,1,2,14,12
57,1,2,0,6,6
57,1,3,3,13,10
57,1,4,2,16,14
57,1,5,0,12,12
57,1,6,2,15,13
57,2,0,0,9,9
57,2,1,1,9,8
57,2,2,4,8,4
57,2,3,1,10,9
57,2,4,3,25,22
57,2,5,1,7,6
57,2,6,0,10,10
57,3,0,0,11,11
57,3,1,4,10,6
57,3,2,2,10,8
57,3,3,2,10,8
57,3,4,0,9,9
57,3,5,3,11,8
57,3,6,2,10,8
57,4,0,0,5,5
57,4,1,3,6,3
57,4,2,0,5,5
57,4,3,1,8,7
57,4,4,0,7,7
57,4,5,2,8,6
57,4,6,0,8,8
57,5,0,3,9,6
57,5,1,0,2,2
57,5,2,1,8,7
57,5,3,1,12,11
57,5,4,1,14,13
57,5,5,3,7,4
57,5,6,0,4,4
57,6,0,0,3,3
57,6,1,1,5,4
57,6,2,0,5,5
57,6,3,1,12,11
57,6,4,0,6,6
57,6,5,4,9,5
57,6,6,0,4,4
57,7,0,0,2,2
57,7,1,0,5,5
57,7,2,0,5,5
57,7,3,1,3,2
57,7,4,1,7,6
57,7,5,0,5,5
57,7,6,0,4,4
57,8,0,1,4,3
57,8,1,0,2,2
57,8,2,1,6,5
57,8,3,0,5,5
57,8,4,2,8,6
57,8,5,4,11,7
57,8,6,3,8,5
57,9,0,2,5,3
57,9,2,0,1,1
57,9,3,2,6,4
57,9,4,1,8,7
57,9,5,3,6,3
57,9,6,2,3,1
57,10,0,1,6,5
57,10,1,1,1,0
57,10,2,0,1,1
57,10,3,0,3,3
57,10,4,1,3,2
57,10,5,0,3,3
57,10,6,1,5,4
57,11,0,0,4,4
57,11,1,0,1,1
57,11,2,1,4,3
57,11,3,0,4,4
57,11,4,1,10,9
57,11,5,2,3,1
57,11,6,1,4,3
57,12,0,3,6,3
57,12,1,0,2,2
57,12,2,1,3,2
57,12,3,1,3,2
57,12,4,1,2,1
57,12,5,1,5,4
57,12,6,1,5,4
57,13,0,1,4,3
57,13,2,3,6,3
57,13,3,3,6,3
57,13,4,4,4,0
57,13,5,5,8,3
57,13,6,1,3,2
57,14,0,4,6,2
57,14,1,2,2,0
57,14,2,1,3,2
57,14,3,0,1,1
57,14,5,2,5,3
57,15,1,2,3,1
57,15,2,0,3,3
57,15,5,1,3,2
57,15,6,0,2,2
57,16,0,2,3,1
57,16,1,0,1,1
57,16,2,0,1,1
57,16,3,0,1,1
57,16,4,4,6,2
57,16,6,0,1,1
57,17,0,4,5,1
57,17,2,0,1,1
57,17,4,2,3,1
57,17,5,1,2,1
57,17,6,3,4,1
57,18,1,0,1,1
57,18,2,0,1,1
57,18,3,0,2,2
57,18,5,1,1,0
57,18,6,1,2,1
57,19,1,0,1,1
57,19,4,1,2,1
57,19,5,1,2,1
57,19,6,0,1,1
57,20,0,0,1,1
57,20,1,0,2,2
57,20,2,0,1,1
57,20,3,1,2,1
57,20,5,0,1,1
57,20,6,1,2,1
57,21,0,1,1,0
57,21,2,0,1,1
57,21,3,1,1,0
57,21,4,1,2,1
57,22,4,2,2,0
57,22,5,0,1,1
57,23,0,2,2,0
57,23,2,0,2,2
57,23,3,1,1,0
57,23,4,0,1,1
57,23,5,2,2,0
57,24,4,3,3,0
57,24,5,0,1,1
57,24,6,3,3,0
57,25,0,1,1,0
57,25,2,0,1,1
57,25,4,0,1,1
57,25,6,3,4,1
57,26,2,0,1,1
57,26,3,0,1,1
57,26,5,1,1,0
57,26,6,2,3,1
57,27,3,2,3,1
57,27,5,0,1,1
57,27,6,0,2,2
57,28,2,1,3,2
57,28,3,1,1,0
57,29,1,1,1,0
57,29,3,0,1,1
57,29,4,1,1,0
57,29,6,2,2,0
57,30,0,0,1,1
57,30,5,1,1,0
57,31,2,0,1,1
57,31,4,1,2,1
57,31,6,0,1,1
57,32,0,0,1,1
57,32,1,1,2,1
57,32,4,0,1,1
57,32,5,0,2,2
57,32,6,1,1,0
57,33,0,1,3,2
57,33,1,0,2,2
57,33,2,3,4,1
57,33,4,1,1,0
57,33,6,0,1,1
57,34,0,1,1,0
57,34,1,2,3,1
57,34,2,0,3,3
57,34,3,1,3,2
57,34,5,1,2,1
57,34,6,2,2,0
57,35,0,5,8,3
57,35,1,0,3,3
57,35,2,1,1,0
57,35,3,0,1,1
57,35,4,1,1,0
57,36,0,5,9,4
57,36,1,2,6,4
57,36,2,2,4,2
57,36,3,2,5,3
57,36,4,0,3,3
57,36,5,3,4,1
57,36,6,0,1,1
57,37,0,2,8,6
57,37,1,1,4,3
57,37,2,1,5,4
57,37,3,3,9,6
57,37,4,3,9,6
57,37,5,3,4,1
57,37,6,1,5,4
57,38,0,1,8,7
57,38,1,3,8,5
57,38,2,1,14,13
57,38,3,0,6,6
57,38,4,0,7,7
57,38,5,2,8,6
57,38,6,1,9,8
57,39,0,0,15,15
57,39,1,0,9,9
57,39,2,0,11,11
57,39,3,0,9,9
57,39,4,0,8,8
57,39,5,0,10,10
57,39,6,0,9,9
57,40,0,0,22,22
57,40,1,1,19,18
57,40,2,0,15,15
57,40,3,0,15,15
57,40,4,0,7,7
57,40,5,1,9,8
57,40,6,1,9,8
57,41,0,0,32,32
57,41,1,0,21,21
57,41,2,1,31,30
57,41,3,0,19,19
57,41,4,2,15,13
57,41,5,3,20,17
57,41,6,1,16,15
57,42,0,0,39,39
57,42,1,1,40,39
57,42,2,0,38,38
57,42,3,0,33,33
57,42,4,1,29,28
57,42,5,2,17,15
57,42,6,1,15,14
57,43,0,1,41,40
57,43,1,0,49,49
57,43,2,1,55,54
57,43,3,1,54,53
57,43,4,2,40,38
57,43,5,0,23,23
57,43,6,0,12,12
57,44,0,1,57,56
57,44,1,3,55,52
57,44,2,2,72,70
57,44,3,1,57,56
57,44,4,3,42,39
57,44,5,0,34,34
57,44,6,2,26,24
57,45,0,2,69,67
57,45,1,1,63,62
57,45,2,2,81,79
57,45,3,2,90,88
57,45,4,2,62,60
57,45,5,2,42,40
57,45,6,2,34,32
57,46,0,1,85,84
57,46,1,0,89,89
57,46,2,0,83,83
57,46,3,3,70,67
57,46,4,4,68,64
57,46,5,1,38,37
57,46,6,1,41,40
57,47,0,6,82,76
57,47,1,2,95,93
57,47,2,1,90,89
57,47,3,1,66,65
57,47,4,1,58,57
57,47,5,0,41,41
57,47,6,0,40,40
57,48,0,5,96,91
57,48,1,2,112,110
57,48,2,1,98,97
57,48,3,3,117,114
57,48,4,0,58,58
57,48,5,0,50,50
57,48,6,1,53,52
57,49,0,2,105,103
57,49,1,3,103,100
57,49,2,0,113,113
57,49,3,2,103,101
57,49,4,0,72,72
57,49,5,1,56,55
57,49,6,1,50,49
57,50,0,1,66,65
57,50,1,0,66,66
57,50,2,2,84,82
57,50,3,1,74,73
57,50,4,1,56,55
57,50,5,1,52,51
57,50,6,0,36,36
57,51,0,0,73,73
57,51,1,0,69,69
57,51,2,0,63,63
57,51,3,1,66,65
57,51,4,0,64,64
57,51,5,0,52,52
57,51,6,1,49,48
57,52,0,0,69,69
57,52,1,1,68,67
57,52,2,2,67,65
57,52,3,2,70,68
57,52,4,0,54,54
57,52,5,0,46,46
57,52,6,0,42,42
57,53,0,0,44,44
57,53,1,1,58,57
57,53,2,0,44,44
57,53,3,2,64,62
57,53,4,4,49,45
57,53,5,2,28,26
57,53,6,0,40,40
57,54,0,1,38,37
57,54,1,0,51,51
57,54,2,2,52,50
57,54,3,0,56,56
57,54,4,1,33,32
57,54,5,0,32,32
57,54,6,0,41,41
57,55,0,1,42,41
57,55,1,4,56,52
57,55,2,3,55,52
57,55,3,0,53,53
57,55,4,1,41,40
57,55,5,0,24,24
57,55,6,2,36,34
57,56,0,0,40,40
57,56,1,10,60,50
57,56,2,3,57,54
57,56,3,1,41,40
57,56,4,2,37,35
57,56,5,1,35,34
57,56,6,0,28,28
57,57,0,2,38,36
57,57,1,0,39,39
57,57,2,0,49,49
57,57,3,1,34,33
57,57,4,0,34,34
57,57,5,0,36,36
57,57,6,1,39,38
57,58,0,0,37,37
57,58,1,1,49,48
57,58,2,0,39,39
57,58,3,0,35,35
57,58,4,2,34,32
57,58,5,1,34,33
57,58,6,1,46,45
57,59,0,0,51,51
57,59,1,0,30,30
57,59,2,1,30,29
57,59,3,0,40,40
57,59,4,0,31,31
57,59,5,1,40,39
57,59,6,1,40,39
57,60,0,0,39,39
57,60,1,0,37,37
57,60,2,0,41,41
57,60,3,2,36,34
57,60,4,1,41,40
57,60,5,0,31,31
57,60,6,0,31,31
57,61,0,1,41,40
57,61,1,1,28,27
57,61,2,0,39,39
57,61,3,0,30,30
57,61,4,0,32,32
57,61,5,0,44,44
57,61,6,1,37,36
57,62,0,1,27,26
57,62,1,1,34,33
57,62,2,0,37,37
57,62,3,0,42,42
57,62,4,0,37,37
57,62,5,1,26,25
57,62,6,0,25,25
57,63,0,3,42,39
57,63,1,0,31,31
57,63,2,0,43,43
57,63,3,4,42,38
57,63,4,0,38,38
57,63,5,2,51,49
57,63,6,0,27,27
57,64,0,11,49,38
57,64,1,3,39,36
57,64,2,0,29,29
57,64,3,1,40,39
57,64,4,1,37,36
57,64,5,2,45,43
57,64,6,2,49,47
57,65,0,0,33,33
57,65,1,2,35,33
57,65,2,1,51,50
57,65,3,0,35,35
57,65,4,0,34,34
57,65,5,0,42,42
57,65,6,8,64,56
57,66,0,1,56,55
57,66,1,0,37,37
57,66,2,1,37,36
57,66,3,2,47,45
57,66,4,1,38,37
57,66,5,1,51,50
57,66,6,0,59,59
57,67,0,0,38,38
57,67,1,0,38,38
57,67,2,0,38,38
57,67,3,2,38,36
57,67,4,0,36,36
57,67,5,1,44,43
57,67,6,1,42,41
57,68,0,3,43,40
57,68,1,1,29,28
57,68,2,1,46,45
57,68,3,0,29,29
57,68,4,2,43,41
57,68,5,1,41,40
57,68,6,1,41,40
57,69,0,0,48,48
57,69,1,1,49,48
57,69,2,0,39,39
57,69,3,2,55,53
57,69,4,2,39,37
57,69,5,1,37,36
57,69,6,0,35,35
57,70,0,0,43,43
57,70,1,3,47,44
57,70,2,0,36,36
57,70,3,0,47,47
57,70,4,1,34,33
57,70,5,1,42,41
57,70,6,1,38,37
57,71,0,1,31,30
57,71,1,1,41,40
57,71,2,2,48,46
57,71,3,0,33,33
57,71,4,2,34,32
57,71,5,0,39,39
57,71,6,1,42,41
57,72,0,2,44,42
57,72,1,1,37,36
57,72,2,0,43,43
57,72,3,0,40,40
57,72,4,5,56,51
57,72,5,1,50,49
57,72,6,2,53,51
57,73,0,0,30,30
57,73,1,3,38,35
57,73,2,1,37,36
57,73,3,0,52,52
57,73,4,4,43,39
57,73,5,4,47,43
57,73,6,0,51,51
57,74,0,0,35,35
57,74,1,1,39,38
57,74,2,1,38,37
57,74,3,1,62,61
57,74,4,0,47,47
57,74,5,0,42,42
57,74,6,0,41,41
57,75,0,0,22,22
57,75,1,0,41,41
57,75,2,1,46,45
57,75,3,0,44,44
57,75,4,0,48,48
57,75,5,3,47,44
57,75,6,0,45,45
57,76,0,0,33,33
57,76,1,0,37,37
57,76,2,2,39,37
57,76,3,0,45,45
57,76,4,2,34,32
57,76,5,0,50,50
57,76,6,3,50,47
57,77,0,0,34,34
57,77,1,1,37,36
57,77,2,1,27,26
57,77,3,1,46,45
57,77,4,0,30,30
57,77,5,1,49,48
57,77,6,1,47,46
57,78,0,1,42,41
57,78,1,1,47,46
57,78,2,0,30,30
57,78,3,0,43,43
57,78,4,1,52,51
57,78,5,0,37,37
57,78,6,1,57,56
57,79,0,1,45,44
57,79,1,1,39,38
57,79,2,0,38,38
57,79,3,0,48,48
57,79,4,2,50,48
57,79,5,0,47,47
57,79,6,5,62,57
57,80,0,0,52,52
57,80,1,1,45,44
57,80,2,3,58,55
57,80,3,1,47,46
57,80,4,0,47,47
57,80,5,0,56,56
57,80,6,1,51,50
57,81,0,1,36,35
57,81,1,1,41,40
57,81,2,2,41,39
57,81,3,0,48,48
57,81,4,0,35,35
57,81,5,3,64,61
57,81,6,0,48,48
57,82,0,0,40,40
57,82,1,1,48,47
57,82,2,6,35,29
57,82,3,1,43,42
57,82,4,1,36,35
57,82,5,1,30,29
57,82,6,1,55,54
57,83,0,1,43,42
57,83,1,1,39,38
57,83,2,1,49,48
57,83,3,3,47,44
57,83,4,0,52,52
57,83,5,0,43,43
57,83,6,0,37,37
57,84,0,0,34,34
57,84,1,2,49,47
57,84,2,0,49,49
57,84,3,0,42,42
57,84,4,0,43,43
57,84,5,0,44,44
57,84,6,1,34,33
57,85,0,2,39,37
57,85,1,4,42,38
57,85,2,0,59,59
57,85,3,2,51,49
57,85,4,0,44,44
57,85,5,0,32,32
57,85,6,1,38,37
57,86,0,1,39,38
57,86,1,0,39,39
57,86,2,0,53,53
57,86,3,0,33,33
57,86,4,0,37,37
57,86,5,1,40,39
57,86,6,4,45,41
57,87,0,0,35,35
57,87,1,0,45,45
57,87,2,1,50,49
57,87,3,0,43,43
57,87,4,1,37,36
57,87,5,1,49,48
57,87,6,4,60,56
57,88,0,0,28,28
57,88,1,0,30,30
57,88,2,2,36,34
57,88,3,0,34,34
57,88,4,0,45,45
57,88,5,2,34,32
57,88,6,2,57,55
57,89,0,1,36,35
57,89,1,12,55,43
57,89,2,1,33,32
57,89,3,1,42,41
57,89,4,3,43,40
57,89,5,0,40,40
57,89,6,0,44,44
57,90,0,0,36,36
57,90,1,1,36,35
57,90,2,1,47,46
57,90,3,1,56,55
57,90,4,0,33,33
57,90,5,4,34,30
57,90,6,1,44,43
57,91,0,0,41,41
57,91,1,3,46,43
57,91,2,0,39,39
57,91,3,1,48,47
57,91,4,3,43,40
57,91,5,3,39,36
57,91,6,1,43,42
57,92,0,1,43,42
57,92,1,3,51,48
57,92,2,0,63,63
57,92,3,0,35,35
57,92,4,1,42,41
57,92,5,1,48,47
57,92,6,2,54,52
57,93,0,2,53,51
57,93,1,2,47,45
57,93,2,6,75,69
57,93,3,1,45,44
57,93,4,4,53,49
57,93,5,0,35,35
57,93,6,1,50,49
57,94,0,0,51,51
57,94,1,1,35,34
57,94,2,5,81,76
57,94,3,4,55,51
57,94,4,3,53,50
57,94,5,0,40,40
57,94,6,1,51,50
57,95,0,2,53,51
57,95,1,3,57,54
57,95,2,2,75,73
57,95,3,2,65,63
57,95,4,1,69,68
57,95,5,1,39,38
57,95,6,1,56,55
57,96,0,0,58,58
57,96,1,1,46,45
57,96,2,6,69,63
57,96,3,6,74,68
57,96,4,3,55,52
57,96,5,1,51,50
57,96,6,0,49,49
57,97,0,3,61,58
57,97,1,3,71,68
57,97,2,3,57,54
57,97,3,0,63,63
57,97,4,3,84,81
57,97,5,2,70,68
57,97,6,0,53,53
57,98,0,4,65,61
57,98,1,3,61,58
57,98,2,6,78,72
57,98,3,1,41,40
57,98,4,7,84,77
57,98,5,2,76,74
57,98,6,0,63,63
57,99,0,2,78,76
57,99,1,1,72,71
57,99,2,1,101,100
57,99,3,1,77,76
57,99,4,7,74,67
57,99,5,0,56,56
57,99,6,0,72,72
57,100,0,1,73,72
57,100,1,3,75,72
57,100,2,5,87,82
57,100,3,2,70,68
57,100,4,5,83,78
57,100,5,1,58,57
57,100,6,1,54,53
57,101,0,2,76,74
57,101,1,0,78,78
57,101,2,1,83,82
57,101,3,1,88,87
57,101,4,3,85,82
57,101,5,0,67,67
57,101,6,2,64,62
57,102,0,0,86,86
57,102,1,4,89,85
57,102,2,1,118,117
57,102,3,7,107,100
57,102,4,1,96,95
57,102,5,1,69,68
57,102,6,0,66,66
57,103,0,6,71,65
57,103,1,2,84,82
57,103,2,2,64,62
57,103,3,2,86,84
57,103,4,3,87,84
57,103,5,4,82,78
57,103,6,2,72,70
57,104,0,0,65,65
57,104,1,2,66,64
57,104,2,4,74,70
57,104,3,3,67,64
57,104,4,1,74,73
57,104,5,3,73,70
57,104,6,0,53,53
57,105,0,2,63,61
57,105,1,0,58,58
57,105,2,3,64,61
57,105,3,1,69,68
57,105,4,0,55,55
57,105,5,1,60,59
57,105,6,16,83,67
57,106,0,0,51,51
57,106,1,1,65,64
57,106,2,4,57,53
57,106,3,5,55,50
57,106,4,3,69,66
57,106,5,0,44,44
57,106,6,5,58,53
57,107,0,0,54,54
57,107,1,4,44,40
57,107,2,3,62,59
57,107,3,2,55,53
57,107,4,1,55,54
57,107,5,3,66,63
57,107,6,1,59,58
57,108,0,1,60,59
57,108,1,0,55,55
57,108,2,1,60,59
57,108,3,2,60,58
57,108,4,0,61,61
57,108,5,3,55,52
57,108,6,1,49,48
57,109,0,0,46,46
57,109,1,0,48,48
57,109,2,0,49,49
57,109,3,3,47,44
57,109,4,1,47,46
57,109,5,2,63,61
57,109,6,2,46,44
57,110,0,1,53,52
57,110,1,1,53,52
57,110,2,3,61,58
57,110,3,0,49,49
57,110,4,2,44,42
57,110,5,1,70,69
57,110,6,1,48,47
57,111,0,2,51,49
57,111,1,0,57,57
57,111,2,4,51,47
57,111,3,1,49,48
57,111,4,1,45,44
57,111,5,1,61,60
57,111,6,0,68,68
57,112,0,6,58,52
57,112,1,1,54,53
57,112,2,2,45,43
57,112,3,0,36,36
57,112,4,3,58,55
57,112,5,5,65,60
57,112,6,4,50,46
57,113,0,0,47,47
57,113,1,1,43,42
57,113,2,4,48,44
57,113,3,2,46,44
57,113,4,3,51,48
57,113,5,1,40,39
57,113,6,1,47,46
57,114,0,0,45,45
57,114,1,0,53,53
57,114,2,0,53,53
57,114,3,1,58,57
57,114,4,1,47,46
57,114,5,2,50,48
57,114,6,1,39,38
57,115,0,2,44,42
57,115,1,3,44,41
57,115,2,3,51,48
57,115,3,1,48,47
57,115,4,0,45,45
57,115,5,7,55,48
57,115,6,7,51,44
57,116,0,5,51,46
57,116,1,2,52,50
57,116,2,1,44,43
57,116,3,0,33,33
57,116,4,0,46,46
57,116,5,4,45,41
57,116,6,3,34,31
57,117,0,3,39,36
57,117,1,1,38,37
57,117,2,1,44,43
57,117,3,0,36,36
57,117,4,1,55,54
57,117,5,2,41,39
57,117,6,0,47,47
57,118,0,1,28,27
57,118,1,3,44,41
57,118,2,2,57,55
57,118,3,2,47,45
57,118,4,2,44,42
57,118,5,1,43,42
57,118,6,2,52,50
57,119,0,2,47,45
57,119,1,1,33,32
57,119,2,1,48,47
57,119,3,0,43,43
57,119,4,6,67,61
57,119,5,10,48,38
57,119,6,0,31,31
57,120,0,1,47,46
57,120,1,1,29,28
57,120,2,1,49,48
57,120,3,0,33,33
57,120,4,2,46,44
57,120,5,1,41,40
57,120,6,1,32,31
57,121,0,1,34,33
57,121,1,1,42,41
57,121,2,4,58,54
57,121,3,1,42,41
57,121,4,0,39,39
57,121,5,1,44,43
57,121,6,1,45,44
57,122,0,1,39,38
57,122,1,0,22,22
57,122,2,2,37,35
57,122,3,2,43,41
57,122,4,0,31,31
57,122,5,0,46,46
57,122,6,2,39,37
57,123,0,2,33,31
57,123,1,0,41,41
57,123,2,2,58,56
57,123,3,2,37,35
57,123,4,1,31,30
57,123,5,1,22,21
57,123,6,1,45,44
57,124,0,2,36,34
57,124,1,1,36,35
57,124,2,0,41,41
57,124,3,0,42,42
57,124,4,1,34,33
57,124,5,1,42,41
57,124,6,1,38,37
57,125,0,2,39,37
57,125,1,2,38,36
57,125,2,5,44,39
57,125,3,1,30,29
57,125,4,1,51,50
57,125,5,2,30,28
57,125,6,1,35,34
57,126,0,1,36,35
57,126,1,2,42,40
57,126,2,3,42,39
57,126,3,5,56,51
57,126,4,1,38,37
57,126,5,8,40,32
57,126,6,0,33,33
57,127,0,2,32,30
57,127,1,2,38,36
57,127,2,1,38,37
57,127,3,0,41,41
57,127,4,0,37,37
57,127,5,1,29,28
57,127,6,0,30,30
57,128,0,1,38,37
57,128,1,0,30,30
57,128,2,0,32,32
57,128,3,5,48,43
57,128,4,0,37,37
57,128,5,3,30,27
57,128,6,0,24,24
57,129,0,0,29,29
57,129,1,10,31,21
57,129,2,2,29,27
57,129,3,3,46,43
57,129,4,0,27,27
57,129,5,6,29,23
57,129,6,0,28,28
57,130,0,0,22,22
57,130,1,3,37,34
57,130,2,0,27,27
57,130,3,1,32,31
57,130,4,1,25,24
57,130,5,1,43,42
57,130,6,1,28,27
57,131,0,5,25,20
57,131,1,0,29,29
57,131,2,0,28,28
57,131,3,2,28,26
57,131,4,1,34,33
57,131,5,3,39,36
57,131,6,0,22,22
57,132,0,2,27,25
57,132,1,2,31,29
57,132,2,2,33,31
57,132,3,0,29,29
57,132,4,8,34,26
57,132,5,1,43,42
57,132,6,1,17,16
57,133,0,2,21,19
57,133,1,0,17,17
57,133,2,0,24,24
57,133,3,0,25,25
57,133,4,0,34,34
57,133,5,1,37,36
57,133,6,2,26,24
57,134,0,0,25,25
57,134,1,0,26,26
57,134,2,0,20,20
57,134,3,1,20,19
57,134,4,0,35,35
57,134,5,2,34,32
57,134,6,1,35,34
57,135,0,1,16,15
57,135,1,2,26,24
57,135,2,1,26,25
57,135,3,0,29,29
57,135,4,1,21,20
57,135,5,0,34,34
57,135,6,1,35,34
57,136,0,2,17,15
57,136,1,1,16,15
57,136,2,0,26,26
57,136,3,0,24,24
57,136,4,1,26,25
57,136,5,1,28,27
57,136,6,5,29,24
57,137,0,0,17,17
57,137,1,0,13,13
57,137,2,0,22,22
57,137,3,0,23,23
57,137,4,2,20,18
57,137,5,0,22,22
57,137,6,6,28,22
57,138,0,1,21,20
57,138,1,0,13,13
57,138,2,2,25,23
57,138,3,0,15,15
57,138,4,0,17,17
57,138,5,1,30,29
57,138,6,0,17,17
57,139,0,0,6,6
57,139,1,1,7,6
57,139,2,1,18,17
57,139,3,1,19,18
57,139,4,4,38,34
57,139,5,2,30,28
57,139,6,0,14,14
57,140,0,1,18,17
57,140,1,0,18,18
57,140,2,0,12,12
57,140,3,3,20,17
57,140,4,8,16,8
57,140,5,2,25,23
57,140,6,1,17,16
57,141,0,1,15,14
57,141,1,0,13,13
57,141,2,0,8,8
57,141,3,0,7,7
57,141,4,1,16,15
57,141,5,0,13,13
57,141,6,2,13,11
57,142,0,0,12,12
57,142,1,1,15,14
57,142,2,0,15,15
57,142,3,1,17,16
57,142,4,3,15,12
57,142,5,1,17,16
57,142,6,2,17,15
57,143,0,2,17,15
57,143,1,1,11,10
57,143,2,3,10,7
57,143,3,0,7,7
57,143,4,2,17,15
57,143,5,1,8,7
57,143,6,0,13,13
58,0,0,3,7,4
58,0,1,0,1,1
58,0,2,1,3,2
58,0,3,1,3,2
58,0,4,0,1,1
58,0,5,2,5,3
58,0,6,0,2,2
58,1,0,1,4,3
58,1,2,0,1,1
58,1,4,2,7,5
58,1,5,0,1,1
58,1,6,2,6,4
58,2,0,2,3,1
58,2,1,0,1,1
58,2,3,0,2,2
58,2,4,2,4,2
58,2,5,0,5,5
58,2,6,2,4,2
58,3,0,2,3,1
58,3,1,0,1,1
58,3,2,1,5,4
58,3,3,0,1,1
58,3,4,0,6,6
58,3,5,2,3,1
58,3,6,2,3,1
58,4,0,0,3,3
58,4,2,2,3,1
58,4,3,0,1,1
58,4,4,0,2,2
58,4,5,1,1,0
58,4,6,0,3,3
58,5,0,2,4,2
58,5,1,2,4,2
58,5,2,1,2,1
58,5,3,0,1,1
58,5,4,1,1,0
58,5,5,1,1,0
58,5,6,0,3,3
58,6,0,0,1,1
58,6,1,0,1,1
58,6,2,1,3,2
58,6,3,2,3,1
58,6,4,1,2,1
58,6,5,0,1,1
58,6,6,2,4,2
58,7,0,1,1,0
58,7,2,1,1,0
58,7,3,2,5,3
58,7,5,0,1,1
58,8,0,0,1,1
58,8,2,0,1,1
58,8,3,1,1,0
58,8,4,1,2,1
58,8,5,0,2,2
58,8,6,0,1,1
58,9,0,0,1,1
58,9,3,1,2,1
58,10,0,0,1,1
58,10,2,0,2,2
58,10,3,5,5,0
58,10,5,1,3,2
58,11,0,0,1,1
58,11,2,1,1,0
58,11,3,4,5,1
58,11,4,0,3,3
58,11,5,1,2,1
58,11,6,1,4,3
58,12,0,0,1,1
58,12,1,0,1,1
58,12,2,1,2,1
58,12,4,3,5,2
58,12,5,0,2,2
58,12,6,0,2,2
58,13,1,1,2,1
58,13,4,1,1,0
58,13,5,4,5,1
58,13,6,1,1,0
58,14,0,4,4,0
58,14,3,1,1,0
58,14,5,0,2,2
58,14,6,0,1,1
58,15,0,1,2,1
58,15,2,0,1,1
58,15,5,0,2,2
58,16,4,0,1,1
58,16,5,1,2,1
58,17,0,0,1,1
58,17,5,0,3,3
58,17,6,0,1,1
58,18,3,0,2,2
58,18,5,0,3,3
58,19,1,0,1,1
58,19,3,1,1,0
58,19,4,2,4,2
58,19,5,1,1,0
58,20,0,0,1,1
58,20,3,0,1,1
58,20,4,0,1,1
58,20,6,0,1,1
58,21,0,0,1,1
58,21,1,0,1,1
58,21,4,1,2,1
58,21,5,0,1,1
58,22,1,0,2,2
58,22,4,1,1,0
58,22,6,1,1,0
58,23,0,0,1,1
58,23,1,0,1,1
58,23,3,0,2,2
58,23,4,0,1,1
58,23,6,1,2,1
58,24,0,2,3,1
58,24,1,1,2,1
58,24,4,1,2,1
58,25,0,0,1,1
58,25,3,0,1,1
58,25,4,1,2,1
58,26,3,1,2,1
58,27,0,5,5,0
58,27,1,1,2,1
58,27,4,1,1,0
58,28,3,0,1,1
58,29,2,1,1,0
58,29,4,0,1,1
58,29,6,0,1,1
58,30,2,0,1,1
58,30,3,0,1,1
58,31,0,0,1,1
58,31,3,1,1,0
58,31,6,1,2,1
58,32,0,2,3,1
58,32,1,0,2,2
58,32,3,0,1,1
58,32,4,0,1,1
58,32,6,1,2,1
58,33,0,2,3,1
58,33,2,1,2,1
58,33,5,1,1,0
58,33,6,1,1,0
58,34,0,1,2,1
58,34,1,2,2,0
58,34,2,1,1,0
58,34,3,2,3,1
58,34,5,1,1,0
58,34,6,0,1,1
58,35,0,0,2,2
58,35,3,0,1,1
58,35,4,2,3,1
58,35,6,1,1,0
58,36,0,0,2,2
58,36,1,2,3,1
58,36,2,0,1,1
58,36,3,1,3,2
58,36,4,3,4,1
58,36,5,0,2,2
58,36,6,0,2,2
58,37,0,1,2,1
58,37,1,0,2,2
58,37,3,1,3,2
58,37,4,2,2,0
58,37,5,0,2,2
58,37,6,0,1,1
58,38,0,0,4,4
58,38,1,2,5,3
58,38,2,0,2,2
58,38,3,2,5,3
58,38,4,1,5,4
58,38,5,3,6,3
58,38,6,1,1,0
58,39,0,0,6,6
58,39,1,2,7,5
58,39,2,0,5,5
58,39,3,0,9,9
58,39,4,3,5,2
58,39,5,0,1,1
58,39,6,1,5,4
58,40,0,0,3,3
58,40,1,0,6,6
58,40,2,1,7,6
58,40,3,1,3,2
58,40,4,4,11,7
58,40,5,0,2,2
58,40,6,2,4,2
58,41,0,0,9,9
58,41,1,3,11,8
58,41,2,0,9,9
58,41,3,0,10,10
58,41,4,0,8,8
58,41,5,2,11,9
58,42,0,2,9,7
58,42,1,0,7,7
58,42,2,0,9,9
58,42,3,0,14,14
58,42,4,0,5,5
58,42,5,4,12,8
58,42,6,0,3,3
58,43,0,0,11,11
58,43,1,0,8,8
58,43,2,0,10,10
58,43,3,3,11,8
58,43,4,2,10,8
58,43,5,3,13,10
58,43,6,8,18,10
58,44,0,3,21,18
58,44,1,0,10,10
58,44,2,1,12,11
58,44,3,2,14,12
58,44,4,0,10,10
58,44,5,0,6,6
58,44,6,1,8,7
58,45,0,7,30,23
58,45,1,4,19,15
58,45,2,0,17,17
58,45,3,3,16,13
58,45,4,3,15,12
58,45,5,5,15,10
58,45,6,2,8,6
58,46,0,4,21,17
58,46,1,3,13,10
58,46,2,2,22,20
58,46,3,2,9,7
58,46,4,4,19,15
58,46,5,1,11,10
58,46,6,6,15,9
58,47,0,3,13,10
58,47,1,3,15,12
58,47,2,5,23,18
58,47,3,4,16,12
58,47,4,1,15,14
58,47,5,1,14,13
58,47,6,2,11,9
58,48,0,5,25,20
58,48,1,4,16,12
58,48,2,1,12,11
58,48,3,7,21,14
58,48,4,1,12,11
58,48,5,0,7,7
58,48,6,0,13,13
58,49,0,7,22,15
58,49,1,1,13,12
58,49,2,2,11,9
58,49,3,10,31,21
58,49,4,0,9,9
58,49,5,0,10,10
58,49,6,1,13,12
58,50,0,1,16,15
58,50,1,8,28,20
58,50,2,3,31,28
58,50,3,3,22,19
58,50,4,1,10,9
58,50,5,0,15,15
58,50,6,2,10,8
58,51,0,2,19,17
58,51,1,8,20,12
58,51,2,3,16,13
58,51,3,7,23,16
58,51,4,4,21,17
58,51,5,0,7,7
58,51,6,1,7,6
58,52,0,0,7,7
58,52,1,4,16,12
58,52,2,2,12,10
58,52,3,2,14,12
58,52,4,3,15,12
58,52,5,1,7,6
58,52,6,1,12,11
58,53,0,3,25,22
58,53,1,4,17,13
58,53,2,4,17,13
58,53,3,1,13,12
58,53,4,2,8,6
58,53,5,3,11,8
58,53,6,0,12,12
58,54,0,3,19,16
58,54,1,4,17,13
58,54,2,2,17,15
58,54,3,5,16,11
58,54,4,5,17,12
58,54,5,3,12,9
58,54,6,4,14,10
58,55,0,4,12,8
58,55,1,0,8,8
58,55,2,1,20,19
58,55,3,5,17,12
58,55,4,3,12,9
58,55,5,5,15,10
58,55,6,1,10,9
58,56,0,5,18,13
58,56,1,0,10,10
58,56,2,4,17,13
58,56,3,5,20,15
58,56,4,2,9,7
58,56,5,2,9,7
58,56,6,0,18,18
58,57,0,2,12,10
58,57,1,5,11,6
58,57,2,7,19,12
58,57,3,5,11,6
58,57,4,1,6,5
58,57,5,2,13,11
58,57,6,2,12,10
58,58,0,3,15,12
58,58,1,6,13,7
58,58,2,6,18,12
58,58,3,5,14,9
58,58,4,7,15,8
58,58,5,9,24,15
58,58,6,2,14,12
58,59,0,13,24,11
58,59,1,5,14,9
58,59,2,2,10,8
58,59,3,6,18,12
58,59,4,4,16,12
58,59,5,1,9,8
58,59,6,5,13,8
58,60,0,6,17,11
58,60,1,6,21,15
58,60,2,4,13,9
58,60,3,4,10,6
58,60,4,6,13,7
58,60,5,0,10,10
58,60,6,3,13,10
58,61,0,3,13,10
58,61,1,0,2,2
58,61,2,9,13,4
58,61,3,3,8,5
58,61,4,5,12,7
58,61,5,5,13,8
58,61,6,1,7,6
58,62,0,8,16,8
58,62,1,5,14,9
58,62,2,2,8,6
58,62,3,5,12,7
58,62,4,8,15,7
58,62,5,3,11,8
58,62,6,4,10,6
58,63,0,1,10,9
58,63,1,5,14,9
58,63,2,1,10,9
58,63,3,5,13,8
58,63,4,2,6,4
58,63,5,0,14,14
58,63,6,3,15,12
58,64,0,6,15,9
58,64,1,2,6,4
58,64,2,3,12,9
58,64,3,16,21,5
58,64,4,9,16,7
58,64,5,5,16,11
58,64,6,10,16,6
58,65,0,10,18,8
58,65,1,1,8,7
58,65,2,2,10,8
58,65,3,14,22,8
58,65,4,21,25,4
58,65,5,1,11,10
58,65,6,1,12,11
58,66,0,2,8,6
58,66,1,1,9,8
58,66,2,1,10,9
58,66,3,7,16,9
58,66,4,23,28,5
58,66,5,2,8,6
58,66,6,1,10,9
58,67,0,4,9,5
58,67,1,1,5,4
58,67,2,0,5,5
58,67,3,7,14,7
58,67,4,14,22,8
58,67,5,4,8,4
58,67,6,3,9,6
58,68,0,0,7,7
58,68,1,2,12,10
58,68,2,9,16,7
58,68,3,5,12,7
58,68,4,7,14,7
58,68,5,3,15,12
58,68,6,2,18,16
58,69,0,7,21,14
58,69,1,5,10,5
58,69,2,4,15,11
58,69,3,3,9,6
58,69,4,2,11,9
58,69,5,2,11,9
58,69,6,4,14,10
58,70,0,7,12,5
58,70,1,4,13,9
58,70,2,3,8,5
58,70,3,4,12,8
58,70,4,3,12,9
58,70,5,0,8,8
58,70,6,8,17,9
58,71,0,7,22,15
58,71,1,6,15,9
58,71,2,1,11,10
58,71,3,4,11,7
58,71,4,3,8,5
58,71,5,4,12,8
58,71,6,9,24,15
58,72,0,8,12,4
58,72,1,3,18,15
58,72,2,3,10,7
58,72,3,3,8,5
58,72,4,5,13,8
58,72,5,1,14,13
58,72,6,2,13,11
58,73,0,10,21,11
58,73,1,7,14,7
58,73,2,6,18,12
58,73,3,5,16,11
58,73,4,7,14,7
58,73,5,7,14,7
58,73,6,5,22,17
58,74,0,1,15,14
58,74,1,9,13,4
58,74,2,3,15,12
58,74,3,7,14,7
58,74,4,8,15,7
58,74,5,9,21,12
58,74,6,1,8,7
58,75,0,0,12,12
58,75,1,6,19,13
58,75,2,1,10,9
58,75,3,4,16,12
58,75,4,11,21,10
58,75,5,4,17,13
58,75,6,0,7,7
58,76,0,2,11,9
58,76,1,2,12,10
58,76,2,4,8,4
58,76,3,4,12,8
58,76,4,9,21,12
58,76,5,6,16,10
58,76,6,0,15,15
58,77,0,3,17,14
58,77,1,4,14,10
58,77,2,8,17,9
58,77,3,2,9,7
58,77,4,4,12,8
58,77,5,9,19,10
58,77,6,1,11,10
58,78,0,1,5,4
58,78,1,5,7,2
58,78,2,2,7,5
58,78,3,2,9,7
58,78,4,15,26,11
58,78,5,11,21,10
58,78,6,3,15,12
58,79,0,0,6,6
58,79,1,0,10,10
58,79,2,3,11,8
58,79,3,0,11,11
58,79,4,9,18,9
58,79,5,4,15,11
58,79,6,2,13,11
58,80,0,2,8,6
58,80,1,5,13,8
58,80,2,3,18,15
58,80,3,5,14,9
58,80,4,8,17,9
58,80,5,9,16,7
58,80,6,2,14,12
58,81,0,4,13,9
58,81,1,4,10,6
58,81,2,10,18,8
58,81,3,5,15,10
58,81,4,9,15,6
58,81,5,5,8,3
58,81,6,4,11,7
58,82,0,3,12,9
58,82,1,5,12,7
58,82,2,7,16,9
58,82,3,2,14,12
58,82,4,11,21,10
58,82,5,7,14,7
58,82,6,14,22,8
58,83,0,2,11,9
58,83,1,1,6,5
58,83,2,8,14,6
58,83,3,2,16,14
58,83,4,6,13,7
58,83,5,12,21,9
58,83,6,14,23,9
58,84,0,8,21,13
58,84,1,0,8,8
58,84,2,2,10,8
58,84,3,0,5,5
58,84,4,5,12,7
58,84,5,3,14,11
58,84,6,2,14,12
58,85,0,4,12,8
58,85,1,3,14,11
58,85,2,3,10,7
58,85,3,1,10,9
58,85,4,8,11,3
58,85,5,4,11,7
58,85,6,7,21,14
58,86,0,2,7,5
58,86,1,4,9,5
58,86,2,2,11,9
58,86,3,0,6,6
58,86,4,4,10,6
58,86,5,4,11,7
58,86,6,6,16,10
58,87,0,1,7,6
58,87,1,1,7,6
58,87,2,2,13,11
58,87,3,3,8,5
58,87,4,6,14,8
58,87,5,2,10,8
58,87,6,1,12,11
58,88,0,5,18,13
58,88,1,0,9,9
58,88,2,3,10,7
58,88,3,2,10,8
58,88,4,11,21,10
58,88,5,0,12,12
58,88,6,3,14,11
58,89,0,6,8,2
58,89,1,6,20,14
58,89,2,2,14,12
58,89,3,0,11,11
58,89,4,5,17,12
58,89,5,0,11,11
58,89,6,7,16,9
58,90,0,1,13,12
58,90,1,1,9,8
58,90,2,2,7,5
58,90,3,2,11,9
58,90,4,2,8,6
58,90,5,1,7,6
58,90,6,2,12,10
58,91,0,4,14,10
58,91,1,3,13,10
58,91,2,1,11,10
58,91,3,5,17,12
58,91,4,1,6,5
58,91,5,2,13,11
58,91,6,3,18,15
58,92,0,4,13,9
58,92,1,2,6,4
58,92,2,1,9,8
58,92,3,3,12,9
58,92,4,0,7,7
58,92,5,0,9,9
58,92,6,1,7,6
58,93,0,2,15,13
58,93,1,0,8,8
58,93,2,2,14,12
58,93,3,0,12,12
58,93,4,1,13,12
58,93,5,1,11,10
58,93,6,2,16,14
58,94,0,0,6,6
58,94,1,2,14,12
58,94,2,0,10,10
58,94,3,2,7,5
58,94,4,1,12,11
58,94,5,1,11,10
58,94,6,0,7,7
58,95,0,2,14,12
58,95,1,0,14,14
58,95,2,1,14,13
58,95,3,0,9,9
58,95,4,4,16,12
58,95,5,1,15,14
58,95,6,2,9,7
58,96,0,0,8,8
58,96,1,2,14,12
58,96,2,0,6,6
58,96,3,0,5,5
58,96,4,0,12,12
58,96,5,2,9,7
58,96,6,1,13,12
58,97,0,1,15,14
58,97,1,2,15,13
58,97,2,3,11,8
58,97,3,0,8,8
58,97,4,1,10,9
58,97,5,2,14,12
58,97,6,1,10,9
58,98,0,0,5,5
58,98,1,3,11,8
58,98,2,1,12,11
58,98,3,0,4,4
58,98,4,0,10,10
58,98,5,0,11,11
58,98,6,0,7,7
58,99,0,0,11,11
58,99,1,0,11,11
58,99,2,3,21,18
58,99,3,4,23,19
58,99,4,0,13,13
58,99,5,1,10,9
58,99,6,1,10,9
58,100,0,0,11,11
58,100,1,1,11,10
58,100,2,2,10,8
58,100,3,10,23,13
58,100,4,0,12,12
58,100,5,0,12,12
58,100,6,1,6,5
58,101,0,0,12,12
58,101,1,0,11,11
58,101,2,3,17,14
58,101,3,0,7,7
58,101,4,1,13,12
58,101,5,9,24,15
58,101,6,0,6,6
58,102,0,0,19,19
58,102,1,0,13,13
58,102,2,2,18,16
58,102,3,1,16,15
58,102,4,4,19,15
58,102,5,0,8,8
58,102,6,0,13,13
58,103,0,0,9,9
58,103,1,3,15,12
58,103,2,1,14,13
58,103,3,0,10,10
58,103,4,1,14,13
58,103,5,2,6,4
58,103,6,1,21,20
58,104,0,2,14,12
58,104,1,0,15,15
58,104,2,0,12,12
58,104,3,0,11,11
58,104,4,1,12,11
58,104,5,3,11,8
58,104,6,2,20,18
58,105,0,0,10,10
58,105,1,2,15,13
58,105,2,0,11,11
58,105,3,2,16,14
58,105,4,0,15,15
58,105,5,0,8,8
58,105,6,0,13,13
58,106,0,1,6,5
58,106,1,4,16,12
58,106,2,0,11,11
58,106,3,1,9,8
58,106,4,1,19,18
58,106,5,1,12,11
58,106,6,2,17,15
58,107,0,3,18,15
58,107,1,0,6,6
58,107,2,0,16,16
58,107,3,3,15,12
58,107,4,2,19,17
58,107,5,1,14,13
58,107,6,1,13,12
58,108,0,0,10,10
58,108,1,0,12,12
58,108,2,0,11,11
58,108,3,2,10,8
58,108,4,0,9,9
58,108,5,0,6,6
58,108,6,0,8,8
58,109,0,1,9,8
58,109,1,2,12,10
58,109,2,2,13,11
58,109,3,5,15,10
58,109,4,1,26,25
58,109,5,3,17,14
58,109,6,1,11,10
58,110,0,0,10,10
58,110,1,0,14,14
58,110,2,0,7,7
58,110,3,2,14,12
58,110,4,1,20,19
58,110,5,5,15,10
58,110,6,2,11,9
58,111,0,3,5,2
58,111,1,3,10,7
58,111,2,2,8,6
58,111,3,0,11,11
58,111,4,2,17,15
58,111,5,1,12,11
58,111,6,5,27,22
58,112,0,0,10,10
58,112,1,3,10,7
58,112,2,0,10,10
58,112,3,0,12,12
58,112,4,1,6,5
58,112,5,1,14,13
58,112,6,7,26,19
58,113,0,4,15,11
58,113,1,0,10,10
58,113,2,1,11,10
58,113,3,0,12,12
58,113,4,3,11,8
58,113,5,2,23,21
58,113,6,5,21,16
58,114,0,4,7,3
58,114,1,1,12,11
58,114,2,1,8,7
58,114,3,0,8,8
58,114,4,0,6,6
58,114,5,0,7,7
58,114,6,6,15,9
58,115,0,1,7,6
58,115,1,0,2,2
58,115,2,2,12,10
58,115,3,1,9,8
58,115,4,4,15,11
58,115,5,0,13,13
58,115,6,1,12,11
58,116,0,1,7,6
58,116,1,0,4,4
58,116,2,2,6,4
58,116,3,0,7,7
58,116,4,3,14,11
58,116,5,1,12,11
58,116,6,2,11,9
58,117,0,4,12,8
58,117,1,0,5,5
58,117,2,0,6,6
58,117,3,1,3,2
58,117,4,2,13,11
58,117,5,1,8,7
58,117,6,0,7,7
58,118,0,2,8,6
58,118,1,2,10,8
58,118,2,2,12,10
58,118,3,1,10,9
58,118,4,0,8,8
58,118,5,3,9,6
58,118,6,2,8,6
58,119,0,0,9,9
58,119,1,1,14,13
58,119,2,1,9,8
58,119,3,1,3,2
58,119,4,0,10,10
58,119,5,4,14,10
58,119,6,0,10,10
58,120,0,1,11,10
58,120,1,2,11,9
58,120,2,1,10,9
58,120,3,0,15,15
58,120,4,0,8,8
58,120,5,1,5,4
58,120,6,0,9,9
58,121,0,4,10,6
58,121,1,4,11,7
58,121,2,0,8,8
58,121,3,0,3,3
58,121,4,0,12,12
58,121,5,0,9,9
58,121,6,0,8,8
58,122,0,0,5,5
58,122,1,0,6,6
58,122,2,2,9,7
58,122,3,2,11,9
58,122,4,0,7,7
58,122,5,2,8,6
58,122,6,0,10,10
58,123,0,1,11,10
58,123,1,0,9,9
58,123,2,3,9,6
58,123,3,5,16,11
58,123,4,0,7,7
58,123,5,1,9,8
58,123,6,2,14,12
58,124,0,1,7,6
58,124,1,3,8,5
58,124,2,1,9,8
58,124,3,0,9,9
58,124,4,1,11,10
58,124,5,1,12,11
58,124,6,0,7,7
58,125,0,0,4,4
58,125,1,3,7,4
58,125,2,1,12,11
58,125,3,1,5,4
58,125,4,0,6,6
58,125,5,0,3,3
58,125,6,2,10,8
58,126,0,0,6,6
58,126,1,5,16,11
58,126,2,1,9,8
58,126,3,4,9,5
58,126,4,2,11,9
58,126,5,0,5,5
58,126,6,0,7,7
58,127,0,1,7,6
58,127,1,0,5,5
58,127,2,2,9,7
58,127,3,3,7,4
58,127,4,4,13,9
58,127,5,0,9,9
58,127,6,0,6,6
58,128,0,0,5,5
58,128,1,0,6,6
58,128,2,0,7,7
58,128,3,1,11,10
58,128,4,2,15,13
58,128,5,1,7,6
58,128,6,0,2,2
58,129,0,1,4,3
58,129,1,0,7,7
58,129,2,0,4,4
58,129,3,3,8,5
58,129,4,2,5,3
58,129,5,0,4,4
58,129,6,0,1,1
58,130,0,1,4,3
58,130,1,4,11,7
58,130,2,1,6,5
58,130,3,1,4,3
58,130,4,1,10,9
58,130,5,1,5,4
58,130,6,1,5,4
58,131,0,1,5,4
58,131,1,1,7,6
58,131,2,0,5,5
58,131,3,6,13,7
58,131,4,1,7,6
58,131,5,1,6,5
58,131,6,1,5,4
58,132,0,0,3,3
58,132,1,1,7,6
58,132,2,2,6,4
58,132,3,6,13,7
58,132,4,0,2,2
58,132,5,0,3,3
58,132,6,0,4,4
58,133,0,0,1,1
58,133,1,2,5,3
58,133,2,2,5,3
58,133,3,2,7,5
58,133,4,1,7,6
58,133,5,7,12,5
58,133,6,1,5,4
58,134,0,2,4,2
58,134,1,0,5,5
58,134,2,2,7,5
58,134,3,2,9,7
58,134,4,1,8,7
58,134,5,2,10,8
58,134,6,0,1,1
58,135,0,2,4,2
58,135,1,0,4,4
58,135,2,1,6,5
58,135,3,2,7,5
58,135,4,1,6,5
58,135,5,0,4,4
58,135,6,1,4,3
58,136,0,0,6,6
58,136,1,0,4,4
58,136,2,0,7,7
58,136,3,3,10,7
58,136,4,1,7,6
58,136,5,0,3,3
58,136,6,3,6,3
58,137,0,4,5,1
58,137,1,2,6,4
58,137,2,0,3,3
58,137,3,1,6,5
58,137,4,2,6,4
58,137,5,3,9,6
58,137,6,3,7,4
58,138,0,1,5,4
58,138,1,1,3,2
58,138,2,0,5,5
58,138,3,0,1,1
58,138,4,1,3,2
58,138,5,0,6,6
58,138,6,1,2,1
58,139,0,0,1,1
58,139,1,0,4,4
58,139,2,2,3,1
58,139,3,0,1,1
58,139,4,1,6,5
58,139,5,0,3,3
58,139,6,1,3,2
58,140,0,0,1,1
58,140,1,1,2,1
58,140,2,0,1,1
58,140,3,0,3,3
58,140,4,5,8,3
58,140,5,0,3,3
58,140,6,1,1,0
58,141,0,0,2,2
58,141,1,0,6,6
58,141,2,1,5,4
58,141,3,0,3,3
58,141,4,3,7,4
58,141,6,1,4,3
58,142,0,0,1,1
58,142,1,2,6,4
58,142,2,1,4,3
58,142,3,1,4,3
58,142,4,1,4,3
58,142,5,1,2,1
58,142,6,0,3,3
58,143,0,3,5,2
58,143,1,1,4,3
58,143,2,1,4,3
58,143,3,3,5,2
58,143,4,0,2,2
58,143,5,4,5,1
58,143,6,1,3,2
59,0,0,0,3,3
59,0,1,0,3,3
59,0,2,1,3,2
59,0,3,2,6,4
59,0,4,0,2,2
59,0,5,2,5,3
59,0,6,2,2,0
59,1,0,0,1,1
59,1,1,3,3,0
59,1,2,1,3,2
59,1,3,2,4,2
59,1,4,0,1,1
59,1,5,1,2,1
59,1,6,0,2,2
59,2,0,1,1,0
59,2,1,2,3,1
59,2,2,5,6,1
59,2,4,2,7,5
59,2,5,0,2,2
59,2,6,1,2,1
59,3,0,2,2,0
59,3,1,1,2,1
59,3,2,2,2,0
59,3,3,0,4,4
59,3,4,2,3,1
59,3,5,4,5,1
59,3,6,2,3,1
59,4,0,2,2,0
59,4,1,1,1,0
59,4,3,0,1,1
59,4,4,1,2,1
59,4,5,1,3,2
59,4,6,1,2,1
59,5,0,2,2,0
59,5,1,1,1,0
59,5,2,0,2,2
59,5,3,0,1,1
59,5,4,1,2,1
59,5,5,2,3,1
59,5,6,0,2,2
59,6,0,1,2,1
59,6,2,0,1,1
59,7,1,0,1,1
59,7,5,2,5,3
59,7,6,1,1,0
59,8,0,1,2,1
59,8,1,1,2,1
59,8,2,1,2,1
59,8,4,1,4,3
59,8,5,0,1,1
59,9,0,2,2,0
59,9,1,1,2,1
59,9,2,0,1,1
59,9,3,2,2,0
59,9,6,0,1,1
59,10,0,1,3,2
59,10,2,1,2,1
59,10,3,2,3,1
59,10,4,1,1,0
59,10,6,0,1,1
59,11,0,2,2,0
59,11,2,1,1,0
59,11,4,0,1,1
59,11,6,0,2,2
59,12,0,0,1,1
59,12,2,1,1,0
59,12,4,1,3,2
59,13,0,0,1,1
59,13,1,0,1,1
59,13,5,1,1,0
59,13,6,0,1,1
59,14,1,2,3,1
59,14,4,1,1,0
59,15,0,2,2,0
59,15,2,0,1,1
59,15,4,0,1,1
59,15,6,2,2,0
59,16,0,1,3,2
59,16,6,2,2,0
59,17,4,1,1,0
59,17,6,1,1,0
59,18,6,0,1,1
59,19,4,1,1,0
59,19,5,0,1,1
59,21,4,1,1,0
59,22,1,0,1,1
59,24,0,1,1,0
59,24,6,0,1,1
59,25,1,1,1,0
59,26,2,1,1,0
59,27,0,1,1,0
59,28,0,0,1,1
59,29,6,3,4,1
59,31,5,2,2,0
59,32,5,3,3,0
59,33,1,0,1,1
59,33,2,2,2,0
59,34,5,0,1,1
59,35,0,1,1,0
59,35,4,0,1,1
59,36,0,0,1,1
59,36,2,1,1,0
59,36,5,0,1,1
59,37,2,1,2,1
59,37,6,2,2,0
59,38,0,1,1,0
59,38,1,1,5,4
59,38,2,3,3,0
59,38,3,0,1,1
59,38,4,1,2,1
59,38,5,3,4,1
59,39,0,0,1,1
59,39,1,0,1,1
59,39,2,0,4,4
59,39,3,0,2,2
59,39,4,1,3,2
59,39,5,4,5,1
59,39,6,2,2,0
59,40,0,2,5,3
59,40,1,0,3,3
59,40,2,1,4,3
59,40,3,1,4,3
59,40,4,0,2,2
59,40,5,2,5,3
59,40,6,4,5,1
59,41,0,0,3,3
59,41,1,0,2,2
59,41,2,0,2,2
59,41,3,0,2,2
59,41,4,0,3,3
59,41,5,2,3,1
59,41,6,1,2,1
59,42,0,1,12,11
59,42,1,0,10,10
59,42,2,0,9,9
59,42,3,1,12,11
59,42,4,0,2,2
59,42,5,2,6,4
59,42,6,1,4,3
59,43,0,3,39,36
59,43,1,0,26,26
59,43,2,3,32,29
59,43,3,9,41,32
59,43,4,5,32,27
59,43,5,1,11,10
59,43,6,3,6,3
59,44,0,23,55,32
59,44,1,22,57,35
59,44,2,46,88,42
59,44,3,62,101,39
59,44,4,26,67,41
59,44,5,8,24,16
59,44,6,5,14,9
59,45,0,8,37,29
59,45,1,25,57,32
59,45,2,18,43,25
59,45,3,25,50,25
59,45,4,4,28,24
59,45,5,15,35,20
59,45,6,4,17,13
59,46,0,2,16,14
59,46,1,4,19,15
59,46,2,0,13,13
59,46,3,8,32,24
59,46,4,2,13,11
59,46,5,1,12,11
59,46,6,0,10,10
59,47,0,4,16,12
59,47,1,3,19,16
59,47,2,1,16,15
59,47,3,5,23,18
59,47,4,6,24,18
59,47,5,0,5,5
59,47,6,0,10,10
59,48,0,0,22,22
59,48,1,1,17,16
59,48,2,5,25,20
59,48,3,1,23,22
59,48,4,0,13,13
59,48,5,1,8,7
59,48,6,0,9,9
59,49,0,2,24,22
59,49,1,0,23,23
59,49,2,3,27,24
59,49,3,1,18,17
59,49,4,0,15,15
59,49,5,1,19,18
59,49,6,0,8,8
59,50,0,4,15,11
59,50,1,1,14,13
59,50,2,1,9,8
59,50,3,2,20,18
59,50,4,0,12,12
59,50,5,0,5,5
59,50,6,0,9,9
59,51,0,6,23,17
59,51,1,0,11,11
59,51,2,1,10,9
59,51,3,1,15,14
59,51,4,2,10,8
59,51,5,3,16,13
59,51,6,2,9,7
59,52,0,8,18,10
59,52,1,1,15,14
59,52,2,2,10,8
59,52,3,3,17,14
59,52,4,0,3,3
59,52,5,4,13,9
59,52,6,1,14,13
59,53,0,1,8,7
59,53,1,0,12,12
59,53,2,0,7,7
59,53,3,3,15,12
59,53,4,0,11,11
59,53,5,3,19,16
59,53,6,4,15,11
59,54,0,3,16,13
59,54,1,0,11,11
59,54,2,2,16,14
59,54,3,0,13,13
59,54,4,0,7,7
59,54,5,1,5,4
59,54,6,1,12,11
59,55,0,1,7,6
59,55,1,0,12,12
59,55,2,1,12,11
59,55,3,0,11,11
59,55,4,4,12,8
59,55,5,0,11,11
59,55,6,0,7,7
59,56,0,5,15,10
59,56,1,0,9,9
59,56,2,3,13,10
59,56,3,4,11,7
59,56,4,1,9,8
59,56,5,2,9,7
59,56,6,1,10,9
59,57,0,4,9,5
59,57,1,3,9,6
59,57,2,2,11,9
59,57,3,0,7,7
59,57,4,0,5,5
59,57,5,3,14,11
59,57,6,1,4,3
59,58,0,0,9,9
59,58,1,1,5,4
59,58,2,1,3,2
59,58,3,0,6,6
59,58,4,0,9,9
59,58,5,4,12,8
59,58,6,4,9,5
59,59,0,2,9,7
59,59,1,0,6,6
59,59,2,0,6,6
59,59,3,0,6,6
59,59,4,0,3,3
59,59,5,11,19,8
59,59,6,1,6,5
59,60,0,1,3,2
59,60,1,0,5,5
59,60,2,0,6,6
59,60,3,0,4,4
59,60,4,2,8,6
59,60,5,3,7,4
59,60,6,2,7,5
59,61,0,2,7,5
59,61,1,0,6,6
59,61,2,2,5,3
59,61,3,3,5,2
59,61,4,5,12,7
59,61,5,1,5,4
59,61,6,0,10,10
59,62,0,3,7,4
59,62,1,3,9,6
59,62,2,2,7,5
59,62,3,3,5,2
59,62,4,1,4,3
59,62,5,7,10,3
59,62,6,1,8,7
59,63,0,4,10,6
59,63,1,4,9,5
59,63,2,3,7,4
59,63,3,2,7,5
59,63,4,0,1,1
59,63,5,1,8,7
59,63,6,0,5,5
59,64,0,5,13,8
59,64,1,0,6,6
59,64,2,2,6,4
59,64,3,0,4,4
59,64,4,1,1,0
59,64,5,1,4,3
59,64,6,0,8,8
59,65,0,1,6,5
59,65,1,1,9,8
59,65,2,2,5,3
59,65,3,0,2,2
59,65,4,3,5,2
59,65,5,0,3,3
59,65,6,2,3,1
59,66,0,3,10,7
59,66,1,1,7,6
59,66,2,1,9,8
59,66,3,1,6,5
59,66,4,7,12,5
59,66,5,6,11,5
59,66,6,2,7,5
59,67,0,2,6,4
59,67,1,0,2,2
59,67,2,1,3,2
59,67,3,0,5,5
59,67,4,1,6,5
59,67,5,5,7,2
59,67,6,1,4,3
59,68,0,0,4,4
59,68,1,0,7,7
59,68,2,1,4,3
59,68,3,1,3,2
59,68,4,1,5,4
59,68,5,4,11,7
59,68,6,1,8,7
59,69,0,0,3,3
59,69,1,0,3,3
59,69,2,1,3,2
59,69,3,0,4,4
59,69,4,2,8,6
59,69,5,0,6,6
59,69,6,6,13,7
59,70,0,0,4,4
59,70,1,0,2,2
59,70,2,3,9,6
59,70,3,4,12,8
59,70,4,2,9,7
59,70,5,2,7,5
59,70,6,3,10,7
59,71,0,0,5,5
59,71,1,1,5,4
59,71,2,1,5,4
59,71,3,17,21,4
59,71,4,8,15,7
59,71,5,4,10,6
59,71,6,4,10,6
59,72,0,0,2,2
59,72,1,2,13,11
59,72,2,4,15,11
59,72,3,4,13,9
59,72,4,2,8,6
59,72,5,2,6,4
59,72,6,1,6,5
59,73,0,1,7,6
59,73,1,3,12,9
59,73,2,4,8,4
59,73,3,2,8,6
59,73,4,4,12,8
59,73,5,2,9,7
59,73,6,1,9,8
59,74,0,1,8,7
59,74,1,1,6,5
59,74,2,2,5,3
59,74,3,4,14,10
59,74,4,3,14,11
59,74,5,0,4,4
59,74,6,3,19,16
59,75,0,0,1,1
59,75,1,2,6,4
59,75,2,5,11,6
59,75,3,2,8,6
59,75,4,3,11,8
59,75,5,3,7,4
59,75,6,8,20,12
59,76,0,2,6,4
59,76,1,1,2,1
59,76,2,4,7,3
59,76,3,1,5,4
59,76,4,4,9,5
59,76,5,5,13,8
59,76,6,3,11,8
59,77,0,8,15,7
59,77,1,0,1,1
59,77,2,4,11,7
59,77,3,0,1,1
59,77,4,2,15,13
59,77,5,7,16,9
59,77,6,1,10,9
59,78,0,3,11,8
59,78,1,1,6,5
59,78,2,3,6,3
59,78,3,1,5,4
59,78,4,7,14,7
59,78,5,2,13,11
59,78,6,0,6,6
59,79,0,1,7,6
59,79,1,1,6,5
59,79,2,0,2,2
59,79,3,2,4,2
59,79,4,2,5,3
59,79,5,6,15,9
59,79,6,1,10,9
59,80,0,0,7,7
59,80,1,3,8,5
59,80,2,3,5,2
59,80,3,1,7,6
59,80,4,4,7,3
59,80,5,2,6,4
59,80,6,2,11,9
59,81,0,2,8,6
59,81,1,0,5,5
59,81,2,5,10,5
59,81,3,0,8,8
59,81,4,0,4,4
59,81,5,1,8,7
59,81,6,1,14,13
59,82,0,1,6,5
59,82,1,1,6,5
59,82,2,0,7,7
59,82,3,0,2,2
59,82,4,0,2,2
59,82,5,0,4,4
59,82,6,1,3,2
59,83,1,0,5,5
59,83,2,1,4,3
59,83,3,2,6,4
59,83,4,0,2,2
59,83,5,9,12,3
59,83,6,6,16,10
59,84,0,1,5,4
59,84,1,0,5,5
59,84,2,2,6,4
59,84,3,0,3,3
59,84,4,0,5,5
59,84,5,5,14,9
59,84,6,5,10,5
59,85,0,0,4,4
59,85,1,1,2,1
59,85,2,3,5,2
59,85,3,8,9,1
59,85,4,1,10,9
59,85,5,0,2,2
59,85,6,1,9,8
59,86,0,0,3,3
59,86,1,1,5,4
59,86,2,2,4,2
59,86,3,2,6,4
59,86,4,1,11,10
59,86,5,0,3,3
59,86,6,4,10,6
59,87,0,0,2,2
59,87,1,1,5,4
59,87,2,0,3,3
59,87,3,2,4,2
59,87,4,5,11,6
59,87,5,1,5,4
59,87,6,0,6,6
59,88,0,2,4,2
59,88,1,1,4,3
59,88,2,6,9,3
59,88,3,1,2,1
59,88,4,5,10,5
59,88,5,1,11,10
59,88,6,0,10,10
59,89,0,6,9,3
59,89,1,1,6,5
59,89,2,4,8,4
59,89,3,2,7,5
59,89,4,5,9,4
59,89,5,1,5,4
59,89,6,2,4,2
59,90,0,2,7,5
59,90,1,1,7,6
59,90,2,2,6,4
59,90,3,2,4,2
59,90,4,4,7,3
59,90,5,1,5,4
59,90,6,4,13,9
59,91,1,0,5,5
59,91,2,3,7,4
59,91,3,2,10,8
59,91,4,4,14,10
59,91,5,2,12,10
59,91,6,4,14,10
59,92,0,0,1,1
59,92,1,1,3,2
59,92,2,0,2,2
59,92,3,0,2,2
59,92,4,4,9,5
59,92,5,1,5,4
59,92,6,0,5,5
59,93,0,1,5,4
59,93,1,1,8,7
59,93,2,1,4,3
59,93,3,1,3,2
59,93,4,0,12,12
59,93,5,2,11,9
59,93,6,1,12,11
59,94,0,1,4,3
59,94,1,0,7,7
59,94,2,3,15,12
59,94,3,1,7,6
59,94,4,2,12,10
59,94,5,1,8,7
59,94,6,3,11,8
59,95,0,0,2,2
59,95,1,1,3,2
59,95,2,1,9,8
59,95,3,1,7,6
59,95,4,0,6,6
59,95,5,1,4,3
59,95,6,1,6,5
59,96,0,2,7,5
59,96,1,4,9,5
59,96,2,1,12,11
59,96,3,1,3,2
59,96,4,0,11,11
59,96,5,2,9,7
59,96,6,0,10,10
59,97,0,2,12,10
59,97,1,1,8,7
59,97,2,0,7,7
59,97,3,1,5,4
59,97,4,0,11,11
59,97,5,0,5,5
59,97,6,1,16,15
59,98,0,1,10,9
59,98,1,0,8,8
59,98,2,0,7,7
59,98,3,0,12,12
59,98,4,0,16,16
59,98,5,1,8,7
59,98,6,1,17,16
59,99,0,0,6,6
59,99,1,5,9,4
59,99,2,3,9,6
59,99,3,1,9,8
59,99,4,2,15,13
59,99,5,3,7,4
59,99,6,3,14,11
59,100,0,0,9,9
59,100,1,5,8,3
59,100,2,0,4,4
59,100,3,0,10,10
59,100,4,2,10,8
59,100,5,6,13,7
59,100,6,0,10,10
59,101,0,2,10,8
59,101,1,2,7,5
59,101,2,0,9,9
59,101,3,4,7,3
59,101,4,0,9,9
59,101,5,1,4,3
59,101,6,0,13,13
59,102,0,1,5,4
59,102,1,0,9,9
59,102,2,1,8,7
59,102,3,1,10,9
59,102,4,2,11,9
59,102,5,0,8,8
59,102,6,2,13,11
59,103,0,1,7,6
59,103,1,2,12,10
59,103,2,4,20,16
59,103,3,1,6,5
59,103,4,0,9,9
59,103,5,1,10,9
59,103,6,1,5,4
59,104,0,0,7,7
59,104,1,0,9,9
59,104,2,2,16,14
59,104,3,0,7,7
59,104,4,1,10,9
59,104,5,0,6,6
59,104,6,1,9,8
59,105,0,0,12,12
59,105,1,0,7,7
59,105,2,1,12,11
59,105,3,0,7,7
59,105,4,0,9,9
59,105,5,0,5,5
59,105,6,0,7,7
59,106,0,3,11,8
59,106,1,3,12,9
59,106,2,0,7,7
59,106,3,1,9,8
59,106,4,0,7,7
59,106,5,2,9,7
59,106,6,1,11,10
59,107,0,1,8,7
59,107,1,0,10,10
59,107,2,1,10,9
59,107,3,1,8,7
59,107,4,1,11,10
59,107,5,4,15,11
59,107,6,2,11,9
59,108,0,0,6,6
59,108,1,2,11,9
59,108,2,0,9,9
59,108,3,3,10,7
59,108,4,2,13,11
59,108,5,0,11,11
59,108,6,2,14,12
59,109,0,0,7,7
59,109,1,1,7,6
59,109,2,0,3,3
59,109,3,3,10,7
59,109,4,1,10,9
59,109,5,1,14,13
59,109,6,1,8,7
59,110,0,0,8,8
59,110,1,1,6,5
59,110,2,0,9,9
59,110,3,0,7,7
59,110,4,0,10,10
59,110,5,1,9,8
59,110,6,1,8,7
59,111,0,1,5,4
59,111,1,1,3,2
59,111,2,1,9,8
59,111,3,0,5,5
59,111,4,0,7,7
59,111,5,5,11,6
59,111,6,1,15,14
59,112,0,1,10,9
59,112,1,0,15,15
59,112,2,0,7,7
59,112,3,1,12,11
59,112,4,4,8,4
59,112,5,0,9,9
59,112,6,1,11,10
59,113,0,3,15,12
59,113,1,2,10,8
59,113,2,3,23,20
59,113,3,0,7,7
59,113,4,3,16,13
59,113,5,4,18,14
59,113,6,0,11,11
59,114,0,1,6,5
59,114,1,0,5,5
59,114,2,2,9,7
59,114,3,0,9,9
59,114,4,0,9,9
59,114,5,0,6,6
59,114,6,1,10,9
59,115,0,0,2,2
59,115,1,0,6,6
59,115,2,0,7,7
59,115,3,0,4,4
59,115,4,0,9,9
59,115,5,0,7,7
59,115,6,1,10,9
59,116,0,0,11,11
59,116,1,0,8,8
59,116,2,2,8,6
59,116,3,1,2,1
59,116,4,0,8,8
59,116,5,2,15,13
59,116,6,4,7,3
59,117,0,1,7,6
59,117,1,0,5,5
59,117,2,0,9,9
59,117,3,0,6,6
59,117,4,2,10,8
59,117,5,0,6,6
59,117,6,0,5,5
59,118,0,2,5,3
59,118,1,1,8,7
59,118,2,0,4,4
59,118,3,0,9,9
59,118,4,6,19,13
59,118,5,0,8,8
59,118,6,2,8,6
59,119,0,1,7,6
59,119,1,1,13,12
59,119,2,0,9,9
59,119,3,4,10,6
59,119,4,1,8,7
59,119,5,2,10,8
59,119,6,1,9,8
59,120,0,2,3,1
59,120,1,2,4,2
59,120,2,1,6,5
59,120,3,0,8,8
59,120,4,0,5,5
59,120,5,3,12,9
59,120,6,1,15,14
59,121,0,1,10,9
59,121,1,0,3,3
59,121,2,0,5,5
59,121,3,0,8,8
59,121,4,3,14,11
59,121,5,4,11,7
59,121,6,0,4,4
59,122,0,1,8,7
59,122,1,0,5,5
59,122,2,0,8,8
59,122,3,0,5,5
59,122,4,4,13,9
59,122,5,1,9,8
59,122,6,0,6,6
59,123,0,1,7,6
59,123,1,3,11,8
59,123,2,0,3,3
59,123,3,1,7,6
59,123,4,1,8,7
59,123,5,0,9,9
59,123,6,0,11,11
59,124,0,0,8,8
59,124,1,0,10,10
59,124,2,1,10,9
59,124,3,0,5,5
59,124,4,1,10,9
59,124,5,2,11,9
59,124,6,0,3,3
59,125,0,0,4,4
59,125,1,0,5,5
59,125,2,3,8,5
59,125,3,1,6,5
59,125,4,2,11,9
59,125,5,3,14,11
59,125,6,0,3,3
59,126,0,0,4,4
59,126,1,3,11,8
59,126,2,0,5,5
59,126,3,0,4,4
59,126,4,5,10,5
59,126,5,0,7,7
59,126,6,1,4,3
59,127,0,6,13,7
59,127,1,0,6,6
59,127,2,1,7,6
59,127,3,0,3,3
59,127,4,1,10,9
59,127,5,1,9,8
59,127,6,0,5,5
59,128,0,1,10,9
59,128,1,0,8,8
59,128,2,1,8,7
59,128,3,0,7,7
59,128,4,0,14,14
59,128,5,3,10,7
59,128,6,5,15,10
59,129,0,3,10,7
59,129,1,1,9,8
59,129,2,0,4,4
59,129,3,0,7,7
59,129,4,1,11,10
59,129,5,0,10,10
59,129,6,1,5,4
59,130,0,2,8,6
59,130,1,3,7,4
59,130,2,4,9,5
59,130,3,1,5,4
59,130,4,5,15,10
59,130,5,2,8,6
59,130,6,1,5,4
59,131,0,1,5,4
59,131,1,7,8,1
59,131,2,1,3,2
59,131,3,0,2,2
59,131,4,1,8,7
59,131,5,0,11,11
59,131,6,1,4,3
59,132,0,2,7,5
59,132,1,3,10,7
59,132,2,0,9,9
59,132,3,0,6,6
59,132,4,0,4,4
59,132,5,1,6,5
59,132,6,2,15,13
59,133,0,0,4,4
59,133,1,0,1,1
59,133,2,0,6,6
59,133,3,2,7,5
59,133,4,0,7,7
59,133,5,1,5,4
59,133,6,3,5,2
59,134,0,1,5,4
59,134,1,0,5,5
59,134,2,1,5,4
59,134,3,2,4,2
59,134,4,0,2,2
59,134,5,1,10,9
59,134,6,1,6,5
59,135,0,4,6,2
59,135,1,3,11,8
59,135,2,2,5,3
59,135,3,2,6,4
59,135,4,0,1,1
59,135,5,0,5,5
59,135,6,3,5,2
59,136,0,1,3,2
59,136,1,0,5,5
59,136,2,4,12,8
59,136,3,1,2,1
59,136,4,2,6,4
59,136,5,0,6,6
59,136,6,0,5,5
59,137,0,1,2,1
59,137,1,0,4,4
59,137,2,1,5,4
59,137,3,2,4,2
59,137,4,5,16,11
59,137,5,4,7,3
59,137,6,1,1,0
59,138,0,0,3,3
59,138,2,0,4,4
59,138,4,3,7,4
59,138,5,0,1,1
59,138,6,0,3,3
59,139,0,0,6,6
59,139,1,3,7,4
59,139,2,0,2,2
59,139,3,0,1,1
59,139,4,0,5,5
59,139,5,0,3,3
59,139,6,4,8,4
59,140,1,0,2,2
59,140,2,6,10,4
59,140,3,0,4,4
59,140,4,0,2,2
59,140,6,1,2,1
59,141,0,1,2,1
59,141,1,0,1,1
59,141,2,0,3,3
59,141,3,1,2,1
59,141,4,1,6,5
59,141,5,0,1,1
59,141,6,2,3,1
59,142,0,4,6,2
59,142,1,0,2,2
59,142,2,1,5,4
59,142,3,0,5,5
59,142,4,1,3,2
59,142,5,4,7,3
59,142,6,2,2,0
59,143,0,0,1,1
59,143,1,0,2,2
59,143,2,2,3,1
59,143,3,0,2,2
59,143,4,2,4,2
59,143,5,3,4,1
59,143,6,0,2,2
60,0,0,1,1,0
60,0,2,2,3,1
60,0,4,2,2,0
60,0,6,1,1,0
60,1,0,0,1,1
60,1,2,4,4,0
60,1,3,2,2,0
60,1,4,0,1,1
60,2,5,0,2,2
60,2,6,1,1,0
60,3,0,1,2,1
60,3,4,0,1,1
60,3,5,0,1,1
60,4,0,1,1,0
60,4,4,0,1,1
60,4,5,1,1,0
60,5,3,4,4,0
60,7,0,0,1,1
60,7,1,0,1,1
60,7,4,0,1,1
60,7,5,1,1,0
60,8,0,1,1,0
60,8,4,2,3,1
60,9,2,3,4,1
60,10,2,2,2,0
60,10,3,1,2,1
60,11,2,1,1,0
60,12,2,3,3,0
60,13,5,1,1,0
60,15,0,1,2,1
60,15,5,1,1,0
60,16,3,0,1,1
60,17,1,0,1,1
60,20,1,2,2,0
60,21,5,1,1,0
60,25,3,1,1,0
60,27,4,1,1,0
60,28,3,1,1,0
60,29,3,1,1,0
60,30,2,1,1,0
60,31,3,1,1,0
60,33,3,0,1,1
60,34,1,1,1,0
60,34,2,0,1,1
60,35,1,1,1,0
60,35,2,1,1,0
60,36,5,2,2,0
60,37,0,2,2,0
60,38,0,1,1,0
60,38,4,1,1,0
60,38,5,3,3,0
60,39,0,0,2,2
60,39,1,1,2,1
60,39,2,4,5,1
60,39,5,2,2,0
60,40,0,0,1,1
60,40,1,0,2,2
60,40,2,0,1,1
60,40,4,1,1,0
60,40,5,1,1,0
60,41,0,4,7,3
60,41,1,0,1,1
60,41,2,0,1,1
60,41,3,0,5,5
60,41,4,2,5,3
60,41,6,0,1,1
60,42,0,3,7,4
60,42,1,0,6,6
60,42,2,0,2,2
60,42,3,0,2,2
60,42,4,0,6,6
60,42,5,0,2,2
60,43,0,0,3,3
60,43,1,0,3,3
60,43,3,0,3,3
60,43,4,4,9,5
60,43,5,2,2,0
60,44,0,4,8,4
60,44,1,2,6,4
60,44,2,2,5,3
60,44,3,1,3,2
60,44,4,3,5,2
60,44,5,2,7,5
60,44,6,0,2,2
60,45,0,4,11,7
60,45,1,5,9,4
60,45,2,2,7,5
60,45,3,1,2,1
60,45,4,2,10,8
60,45,5,0,2,2
60,45,6,4,7,3
60,46,0,5,13,8
60,46,1,5,17,12
60,46,2,1,9,8
60,46,3,7,12,5
60,46,4,1,5,4
60,46,5,1,4,3
60,46,6,5,7,2
60,47,0,1,12,11
60,47,1,4,8,4
60,47,2,0,8,8
60,47,3,5,21,16
60,47,4,0,2,2
60,47,5,1,2,1
60,47,6,1,4,3
60,48,0,0,6,6
60,48,1,2,15,13
60,48,2,5,11,6
60,48,3,5,14,9
60,48,4,1,3,2
60,48,5,0,7,7
60,48,6,0,3,3
60,49,0,1,8,7
60,49,1,1,6,5
60,49,2,5,14,9
60,49,3,0,9,9
60,49,4,2,9,7
60,49,5,4,7,3
60,49,6,1,4,3
60,50,0,0,11,11
60,50,1,0,8,8
60,50,2,2,12,10
60,50,3,3,10,7
60,50,4,0,5,5
60,50,5,2,6,4
60,50,6,1,7,6
60,51,0,0,7,7
60,51,1,1,11,10
60,51,2,0,5,5
60,51,3,1,11,10
60,51,4,0,8,8
60,51,5,2,7,5
60,51,6,0,7,7
60,52,0,0,13,13
60,52,1,3,12,9
60,52,2,1,10,9
60,52,3,0,6,6
60,52,4,6,12,6
60,52,5,2,9,7
60,52,6,4,6,2
60,53,0,0,5,5
60,53,1,6,10,4
60,53,2,2,10,8
60,53,3,0,2,2
60,53,4,2,8,6
60,53,5,1,6,5
60,53,6,2,8,6
60,54,0,1,2,1
60,54,1,1,4,3
60,54,2,4,8,4
60,54,3,2,2,0
60,54,4,4,8,4
60,54,5,6,7,1
60,54,6,0,4,4
60,55,0,0,4,4
60,55,1,0,4,4
60,55,2,0,4,4
60,55,3,1,5,4
60,55,4,5,9,4
60,55,5,0,1,1
60,55,6,1,2,1
60,56,0,1,3,2
60,56,1,1,2,1
60,56,2,1,7,6
60,56,3,1,7,6
60,56,4,3,8,5
60,56,5,0,2,2
60,56,6,0,2,2
60,57,0,0,3,3
60,57,1,3,5,2
60,57,2,1,3,2
60,57,3,1,2,1
60,57,4,0,1,1
60,57,5,0,2,2
60,57,6,1,2,1
60,58,0,0,3,3
60,58,1,1,5,4
60,58,2,0,2,2
60,58,3,1,2,1
60,58,4,0,3,3
60,58,5,1,2,1
60,58,6,0,3,3
60,59,0,2,3,1
60,59,1,1,4,3
60,59,3,0,2,2
60,59,4,0,1,1
60,59,5,1,4,3
60,59,6,0,4,4
60,60,0,0,4,4
60,60,1,3,5,2
60,60,2,2,4,2
60,60,3,1,4,3
60,60,4,3,6,3
60,60,5,5,14,9
60,60,6,3,4,1
60,61,0,0,2,2
60,61,1,3,4,1
60,61,2,2,4,2
60,61,3,0,1,1
60,61,4,6,8,2
60,61,5,6,8,2
60,61,6,1,4,3
60,62,0,0,2,2
60,62,1,4,6,2
60,62,2,2,3,1
60,62,3,1,2,1
60,62,4,8,12,4
60,62,5,3,5,2
60,62,6,2,5,3
60,63,0,1,3,2
60,63,1,1,4,3
60,63,2,0,1,1
60,63,3,1,3,2
60,63,4,4,7,3
60,63,5,7,12,5
60,63,6,0,2,2
60,64,0,6,7,1
60,64,1,1,1,0
60,64,2,2,5,3
60,64,3,0,3,3
60,64,4,1,2,1
60,64,5,6,9,3
60,64,6,0,3,3
60,65,0,2,3,1
60,65,1,0,6,6
60,65,3,2,5,3
60,65,4,0,4,4
60,65,5,1,2,1
60,65,6,0,1,1
60,66,0,2,6,4
60,66,1,0,5,5
60,66,2,3,5,2
60,66,3,4,6,2
60,66,4,4,4,0
60,66,5,1,3,2
60,66,6,3,7,4
60,67,1,0,2,2
60,67,3,3,6,3
60,67,4,1,4,3
60,67,5,0,1,1
60,67,6,1,2,1
60,68,0,9,10,1
60,68,1,1,1,0
60,68,3,1,2,1
60,68,4,3,6,3
60,68,5,1,3,2
60,68,6,0,5,5
60,69,1,1,1,0
60,69,2,1,5,4
60,69,3,1,1,0
60,69,4,1,2,1
60,69,5,1,2,1
60,69,6,1,2,1
60,70,1,1,3,2
60,70,2,1,1,0
60,70,3,1,1,0
60,70,4,1,3,2
60,70,5,5,7,2
60,70,6,0,4,4
60,71,0,1,3,2
60,71,1,5,8,3
60,71,2,2,4,2
60,71,3,1,3,2
60,71,4,0,4,4
60,71,5,1,2,1
60,71,6,0,3,3
60,72,0,4,8,4
60,72,1,2,6,4
60,72,2,1,2,1
60,72,3,0,1,1
60,72,4,1,2,1
60,72,5,4,4,0
60,72,6,0,5,5
60,73,0,0,3,3
60,73,1,0,1,1
60,73,2,2,3,1
60,73,3,1,3,2
60,73,4,0,3,3
60,73,5,10,15,5
60,73,6,1,3,2
60,74,0,4,7,3
60,74,1,0,1,1
60,74,2,0,2,2
60,74,3,1,3,2
60,74,4,3,5,2
60,74,5,3,6,3
60,74,6,1,4,3
60,75,0,1,4,3
60,75,1,0,4,4
60,75,2,1,2,1
60,75,3,0,2,2
60,75,4,3,3,0
60,75,5,1,6,5
60,75,6,1,5,4
60,76,0,0,3,3
60,76,1,0,1,1
60,76,2,3,7,4
60,76,3,2,2,0
60,76,4,1,6,5
60,76,5,1,4,3
60,76,6,4,10,6
60,77,0,1,4,3
60,77,1,1,3,2
60,77,2,1,5,4
60,77,3,3,5,2
60,77,4,4,7,3
60,77,5,0,3,3
60,77,6,1,2,1
60,78,0,0,2,2
60,78,1,2,2,0
60,78,2,1,1,0
60,78,3,1,2,1
60,78,4,9,12,3
60,78,5,1,6,5
60,78,6,3,6,3
60,79,0,2,3,1
60,79,1,4,5,1
60,79,2,0,2,2
60,79,3,3,7,4
60,79,4,2,3,1
60,79,5,9,14,5
60,79,6,7,8,1
60,80,0,0,1,1
60,80,1,4,6,2
60,80,2,5,6,1
60,80,4,2,3,1
60,80,5,3,9,6
60,80,6,1,5,4
60,81,0,0,2,2
60,81,1,0,2,2
60,81,2,6,9,3
60,81,3,0,1,1
60,81,4,3,5,2
60,81,5,3,11,8
60,81,6,2,8,6
60,82,0,0,2,2
60,82,1,0,2,2
60,82,2,3,3,0
60,82,3,0,2,2
60,82,4,1,2,1
60,82,5,0,4,4
60,82,6,2,6,4
60,83,0,3,5,2
60,83,1,1,2,1
60,83,2,0,1,1
60,83,3,1,6,5
60,83,4,4,6,2
60,83,5,0,3,3
60,83,6,1,3,2
60,84,0,4,8,4
60,84,1,4,4,0
60,84,3,3,3,0
60,84,4,1,2,1
60,84,5,0,1,1
60,84,6,2,5,3
60,85,0,1,4,3
60,85,1,1,2,1
60,85,2,2,3,1
60,85,3,0,2,2
60,85,4,3,5,2
60,85,5,3,4,1
60,85,6,0,1,1
60,86,0,0,1,1
60,86,1,1,3,2
60,86,2,3,9,6
60,86,3,0,2,2
60,86,4,5,6,1
60,86,5,0,3,3
60,86,6,1,2,1
60,87,0,0,1,1
60,87,1,0,2,2
60,87,2,4,6,2
60,87,3,1,3,2
60,87,4,5,8,3
60,87,5,0,1,1
60,87,6,3,6,3
60,88,1,0,4,4
60,88,2,3,3,0
60,88,3,0,1,1
60,88,4,4,4,0
60,88,5,1,4,3
60,88,6,2,3,1
60,89,0,1,2,1
60,89,1,3,3,0
60,89,3,0,2,2
60,89,4,2,2,0
60,89,5,2,5,3
60,89,6,2,3,1
60,90,0,4,6,2
60,90,1,0,1,1
60,90,2,0,1,1
60,90,3,0,2,2
60,90,4,2,3,1
60,90,5,3,3,0
60,90,6,2,4,2
60,91,0,1,3,2
60,91,1,0,2,2
60,91,2,3,4,1
60,91,3,3,5,2
60,91,4,1,3,2
60,91,5,1,4,3
60,91,6,1,5,4
60,92,0,0,3,3
60,92,1,0,2,2
60,92,2,2,3,1
60,92,3,3,9,6
60,92,4,3,3,0
60,92,5,0,3,3
60,92,6,3,5,2
60,93,0,0,4,4
60,93,1,1,1,0
60,93,2,5,7,2
60,93,3,1,4,3
60,93,4,1,6,5
60,93,5,0,6,6
60,93,6,0,4,4
60,94,1,2,6,4
60,94,2,2,4,2
60,94,3,0,5,5
60,94,5,0,4,4
60,94,6,5,9,4
60,95,0,0,2,2
60,95,1,2,6,4
60,95,2,1,3,2
60,95,3,1,3,2
60,95,4,0,2,2
60,95,5,3,7,4
60,95,6,4,6,2
60,96,0,1,2,1
60,96,1,1,1,0
60,96,3,0,2,2
60,96,4,1,7,6
60,96,5,3,9,6
60,96,6,1,8,7
60,97,0,0,3,3
60,97,1,2,7,5
60,97,2,3,6,3
60,97,3,1,4,3
60,97,4,0,7,7
60,97,5,1,4,3
60,97,6,0,1,1
60,98,0,6,9,3
60,98,1,1,3,2
60,98,2,6,9,3
60,98,3,0,4,4
60,98,4,2,9,7
60,98,5,1,9,8
60,98,6,0,4,4
60,99,0,1,3,2
60,99,1,0,4,4
60,99,2,7,12,5
60,99,3,3,7,4
60,99,4,1,5,4
60,99,5,3,13,10
60,99,6,0,3,3
60,100,0,2,4,2
60,100,1,0,6,6
60,100,2,6,10,4
60,100,3,0,2,2
60,100,4,0,4,4
60,100,5,2,7,5
60,100,6,9,13,4
60,101,0,0,1,1
60,101,1,2,9,7
60,101,2,2,9,7
60,101,3,2,7,5
60,101,4,4,6,2
60,101,5,0,3,3
60,101,6,2,7,5
60,102,0,0,5,5
60,102,1,0,7,7
60,102,2,2,8,6
60,102,3,2,9,7
60,102,4,7,13,6
60,102,5,0,5,5
60,102,6,0,3,3
60,103,0,5,7,2
60,103,1,2,4,2
60,103,2,4,13,9
60,103,3,5,13,8
60,103,4,0,5,5
60,103,5,1,3,2
60,103,6,0,4,4
60,104,0,1,4,3
60,104,1,2,6,4
60,104,2,1,4,3
60,104,3,0,1,1
60,104,4,0,2,2
60,104,5,3,8,5
60,104,6,4,7,3
60,105,0,2,4,2
60,105,1,2,6,4
60,105,2,5,8,3
60,105,3,0,4,4
60,105,4,3,7,4
60,105,5,2,6,4
60,105,6,4,5,1
60,106,0,1,2,1
60,106,1,3,6,3
60,106,2,3,7,4
60,106,3,2,6,4
60,106,4,4,10,6
60,106,5,0,3,3
60,106,6,0,5,5
60,107,0,0,5,5
60,107,1,3,9,6
60,107,2,2,4,2
60,107,3,3,9,6
60,107,4,0,7,7
60,107,5,0,3,3
60,107,6,0,1,1
60,108,0,3,10,7
60,108,1,0,6,6
60,108,2,1,6,5
60,108,3,3,7,4
60,108,4,3,5,2
60,108,5,1,7,6
60,108,6,0,2,2
60,109,0,0,6,6
60,109,1,0,4,4
60,109,2,1,4,3
60,109,3,7,12,5
60,109,4,3,9,6
60,109,5,1,4,3
60,109,6,0,2,2
60,110,0,0,1,1
60,110,1,1,6,5
60,110,2,4,10,6
60,110,3,5,11,6
60,110,4,2,4,2
60,110,5,1,1,0
60,110,6,3,9,6
60,111,0,2,5,3
60,111,1,5,9,4
60,111,2,1,3,2
60,111,3,1,3,2
60,111,4,0,1,1
60,111,5,0,5,5
60,111,6,0,6,6
60,112,0,1,4,3
60,112,1,5,9,4
60,112,2,2,7,5
60,112,3,2,4,2
60,112,4,4,9,5
60,112,6,1,3,2
60,113,0,1,5,4
60,113,1,1,5,4
60,113,2,1,5,4
60,113,3,1,3,2
60,113,4,0,2,2
60,113,5,2,5,3
60,113,6,0,2,2
60,114,1,2,5,3
60,114,2,0,3,3
60,114,3,0,1,1
60,114,4,4,8,4
60,114,5,3,4,1
60,114,6,2,4,2
60,115,0,1,2,1
60,115,1,0,2,2
60,115,2,6,9,3
60,115,3,0,4,4
60,115,4,2,5,3
60,115,5,2,4,2
60,115,6,1,5,4
60,116,0,0,1,1
60,116,1,2,9,7
60,116,2,1,1,0
60,116,3,2,7,5
60,116,4,2,4,2
60,116,5,2,4,2
60,116,6,0,1,1
60,117,0,0,3,3
60,117,1,3,4,1
60,117,2,1,1,0
60,117,3,0,2,2
60,117,4,0,3,3
60,117,5,1,5,4
60,117,6,0,1,1
60,118,0,1,5,4
60,118,1,5,6,1
60,118,2,0,3,3
60,118,3,1,2,1
60,118,4,2,3,1
60,118,5,0,1,1
60,118,6,2,5,3
60,119,0,0,3,3
60,119,2,1,2,1
60,119,3,2,2,0
60,119,4,4,5,1
60,119,5,0,1,1
60,120,0,3,5,2
60,120,1,2,6,4
60,120,2,4,5,1
60,120,3,0,1,1
60,120,4,0,1,1
60,120,5,0,3,3
60,120,6,2,4,2
60,121,0,3,4,1
60,121,1,3,4,1
60,121,2,4,7,3
60,121,3,1,1,0
60,121,4,0,2,2
60,121,5,1,2,1
60,121,6,0,2,2
60,122,0,1,2,1
60,122,1,1,2,1
60,122,2,0,1,1
60,122,3,1,1,0
60,122,4,1,4,3
60,122,5,3,6,3
60,122,6,0,1,1
60,123,0,0,1,1
60,123,1,7,10,3
60,123,2,0,2,2
60,123,3,0,1,1
60,123,4,0,2,2
60,123,5,1,3,2
60,123,6,2,5,3
60,124,0,1,3,2
60,124,1,7,8,1
60,124,2,0,3,3
60,124,3,0,1,1
60,124,4,3,7,4
60,124,5,2,4,2
60,124,6,1,3,2
60,125,0,2,6,4
60,125,1,4,5,1
60,125,3,3,3,0
60,125,4,3,5,2
60,125,5,4,7,3
60,125,6,1,1,0
60,126,0,0,1,1
60,126,1,1,3,2
60,126,2,2,3,1
60,126,4,5,7,2
60,126,5,4,4,0
60,126,6,2,6,4
60,127,0,0,1,1
60,127,1,2,4,2
60,127,2,3,5,2
60,127,3,0,2,2
60,127,4,4,5,1
60,127,5,3,5,2
60,127,6,3,5,2
60,128,0,1,2,1
60,128,1,0,1,1
60,128,3,0,3,3
60,128,4,1,3,2
60,128,5,6,8,2
60,128,6,0,1,1
60,129,0,1,2,1
60,129,1,3,6,3
60,129,3,0,1,1
60,129,4,0,5,5
60,129,5,3,4,1
60,129,6,0,3,3
60,130,1,2,4,2
60,130,2,3,3,0
60,130,3,0,3,3
60,130,4,0,1,1
60,130,5,4,6,2
60,130,6,1,3,2
60,131,0,0,1,1
60,131,1,1,1,0
60,131,3,0,1,1
60,131,4,1,1,0
60,131,5,4,6,2
60,131,6,3,7,4
60,132,0,11,11,0
60,132,1,0,1,1
60,132,2,0,2,2
60,132,3,2,4,2
60,132,4,2,4,2
60,132,5,3,4,1
60,133,0,6,8,2
60,133,1,2,2,0
60,133,4,1,1,0
60,133,5,2,3,1
60,133,6,2,4,2
60,134,0,2,3,1
60,134,1,0,1,1
60,134,2,0,1,1
60,134,3,1,2,1
60,134,4,5,7,2
60,134,5,3,3,0
60,134,6,1,1,0
60,135,0,0,1,1
60,135,2,1,2,1
60,135,5,4,4,0
60,135,6,4,5,1
60,136,0,0,1,1
60,136,1,0,1,1
60,136,2,0,3,3
60,136,3,1,4,3
60,136,4,0,2,2
60,136,5,0,1,1
60,136,6,0,1,1
60,137,1,1,2,1
60,137,2,0,1,1
60,137,3,1,2,1
60,137,4,0,1,1
60,137,5,0,1,1
60,137,6,4,4,0
60,138,1,0,1,1
60,138,2,0,2,2
60,138,3,1,2,1
60,138,5,1,2,1
60,138,6,1,1,0
60,139,3,1,3,2
60,139,5,3,4,1
60,139,6,1,2,1
60,140,0,1,1,0
60,140,1,1,2,1
60,140,3,1,2,1
60,140,5,1,1,0
60,141,1,2,2,0
60,141,2,1,2,1
60,141,3,0,2,2
60,141,4,0,1,1
60,142,0,2,3,1
60,142,2,0,1,1
60,142,4,1,2,1
60,142,6,1,1,0
60,143,0,1,1,0
60,143,1,6,7,1
61,0,0,0,1,1
61,0,1,1,1,0
61,0,2,3,4,1
61,0,3,0,1,1
61,0,4,2,5,3
61,0,5,13,17,4
61,0,6,1,3,2
61,1,0,0,1,1
61,1,1,1,2,1
61,1,3,1,1,0
61,1,4,3,5,2
61,1,5,10,13,3
61,1,6,0,2,2
61,2,1,2,3,1
61,2,2,2,2,0
61,2,3,2,2,0
61,2,4,0,3,3
61,2,5,2,4,2
61,2,6,0,1,1
61,3,0,1,1,0
61,3,1,3,4,1
61,3,2,0,1,1
61,3,3,0,1,1
61,3,4,0,1,1
61,3,5,1,4,3
61,3,6,3,3,0
61,4,0,0,1,1
61,4,1,2,2,0
61,4,2,0,1,1
61,4,3,4,7,3
61,4,5,2,4,2
61,4,6,0,2,2
61,5,0,1,1,0
61,5,1,0,1,1
61,5,2,0,1,1
61,5,3,4,4,0
61,5,4,2,5,3
61,5,6,3,4,1
61,6,1,1,2,1
61,6,2,0,1,1
61,6,3,1,1,0
61,6,5,1,1,0
61,6,6,1,1,0
61,7,0,1,1,0
61,7,1,0,1,1
61,7,3,1,3,2
61,7,4,2,2,0
61,7,5,2,2,0
61,7,6,3,4,1
61,8,1,1,1,0
61,8,2,0,1,1
61,8,3,0,1,1
61,8,5,0,1,1
61,8,6,1,3,2
61,9,1,4,4,0
61,9,2,2,3,1
61,9,3,0,1,1
61,9,5,0,1,1
61,9,6,4,4,0
61,10,0,0,1,1
61,10,3,0,1,1
61,10,4,0,1,1
61,10,5,1,1,0
61,10,6,1,2,1
61,11,2,0,1,1
61,11,3,0,1,1
61,11,4,0,1,1
61,11,6,0,4,4
61,12,4,0,2,2
61,12,5,1,2,1
61,12,6,0,2,2
61,13,0,0,1,1
61,13,2,0,1,1
61,13,5,1,1,0
61,13,6,0,1,1
61,14,4,0,2,2
61,15,6,3,4,1
61,16,2,2,2,0
61,16,5,1,1,0
61,16,6,4,5,1
61,17,6,2,2,0
61,18,0,2,2,0
61,18,1,1,1,0
61,18,4,1,2,1
61,19,1,2,2,0
61,19,4,1,2,1
61,20,1,1,2,1
61,20,5,1,1,0
61,21,1,0,1,1
61,21,4,1,2,1
61,21,5,1,1,0
61,23,4,4,4,0
61,25,0,0,1,1
61,25,4,4,4,0
61,25,5,1,1,0
61,29,5,0,1,1
61,31,2,0,1,1
61,31,3,1,2,1
61,32,6,3,3,0
61,33,6,0,1,1
61,34,0,2,2,0
61,36,4,1,1,0
61,37,0,0,1,1
61,38,0,2,2,0
61,38,1,0,1,1
61,38,2,1,1,0
61,38,3,1,1,0
61,38,5,1,1,0
61,38,6,1,1,0
61,39,0,0,2,2
61,39,2,2,5,3
61,39,4,2,4,2
61,40,0,0,2,2
61,40,1,2,2,0
61,40,2,2,4,2
61,40,4,0,1,1
61,40,5,2,4,2
61,40,6,3,3,0
61,41,0,0,3,3
61,41,1,1,1,0
61,41,2,0,1,1
61,41,3,2,4,2
61,41,4,0,1,1
61,41,5,0,2,2
61,41,6,3,3,0
61,42,0,0,2,2
61,42,1,1,4,3
61,42,2,0,3,3
61,42,3,1,3,2
61,42,4,0,3,3
61,42,5,0,1,1
61,42,6,5,7,2
61,43,0,2,8,6
61,43,1,0,6,6
61,43,2,0,3,3
61,43,3,1,3,2
61,43,4,1,3,2
61,43,5,0,1,1
61,43,6,0,2,2
61,44,0,0,7,7
61,44,1,0,3,3
61,44,2,2,4,2
61,44,3,2,9,7
61,44,4,3,8,5
61,44,5,0,2,2
61,44,6,3,6,3
61,45,0,1,4,3
61,45,1,1,4,3
61,45,2,1,6,5
61,45,3,1,8,7
61,45,4,0,5,5
61,45,5,1,6,5
61,45,6,1,1,0
61,46,0,0,8,8
61,46,1,1,12,11
61,46,2,0,4,4
61,46,3,1,9,8
61,46,4,2,7,5
61,46,5,0,3,3
61,46,6,7,11,4
61,47,0,0,8,8
61,47,1,0,10,10
61,47,2,0,8,8
61,47,3,0,4,4
61,47,4,4,14,10
61,47,5,1,2,1
61,47,6,1,8,7
61,48,0,0,6,6
61,48,1,0,5,5
61,48,2,0,2,2
61,48,3,0,5,5
61,48,4,1,3,2
61,48,5,0,4,4
61,48,6,4,8,4
61,49,0,0,2,2
61,49,1,0,5,5
61,49,2,0,6,6
61,49,3,0,2,2
61,49,4,0,4,4
61,49,5,4,4,0
61,50,0,0,5,5
61,50,2,0,3,3
61,50,3,0,2,2
61,50,4,0,5,5
61,50,5,2,8,6
61,50,6,3,4,1
61,51,0,1,3,2
61,51,1,3,13,10
61,51,2,0,8,8
61,51,3,0,7,7
61,51,4,1,5,4
61,51,5,1,9,8
61,51,6,0,2,2
61,52,0,0,8,8
61,52,1,0,6,6
61,52,2,0,9,9
61,52,3,1,2,1
61,52,4,1,8,7
61,52,5,0,4,4
61,52,6,1,7,6
61,53,0,0,8,8
61,53,1,0,6,6
61,53,2,0,9,9
61,53,3,1,4,3
61,53,4,2,8,6
61,53,5,0,1,1
61,53,6,0,4,4
61,54,0,0,4,4
61,54,1,2,7,5
61,54,2,3,8,5
61,54,3,0,8,8
61,54,4,1,5,4
61,54,5,0,6,6
61,54,6,2,8,6
61,55,0,0,5,5
61,55,1,3,6,3
61,55,2,1,2,1
61,55,3,0,5,5
61,55,4,0,1,1
61,55,5,1,4,3
61,55,6,4,10,6
61,56,0,1,3,2
61,56,1,2,9,7
61,56,2,3,6,3
61,56,3,2,5,3
61,56,4,0,7,7
61,56,5,2,6,4
61,56,6,0,4,4
61,57,0,6,11,5
61,57,1,0,7,7
61,57,2,5,9,4
61,57,3,1,6,5
61,57,4,0,6,6
61,57,5,1,6,5
61,57,6,1,2,1
61,58,0,3,7,4
61,58,1,1,6,5
61,58,2,2,7,5
61,58,3,2,7,5
61,58,4,1,3,2
61,58,5,2,9,7
61,58,6,0,6,6
61,59,0,0,4,4
61,59,1,1,8,7
61,59,2,2,4,2
61,59,3,1,7,6
61,59,4,0,2,2
61,59,5,0,7,7
61,59,6,0,6,6
61,60,0,2,6,4
61,60,1,0,4,4
61,60,2,1,9,8
61,60,3,0,5,5
61,60,4,1,5,4
61,60,5,1,4,3
61,60,6,0,2,2
61,61,0,2,7,5
61,61,1,0,3,3
61,61,2,0,4,4
61,61,3,1,4,3
61,61,4,1,11,10
61,61,5,0,2,2
61,61,6,0,2,2
61,62,0,0,7,7
61,62,1,3,8,5
61,62,2,0,2,2
61,62,3,1,4,3
61,62,4,1,3,2
61,62,5,0,3,3
61,62,6,0,4,4
61,63,0,3,8,5
61,63,1,2,6,4
61,63,2,0,4,4
61,63,3,0,3,3
61,63,4,1,8,7
61,63,5,0,3,3
61,63,6,0,4,4
61,64,0,5,9,4
61,64,1,0,4,4
61,64,2,1,5,4
61,64,3,1,4,3
61,64,4,1,7,6
61,64,5,0,5,5
61,64,6,0,6,6
61,65,0,2,4,2
61,65,1,1,8,7
61,65,2,12,14,2
61,65,3,4,10,6
61,65,4,3,8,5
61,65,5,0,8,8
61,65,6,0,5,5
61,66,0,1,4,3
61,66,1,2,6,4
61,66,2,1,5,4
61,66,3,1,10,9
61,66,4,3,9,6
61,66,5,2,8,6
61,66,6,1,11,10
61,67,0,1,7,6
61,67,1,0,3,3
61,67,2,4,8,4
61,67,3,1,7,6
61,67,4,0,4,4
61,67,5,6,14,8
61,67,6,0,2,2
61,68,0,0,3,3
61,68,1,0,5,5
61,68,2,0,4,4
61,68,3,1,4,3
61,68,4,1,13,12
61,68,5,1,9,8
61,68,6,5,11,6
61,69,0,4,12,8
61,69,1,0,6,6
61,69,2,1,5,4
61,69,3,0,4,4
61,69,4,1,9,8
61,69,5,7,12,5
61,69,6,3,10,7
61,70,0,5,12,7
61,70,1,0,4,4
61,70,2,2,9,7
61,70,3,1,7,6
61,70,4,0,6,6
61,70,5,1,3,2
61,70,6,1,4,3
61,71,0,2,8,6
61,71,1,0,2,2
61,71,2,1,6,5
61,71,3,0,5,5
61,71,4,0,10,10
61,71,5,6,15,9
61,71,6,2,9,7
61,72,0,0,4,4
61,72,1,4,7,3
61,72,2,0,6,6
61,72,3,0,4,4
61,72,4,0,3,3
61,72,5,1,4,3
61,72,6,4,11,7
61,73,0,0,1,1
61,73,1,2,7,5
61,73,2,1,13,12
61,73,3,1,1,0
61,73,4,3,12,9
61,73,5,4,12,8
61,73,6,1,5,4
61,74,0,0,5,5
61,74,1,0,4,4
61,74,2,2,6,4
61,74,3,0,2,2
61,74,4,1,7,6
61,74,5,1,11,10
61,74,6,2,8,6
61,75,0,0,3,3
61,75,1,0,3,3
61,75,2,0,3,3
61,75,3,0,3,3
61,75,4,3,10,7
61,75,5,4,11,7
61,75,6,0,6,6
61,76,0,0,4,4
61,76,1,0,5,5
61,76,2,3,6,3
61,76,3,1,7,6
61,76,4,3,11,8
61,76,5,0,9,9
61,76,6,1,10,9
61,77,0,3,5,2
61,77,1,0,8,8
61,77,2,0,6,6
61,77,3,3,9,6
61,77,4,4,9,5
61,77,5,1,7,6
61,77,6,2,13,11
61,78,0,8,16,8
61,78,1,0,5,5
61,78,2,1,5,4
61,78,3,2,8,6
61,78,4,1,5,4
61,78,5,1,11,10
61,78,6,0,10,10
61,79,0,2,11,9
61,79,1,0,3,3
61,79,2,0,4,4
61,79,3,0,3,3
61,79,4,11,14,3
61,79,5,0,7,7
61,79,6,2,13,11
61,80,0,0,2,2
61,80,1,0,6,6
61,80,2,0,8,8
61,80,3,1,5,4
61,80,4,2,7,5
61,80,5,2,7,5
61,80,6,4,9,5
61,81,0,1,3,2
61,81,1,0,2,2
61,81,2,0,6,6
61,81,3,5,7,2
61,81,4,5,15,10
61,81,5,0,6,6
61,81,6,1,6,5
61,82,0,1,7,6
61,82,1,0,7,7
61,82,2,0,3,3
61,82,3,0,5,5
61,82,4,3,8,5
61,82,5,0,4,4
61,82,6,1,11,10
61,83,0,1,5,4
61,83,1,0,5,5
61,83,2,1,6,5
61,83,3,0,1,1
61,83,4,3,8,5
61,83,5,3,14,11
61,83,6,2,12,10
61,84,0,2,5,3
61,84,1,0,8,8
61,84,2,0,4,4
61,84,3,1,3,2
61,84,4,2,10,8
61,84,5,2,8,6
61,84,6,4,10,6
61,85,0,1,5,4
61,85,1,0,3,3
61,85,2,0,5,5
61,85,3,0,5,5
61,85,4,0,6,6
61,85,5,1,7,6
61,85,6,1,7,6
61,86,0,1,5,4
61,86,1,0,5,5
61,86,2,2,9,7
61,86,3,1,7,6
61,86,4,2,5,3
61,86,5,3,13,10
61,86,6,2,5,3
61,87,0,0,4,4
61,87,1,2,7,5
61,87,2,0,2,2
61,87,3,2,11,9
61,87,4,2,13,11
61,87,5,5,10,5
61,87,6,3,13,10
61,88,0,0,6,6
61,88,1,0,2,2
61,88,2,0,7,7
61,88,3,1,7,6
61,88,4,1,9,8
61,88,5,9,21,12
61,88,6,1,7,6
61,89,0,3,11,8
61,89,1,0,6,6
61,89,2,5,15,10
61,89,3,3,7,4
61,89,4,1,5,4
61,89,5,2,13,11
61,89,6,1,9,8
61,90,0,1,11,10
61,90,1,2,7,5
61,90,2,2,6,4
61,90,3,1,9,8
61,90,4,2,11,9
61,90,5,0,7,7
61,90,6,5,16,11
61,91,0,1,10,9
61,91,1,0,2,2
61,91,2,8,12,4
61,91,3,3,9,6
61,91,4,2,11,9
61,91,5,2,11,9
61,91,6,4,12,8
61,92,0,6,15,9
61,92,1,2,5,3
61,92,2,3,11,8
61,92,3,1,5,4
61,92,4,3,11,8
61,92,5,7,15,8
61,92,6,2,15,13
61,93,0,0,11,11
61,93,1,1,6,5
61,93,2,6,13,7
61,93,3,3,6,3
61,93,4,5,17,12
61,93,5,7,17,10
61,93,6,1,10,9
61,94,0,4,12,8
61,94,1,1,9,8
61,94,2,6,11,5
61,94,3,1,6,5
61,94,4,2,6,4
61,94,5,6,15,9
61,94,6,1,8,7
61,95,0,3,8,5
61,95,1,0,4,4
61,95,2,2,6,4
61,95,3,0,4,4
61,95,4,1,18,17
61,95,5,0,22,22
61,95,6,2,12,10
61,96,0,0,6,6
61,96,1,4,7,3
61,96,2,1,8,7
61,96,3,0,2,2
61,96,4,0,10,10
61,96,5,0,16,16
61,96,6,0,8,8
61,97,0,1,7,6
61,97,1,4,13,9
61,97,2,2,10,8
61,97,3,0,8,8
61,97,4,1,9,8
61,97,5,1,12,11
61,97,6,1,5,4
61,98,0,1,5,4
61,98,1,5,11,6
61,98,2,0,7,7
61,98,3,1,6,5
61,98,4,2,13,11
61,98,5,1,12,11
61,98,6,0,8,8
61,99,0,0,4,4
61,99,1,5,9,4
61,99,2,0,7,7
61,99,3,5,13,8
61,99,4,2,11,9
61,99,5,0,9,9
61,99,6,1,16,15
61,100,0,0,6,6
61,100,1,1,8,7
61,100,2,0,1,1
61,100,3,1,8,7
61,100,4,1,14,13
61,100,5,0,8,8
61,100,6,0,11,11
61,101,0,0,4,4
61,101,1,0,14,14
61,101,2,2,17,15
61,101,3,2,5,3
61,101,4,1,12,11
61,101,5,1,14,13
61,101,6,1,11,10
61,102,0,0,13,13
61,102,1,0,9,9
61,102,2,2,13,11
61,102,3,4,12,8
61,102,4,0,10,10
61,102,5,0,12,12
61,102,6,0,6,6
61,103,0,2,12,10
61,103,1,0,5,5
61,103,2,3,16,13
61,103,3,4,12,8
61,103,4,3,11,8
61,103,5,0,16,16
61,103,6,6,12,6
61,104,0,0,9,9
61,104,1,0,6,6
61,104,2,0,9,9
61,104,3,4,13,9
61,104,4,1,4,3
61,104,5,2,10,8
61,104,6,0,6,6
61,105,0,1,4,3
61,105,1,0,10,10
61,105,2,0,8,8
61,105,3,0,2,2
61,105,4,3,11,8
61,105,5,1,7,6
61,105,6,1,8,7
61,106,0,0,5,5
61,106,1,0,4,4
61,106,2,2,6,4
61,106,3,1,10,9
61,106,4,3,11,8
61,106,5,0,3,3
61,106,6,3,13,10
61,107,0,5,9,4
61,107,1,0,7,7
61,107,2,3,6,3
61,107,3,0,6,6
61,107,4,2,7,5
61,107,5,3,11,8
61,107,6,0,6,6
61,108,0,1,9,8
61,108,1,1,6,5
61,108,2,4,10,6
61,108,3,1,9,8
61,108,4,0,6,6
61,108,5,3,7,4
61,108,6,3,12,9
61,109,0,0,4,4
61,109,1,2,15,13
61,109,2,0,9,9
61,109,3,0,6,6
61,109,4,0,7,7
61,109,5,0,6,6
61,109,6,2,14,12
61,110,0,0,7,7
61,110,1,2,7,5
61,110,2,1,12,11
61,110,3,0,5,5
61,110,4,4,15,11
61,110,5,2,10,8
61,110,6,0,4,4
61,111,0,1,5,4
61,111,1,0,13,13
61,111,2,0,10,10
61,111,3,1,7,6
61,111,4,3,8,5
61,111,5,0,3,3
61,111,6,0,6,6
61,112,0,4,10,6
61,112,1,1,10,9
61,112,2,0,4,4
61,112,3,1,8,7
61,112,4,0,10,10
61,112,5,3,11,8
61,112,6,0,6,6
61,113,0,4,12,8
61,113,1,0,7,7
61,113,2,2,18,16
61,113,3,0,5,5
61,113,4,0,4,4
61,113,5,4,10,6
61,113,6,0,10,10
61,114,0,3,10,7
61,114,1,0,7,7
61,114,2,3,10,7
61,114,3,2,9,7
61,114,4,3,14,11
61,114,5,3,12,9
61,114,6,0,5,5
61,115,0,2,4,2
61,115,1,0,4,4
61,115,2,0,4,4
61,115,3,1,3,2
61,115,4,0,6,6
61,115,5,0,3,3
61,115,6,3,13,10
61,116,0,1,4,3
61,116,1,0,5,5
61,116,2,1,8,7
61,116,3,2,9,7
61,116,4,0,6,6
61,116,5,2,8,6
61,116,6,0,14,14
61,117,0,1,5,4
61,117,1,0,5,5
61,117,2,0,11,11
61,117,3,0,6,6
61,117,4,2,8,6
61,117,5,0,6,6
61,117,6,0,5,5
61,118,0,0,3,3
61,118,1,0,2,2
61,118,2,2,5,3
61,118,3,3,10,7
61,118,4,1,12,11
61,118,5,0,5,5
61,118,6,0,3,3
61,119,0,0,6,6
61,119,1,0,5,5
61,119,2,1,10,9
61,119,3,1,10,9
61,119,4,2,10,8
61,119,5,3,14,11
61,119,6,0,8,8
61,120,0,0,7,7
61,120,1,2,11,9
61,120,2,2,11,9
61,120,3,0,3,3
61,120,4,1,13,12
61,120,5,5,13,8
61,120,6,0,4,4
61,121,0,0,6,6
61,121,1,0,7,7
61,121,2,1,7,6
61,121,3,0,7,7
61,121,4,4,18,14
61,121,5,4,13,9
61,121,6,0,4,4
61,122,0,2,6,4
61,122,1,3,10,7
61,122,2,1,6,5
61,122,3,1,10,9
61,122,4,3,12,9
61,122,5,8,24,16
61,122,6,0,7,7
61,123,0,0,10,10
61,123,1,2,11,9
61,123,2,1,3,2
61,123,3,3,8,5
61,123,4,1,11,10
61,123,5,10,19,9
61,123,6,0,10,10
61,124,0,0,5,5
61,124,1,6,13,7
61,124,2,0,6,6
61,124,3,0,6,6
61,124,4,1,15,14
61,124,5,6,16,10
61,124,6,2,12,10
61,125,0,1,14,13
61,125,1,2,7,5
61,125,2,1,8,7
61,125,3,3,13,10
61,125,4,0,11,11
61,125,5,0,9,9
61,125,6,0,11,11
61,126,0,4,8,4
61,126,1,1,8,7
61,126,2,2,12,10
61,126,3,1,8,7
61,126,4,5,17,12
61,126,5,0,10,10
61,126,6,3,12,9
61,127,0,4,12,8
61,127,1,0,4,4
61,127,2,1,6,5
61,127,3,1,7,6
61,127,4,3,10,7
61,127,5,1,7,6
61,127,6,4,15,11
61,128,0,2,12,10
61,128,1,1,6,5
61,128,2,3,8,5
61,128,3,1,6,5
61,128,4,0,5,5
61,128,5,1,13,12
61,128,6,2,12,10
61,129,0,0,10,10
61,129,1,4,7,3
61,129,2,0,7,7
61,129,3,3,9,6
61,129,4,0,3,3
61,129,5,4,12,8
61,129,6,1,8,7
61,130,0,1,4,3
61,130,1,2,8,6
61,130,2,1,7,6
61,130,3,3,11,8
61,130,4,1,7,6
61,130,5,0,7,7
61,130,6,1,3,2
61,131,0,0,1,1
61,131,1,3,9,6
61,131,2,0,5,5
61,131,3,0,6,6
61,131,4,0,5,5
61,131,5,1,5,4
61,131,6,0,8,8
61,132,0,1,5,4
61,132,1,0,6,6
61,132,2,0,5,5
61,132,3,1,3,2
61,132,4,0,8,8
61,132,5,0,6,6
61,132,6,3,6,3
61,133,0,1,6,5
61,133,2,0,2,2
61,133,3,0,1,1
61,133,4,0,4,4
61,133,5,3,9,6
61,133,6,3,4,1
61,134,0,0,3,3
61,134,1,1,1,0
61,134,2,0,4,4
61,134,3,0,1,1
61,134,4,0,7,7
61,134,5,3,8,5
61,134,6,2,4,2
61,135,0,1,5,4
61,135,1,1,4,3
61,135,2,0,5,5
61,135,3,0,2,2
61,135,4,0,9,9
61,135,5,8,13,5
61,135,6,4,6,2
61,136,1,2,4,2
61,136,2,1,7,6
61,136,3,0,2,2
61,136,4,0,6,6
61,136,5,11,18,7
61,136,6,8,13,5
61,137,0,0,3,3
61,137,1,1,6,5
61,137,2,0,3,3
61,137,3,2,4,2
61,137,4,0,8,8
61,137,5,0,3,3
61,137,6,2,3,1
61,138,0,1,3,2
61,138,1,1,9,8
61,138,2,0,1,1
61,138,3,2,4,2
61,138,4,0,3,3
61,138,5,5,11,6
61,138,6,0,4,4
61,139,0,0,3,3
61,139,1,5,9,4
61,139,2,0,1,1
61,139,3,1,4,3
61,139,4,0,5,5
61,139,5,0,3,3
61,139,6,0,2,2
61,140,1,0,3,3
61,140,3,0,4,4
61,140,4,2,5,3
61,140,5,7,11,4
61,140,6,1,2,1
61,141,0,1,2,1
61,141,1,0,2,2
61,141,2,1,4,3
61,141,4,0,3,3
61,141,5,0,2,2
61,141,6,5,6,1
61,142,0,1,4,3
61,142,2,0,2,2
61,142,3,0,1,1
61,142,4,0,2,2
61,142,5,3,7,4
61,142,6,2,5,3
61,143,0,1,2,1
61,143,1,0,3,3
61,143,2,2,3,1
61,143,3,2,3,1
61,143,4,1,5,4
61,143,5,1,3,2
61,143,6,1,1,0
62,0,1,0,1,1
62,0,4,0,1,1
62,1,5,1,1,0
62,1,6,0,1,1
62,3,1,1,1,0
62,4,6,1,2,1
62,6,2,0,1,1
62,7,6,0,1,1
62,12,3,1,1,0
62,12,4,1,1,0
62,13,2,1,1,0
62,15,1,1,1,0
62,33,4,1,1,0
62,34,4,1,1,0
62,36,4,1,1,0
62,37,4,1,1,0
62,38,4,1,1,0
62,39,0,2,2,0
62,39,1,3,3,0
62,39,4,0,4,4
62,39,5,1,1,0
62,39,6,0,1,1
62,40,0,1,5,4
62,40,1,0,1,1
62,40,2,2,4,2
62,40,3,1,3,2
62,40,5,1,1,0
62,40,6,0,1,1
62,41,0,2,2,0
62,41,3,1,3,2
62,41,4,0,1,1
62,42,0,1,1,0
62,42,2,0,2,2
62,42,3,0,1,1
62,42,4,1,2,1
62,42,5,1,2,1
62,42,6,1,3,2
62,43,0,0,4,4
62,43,1,1,3,2
62,43,2,0,1,1
62,43,3,6,8,2
62,43,4,0,3,3
62,43,6,0,1,1
62,44,0,0,4,4
62,44,1,0,3,3
62,44,2,0,1,1
62,44,3,0,2,2
62,44,4,0,1,1
62,44,5,0,1,1
62,44,6,0,4,4
62,45,0,3,3,0
62,45,1,0,1,1
62,45,2,1,1,0
62,45,3,3,5,2
62,45,5,0,1,1
62,45,6,1,3,2
62,46,0,1,2,1
62,46,1,0,3,3
62,46,2,0,3,3
62,46,3,2,2,0
62,46,4,0,1,1
62,46,5,0,1,1
62,47,0,0,1,1
62,47,1,1,2,1
62,47,2,2,6,4
62,47,3,2,5,3
62,47,4,2,3,1
62,48,0,2,5,3
62,48,1,0,3,3
62,48,2,1,5,4
62,48,3,3,7,4
62,48,4,0,1,1
62,48,5,0,1,1
62,49,0,0,1,1
62,49,1,1,4,3
62,49,2,0,2,2
62,49,3,1,3,2
62,49,4,0,3,3
62,49,5,0,1,1
62,49,6,0,2,2
62,50,0,0,5,5
62,50,1,2,7,5
62,50,2,1,2,1
62,50,3,1,2,1
62,50,4,2,4,2
62,50,5,1,3,2
62,50,6,1,3,2
62,51,0,4,9,5
62,51,1,2,3,1
62,51,2,0,5,5
62,51,3,2,2,0
62,51,4,0,2,2
62,51,5,0,3,3
62,51,6,0,1,1
62,52,0,0,4,4
62,52,1,2,3,1
62,52,2,0,3,3
62,52,3,3,7,4
62,52,4,1,1,0
62,52,5,1,4,3
62,53,0,0,1,1
62,53,1,2,2,0
62,53,3,0,2,2
62,53,5,4,6,2
62,53,6,2,2,0
62,54,0,1,2,1
62,54,1,2,4,2
62,54,4,3,5,2
62,54,5,2,2,0
62,54,6,0,1,1
62,55,0,0,2,2
62,55,1,0,4,4
62,55,2,0,1,1
62,55,3,1,1,0
62,55,4,1,5,4
62,55,6,1,3,2
62,56,0,0,2,2
62,56,1,1,2,1
62,56,2,8,8,0
62,56,3,4,4,0
62,56,4,1,3,2
62,56,5,5,6,1
62,56,6,0,3,3
62,57,0,5,5,0
62,57,2,0,1,1
62,57,3,5,7,2
62,57,4,2,4,2
62,57,5,1,2,1
62,57,6,1,5,4
62,58,1,3,5,2
62,58,2,3,4,1
62,58,4,5,7,2
62,58,5,2,3,1
62,58,6,0,3,3
62,59,1,0,1,1
62,59,3,2,2,0
62,59,4,5,7,2
62,59,5,4,4,0
62,60,0,5,6,1
62,60,2,1,2,1
62,60,3,6,7,1
62,60,5,0,3,3
62,60,6,1,2,1
62,61,0,5,7,2
62,61,1,5,6,1
62,61,2,0,1,1
62,61,3,6,6,0
62,61,4,3,8,5
62,62,0,2,3,1
62,62,1,2,2,0
62,62,2,4,5,1
62,62,3,3,4,1
62,62,4,1,2,1
62,62,5,0,1,1
62,62,6,3,3,0
62,63,0,5,5,0
62,63,1,1,2,1
62,63,2,0,1,1
62,63,3,0,1,1
62,63,4,1,2,1
62,63,5,1,2,1
62,63,6,2,3,1
62,64,0,4,5,1
62,64,1,3,5,2
62,64,2,2,2,0
62,64,3,2,2,0
62,64,4,1,2,1
62,64,5,2,4,2
62,64,6,5,5,0
62,65,1,0,1,1
62,65,2,3,4,1
62,65,4,1,1,0
62,65,5,2,2,0
62,65,6,3,4,1
62,66,2,1,2,1
62,66,3,0,1,1
62,66,5,1,4,3
62,66,6,1,4,3
62,67,0,0,2,2
62,67,1,0,1,1
62,67,2,3,4,1
62,67,4,1,1,0
62,67,5,1,2,1
62,67,6,4,7,3
62,68,1,0,1,1
62,68,2,0,1,1
62,68,3,0,2,2
62,68,4,5,5,0
62,68,6,5,8,3
62,69,0,2,2,0
62,69,2,2,3,1
62,69,3,1,5,4
62,69,4,2,3,1
62,69,5,5,5,0
62,69,6,0,1,1
62,70,0,2,3,1
62,70,2,1,2,1
62,70,3,2,5,3
62,70,5,0,1,1
62,71,1,2,2,0
62,71,2,2,5,3
62,71,4,2,2,0
62,71,6,0,3,3
62,72,0,1,2,1
62,72,1,0,2,2
62,72,2,2,3,1
62,72,4,2,2,0
62,72,5,1,2,1
62,72,6,0,2,2
62,73,0,1,3,2
62,73,3,3,4,1
62,73,4,7,8,1
62,73,5,1,1,0
62,73,6,2,4,2
62,74,1,6,7,1
62,74,2,1,2,1
62,74,3,5,6,1
62,74,5,0,1,1
62,74,6,4,6,2
62,75,1,3,7,4
62,75,2,2,5,3
62,75,3,2,4,2
62,75,4,1,2,1
62,75,5,0,1,1
62,75,6,1,5,4
62,76,0,5,6,1
62,76,1,0,1,1
62,76,4,5,5,0
62,76,5,1,2,1
62,76,6,1,3,2
62,77,0,0,1,1
62,77,1,3,4,1
62,77,2,0,1,1
62,77,3,3,3,0
62,77,4,1,1,0
62,77,5,2,3,1
62,77,6,0,2,2
62,78,1,1,1,0
62,78,2,3,3,0
62,78,3,2,3,1
62,78,4,2,2,0
62,78,5,2,2,0
62,78,6,2,2,0
62,79,1,2,2,0
62,79,3,0,1,1
62,79,4,1,2,1
62,79,6,1,2,1
62,80,0,0,1,1
62,80,1,1,1,0
62,80,2,1,2,1
62,80,3,1,3,2
62,80,4,2,2,0
62,80,5,6,7,1
62,81,0,1,3,2
62,81,1,1,2,1
62,81,3,1,4,3
62,81,4,2,5,3
62,81,5,2,4,2
62,82,0,0,1,1
62,82,1,0,3,3
62,82,3,0,1,1
62,82,4,0,3,3
62,82,5,1,4,3
62,82,6,0,1,1
62,83,0,1,1,0
62,83,1,2,3,1
62,83,3,1,2,1
62,83,4,1,4,3
62,83,5,1,3,2
62,83,6,3,3,0
62,84,0,2,5,3
62,84,1,4,5,1
62,84,3,2,3,1
62,84,4,2,4,2
62,84,5,1,6,5
62,84,6,1,2,1
62,85,0,0,1,1
62,85,1,1,1,0
62,85,3,3,4,1
62,85,4,1,2,1
62,85,5,1,4,3
62,85,6,0,1,1
62,86,0,1,1,0
62,86,1,3,3,0
62,86,2,3,4,1
62,86,3,0,1,1
62,86,4,3,7,4
62,86,5,3,4,1
62,86,6,2,3,1
62,87,0,1,1,0
62,87,1,0,1,1
62,87,2,0,1,1
62,87,3,0,1,1
62,87,4,0,1,1
62,87,5,1,1,0
62,87,6,1,3,2
62,88,0,3,4,1
62,88,1,1,2,1
62,88,2,2,2,0
62,88,3,1,2,1
62,88,4,2,3,1
62,88,5,0,1,1
62,88,6,1,2,1
62,89,0,3,6,3
62,89,1,0,3,3
62,89,2,0,1,1
62,89,5,4,5,1
62,89,6,1,6,5
62,90,1,4,4,0
62,90,5,2,4,2
62,90,6,4,5,1
62,91,1,0,2,2
62,91,2,1,1,0
62,91,4,0,1,1
62,91,5,2,2,0
62,91,6,1,1,0
62,92,0,0,1,1
62,92,1,2,4,2
62,92,2,0,2,2
62,92,5,2,4,2
62,92,6,2,2,0
62,93,2,0,1,1
62,93,3,0,2,2
62,93,4,1,3,2
62,93,5,0,3,3
62,93,6,0,1,1
62,94,2,5,5,0
62,94,3,0,3,3
62,94,4,0,2,2
62,94,6,2,3,1
62,95,0,1,2,1
62,95,1,0,2,2
62,95,2,3,4,1
62,95,3,0,1,1
62,95,4,0,1,1
62,96,0,0,1,1
62,96,2,1,5,4
62,96,5,0,1,1
62,96,6,0,1,1
62,97,0,3,4,1
62,97,1,2,5,3
62,97,3,1,2,1
62,97,6,0,1,1
62,98,0,1,1,0
62,98,1,3,3,0
62,98,2,0,2,2
62,98,3,1,1,0
62,98,4,3,3,0
62,98,6,1,1,0
62,99,0,0,1,1
62,99,1,3,6,3
62,99,2,2,4,2
62,99,3,0,2,2
62,99,4,1,3,2
62,99,5,1,3,2
62,99,6,3,5,2
62,100,0,0,1,1
62,100,1,0,2,2
62,100,2,1,3,2
62,100,4,0,1,1
62,100,5,0,1,1
62,100,6,0,1,1
62,101,0,0,4,4
62,101,2,0,2,2
62,101,3,5,6,1
62,101,4,0,1,1
62,102,0,0,2,2
62,102,1,0,1,1
62,102,3,2,3,1
62,102,4,2,3,1
62,102,6,0,1,1
62,103,0,2,2,0
62,103,1,1,3,2
62,103,2,2,3,1
62,103,5,0,1,1
62,104,1,1,3,2
62,104,2,1,1,0
62,104,3,2,3,1
62,104,6,4,5,1
62,105,0,1,3,2
62,105,1,2,2,0
62,105,2,0,2,2
62,105,3,0,1,1
62,105,6,2,3,1
62,106,0,4,5,1
62,106,1,5,7,2
62,106,2,1,1,0
62,106,4,0,1,1
62,106,5,1,1,0
62,107,0,1,2,1
62,107,1,7,9,2
62,107,2,3,3,0
62,107,3,0,3,3
62,107,5,0,2,2
62,107,6,0,2,2
62,108,1,4,5,1
62,108,2,1,2,1
62,108,4,2,2,0
62,108,5,1,2,1
62,108,6,1,2,1
62,109,1,5,6,1
62,109,2,3,6,3
62,109,3,1,1,0
62,109,4,0,1,1
62,109,5,2,2,0
62,109,6,0,1,1
62,110,1,6,9,3
62,110,2,7,9,2
62,110,3,5,7,2
62,110,5,0,4,4
62,110,6,4,4,0
62,111,0,0,2,2
62,111,1,4,8,4
62,111,2,2,3,1
62,111,3,5,5,0
62,111,4,0,1,1
62,111,5,1,1,0
62,111,6,2,3,1
62,112,0,1,3,2
62,112,1,6,9,3
62,112,2,1,5,4
62,112,3,6,6,0
62,112,5,1,2,1
62,112,6,0,3,3
62,113,0,2,3,1
62,113,1,9,13,4
62,113,2,0,1,1
62,113,3,2,4,2
62,113,4,3,7,4
62,113,5,0,3,3
62,113,6,2,7,5
62,114,0,0,1,1
62,114,1,4,5,1
62,114,2,0,1,1
62,114,3,3,5,2
62,114,4,1,1,0
62,114,5,1,3,2
62,114,6,0,1,1
62,115,2,2,2,0
62,115,3,3,4,1
62,115,4,1,1,0
62,116,2,3,6,3
62,116,3,1,1,0
62,116,4,0,2,2
62,116,5,0,1,1
62,116,6,1,2,1
62,117,0,2,3,1
62,117,2,2,5,3
62,117,3,0,1,1
62,117,4,1,1,0
62,118,0,1,2,1
62,118,1,0,1,1
62,118,3,0,2,2
62,118,4,4,4,0
62,118,6,3,3,0
62,119,1,0,1,1
62,119,2,2,3,1
62,119,3,0,1,1
62,119,4,4,5,1
62,119,5,1,3,2
62,119,6,0,2,2
62,120,2,0,2,2
62,120,4,3,4,1
62,120,5,2,4,2
62,120,6,7,10,3
62,121,4,2,3,1
62,121,5,3,5,2
62,121,6,2,5,3
62,122,1,0,1,1
62,122,2,2,2,0
62,122,3,0,1,1
62,122,4,3,3,0
62,122,5,4,6,2
62,122,6,1,2,1
62,123,2,4,4,0
62,123,4,0,2,2
62,123,5,1,2,1
62,123,6,1,1,0
62,124,2,9,9,0
62,124,4,1,2,1
62,124,5,0,1,1
62,124,6,1,1,0
62,125,2,0,1,1
62,125,4,1,4,3
62,125,5,0,1,1
62,125,6,0,1,1
62,126,0,0,1,1
62,126,1,4,6,2
62,126,2,0,1,1
62,126,3,3,3,0
62,126,4,5,7,2
62,126,6,0,1,1
62,127,0,5,6,1
62,127,2,0,1,1
62,127,3,2,2,0
62,127,4,1,2,1
62,128,0,5,5,0
62,128,1,0,1,1
62,128,2,0,1,1
62,128,3,5,5,0
62,128,5,0,2,2
62,128,6,2,2,0
62,129,0,2,3,1
62,129,1,3,4,1
62,129,2,1,1,0
62,129,3,3,3,0
62,129,4,2,4,2
62,129,5,1,1,0
62,130,1,3,3,0
62,130,2,1,1,0
62,130,3,1,1,0
62,130,4,3,5,2
62,130,6,1,3,2
62,131,2,2,2,0
62,131,3,2,2,0
62,131,5,3,4,1
62,132,1,1,2,1
62,132,2,1,1,0
62,132,3,7,7,0
62,132,5,2,2,0
62,132,6,1,2,1
62,133,0,1,1,0
62,133,1,4,5,1
62,133,2,4,4,0
62,133,3,2,4,2
62,133,4,2,2,0
62,133,5,1,2,1
62,133,6,2,3,1
62,134,0,3,5,2
62,134,1,0,2,2
62,134,2,1,1,0
62,134,4,2,4,2
62,134,6,2,2,0
62,135,1,1,1,0
62,135,2,0,1,1
62,135,3,1,2,1
62,135,6,2,3,1
62,136,0,0,1,1
62,136,4,0,1,1
62,136,5,2,2,0
62,136,6,3,3,0
62,137,1,1,1,0
62,137,4,3,6,3
62,137,6,1,1,0
62,138,2,0,1,1
62,139,0,2,3,1
62,139,1,0,1,1
62,139,2,2,2,0
62,139,3,1,1,0
62,139,4,0,1,1
62,139,6,3,4,1
62,140,0,1,1,0
62,140,3,1,1,0
62,140,5,1,1,0
62,141,1,5,6,1
62,141,3,3,3,0
62,141,4,1,1,0
62,142,1,1,1,0
62,143,0,1,1,0
62,143,5,1,1,0
63,0,1,2,3,1
63,0,3,0,1,1
63,0,4,3,4,1
63,0,5,0,1,1
63,1,0,1,1,0
63,1,6,0,1,1
63,2,0,0,1,1
63,2,4,0,1,1
63,3,3,1,1,0
63,6,5,2,2,0
63,11,1,0,1,1
63,19,1,1,1,0
63,20,1,1,2,1
63,26,2,2,2,0
63,27,2,2,2,0
63,28,2,4,4,0
63,29,2,2,2,0
63,30,2,1,1,0
63,31,2,1,1,0
63,32,5,2,2,0
63,33,5,1,1,0
63,37,6,0,1,1
63,38,0,1,1,0
63,39,5,2,2,0
63,40,1,0,1,1
63,40,4,0,2,2
63,41,0,0,1,1
63,41,3,4,4,0
63,41,5,0,1,1
63,42,0,0,1,1
63,42,1,0,1,1
63,42,3,0,1,1
63,43,0,0,2,2
63,43,2,0,4,4
63,43,4,0,1,1
63,43,5,0,1,1
63,43,6,1,2,1
63,44,0,0,3,3
63,44,1,0,2,2
63,44,2,2,3,1
63,44,3,1,2,1
63,45,1,3,3,0
63,45,2,0,1,1
63,45,3,0,1,1
63,46,0,3,4,1
63,46,1,1,2,1
63,46,4,0,1,1
63,47,1,3,4,1
63,47,3,0,1,1
63,47,6,0,1,1
63,48,1,2,3,1
63,48,3,0,2,2
63,48,4,1,2,1
63,48,6,0,1,1
63,49,0,1,2,1
63,49,1,2,5,3
63,49,2,1,2,1
63,49,3,0,2,2
63,49,4,2,4,2
63,49,5,0,1,1
63,50,1,2,2,0
63,50,2,0,2,2
63,50,3,1,3,2
63,50,4,2,2,0
63,50,5,2,2,0
63,50,6,3,4,1
63,51,0,1,1,0
63,51,1,0,1,1
63,51,2,0,1,1
63,51,4,1,1,0
63,51,5,1,1,0
63,51,6,0,1,1
63,52,0,2,3,1
63,52,1,0,1,1
63,52,2,0,1,1
63,52,3,0,1,1
63,52,4,0,1,1
63,53,0,0,1,1
63,53,3,1,1,0
63,53,4,2,3,1
63,53,6,0,2,2
63,54,0,1,5,4
63,54,1,0,1,1
63,54,3,0,2,2
63,54,4,3,4,1
63,54,5,4,4,0
63,54,6,1,3,2
63,55,0,0,1,1
63,55,2,2,4,2
63,55,4,1,3,2
63,55,5,3,3,0
63,55,6,0,2,2
63,56,1,1,1,0
63,56,2,4,5,1
63,56,3,0,1,1
63,56,4,2,3,1
63,56,5,0,1,1
63,56,6,2,2,0
63,57,0,3,4,1
63,57,1,4,6,2
63,57,2,1,3,2
63,57,3,2,3,1
63,57,6,0,2,2
63,58,1,3,4,1
63,58,2,3,3,0
63,58,4,0,1,1
63,58,5,0,1,1
63,59,0,1,2,1
63,59,1,1,1,0
63,59,2,2,2,0
63,59,3,0,1,1
63,59,6,0,2,2
63,60,0,1,1,0
63,60,1,1,1,0
63,60,2,0,1,1
63,60,3,1,1,0
63,60,4,0,1,1
63,60,5,0,2,2
63,61,0,0,2,2
63,61,1,0,2,2
63,61,2,4,4,0
63,61,3,1,1,0
63,61,4,6,7,1
63,61,5,4,6,2
63,61,6,2,5,3
63,62,0,1,2,1
63,62,1,0,1,1
63,62,2,3,3,0
63,62,4,2,4,2
63,62,5,3,4,1
63,63,0,3,4,1
63,63,1,0,1,1
63,63,3,0,2,2
63,63,4,3,4,1
63,63,5,8,8,0
63,63,6,1,2,1
63,64,0,1,2,1
63,64,3,7,8,1
63,64,4,0,1,1
63,64,5,2,2,0
63,64,6,0,1,1
63,65,0,1,1,0
63,65,1,1,1,0
63,65,3,1,2,1
63,65,5,2,3,1
63,66,0,0,1,1
63,66,2,3,3,0
63,66,3,1,1,0
63,66,4,1,1,0
63,66,5,0,1,1
63,67,2,0,1,1
63,67,3,1,1,0
63,67,6,0,1,1
63,68,1,1,1,0
63,68,2,1,2,1
63,68,3,2,3,1
63,68,4,0,1,1
63,68,5,1,1,0
63,68,6,0,1,1
63,69,2,2,3,1
63,69,3,2,3,1
63,69,5,2,2,0
63,69,6,0,1,1
63,70,1,1,1,0
63,70,2,0,1,1
63,70,3,1,1,0
63,70,4,3,4,1
63,70,5,4,4,0
63,70,6,1,2,1
63,71,0,1,1,0
63,71,1,1,2,1
63,71,3,1,3,2
63,71,4,0,1,1
63,71,6,3,4,1
63,72,0,2,2,0
63,72,1,3,5,2
63,72,2,0,2,2
63,72,5,2,4,2
63,72,6,2,3,1
63,73,0,6,6,0
63,73,5,10,10,0
63,73,6,4,6,2
63,74,0,4,4,0
63,74,1,0,1,1
63,74,3,0,4,4
63,74,4,2,3,1
63,74,5,0,1,1
63,74,6,0,1,1
63,75,0,1,3,2
63,75,1,0,1,1
63,75,3,0,1,1
63,75,6,3,4,1
63,76,3,2,2,0
63,76,4,6,6,0
63,76,5,2,3,1
63,76,6,5,6,1
63,77,0,1,2,1
63,77,1,2,2,0
63,77,3,3,4,1
63,77,4,5,8,3
63,77,5,0,1,1
63,77,6,2,3,1
63,78,0,2,2,0
63,78,1,2,2,0
63,78,2,5,8,3
63,78,3,3,4,1
63,78,4,0,1,1
63,78,5,3,3,0
63,78,6,0,3,3
63,79,1,0,1,1
63,79,3,1,1,0
63,79,4,1,2,1
63,79,5,2,2,0
63,79,6,2,3,1
63,80,0,1,1,0
63,80,1,3,4,1
63,80,3,2,3,1
63,80,4,0,1,1
63,80,5,2,2,0
63,80,6,1,1,0
63,81,0,2,2,0
63,81,2,1,2,1
63,81,3,1,2,1
63,81,4,1,1,0
63,81,5,1,2,1
63,82,0,0,1,1
63,82,1,3,4,1
63,82,3,0,2,2
63,82,5,2,3,1
63,83,0,1,3,2
63,83,2,1,1,0
63,83,4,0,1,1
63,83,5,1,2,1
63,83,6,0,1,1
63,84,0,5,7,2
63,84,2,0,2,2
63,84,4,0,2,2
63,84,5,2,2,0
63,85,0,2,3,1
63,85,1,1,2,1
63,85,3,0,1,1
63,85,4,0,1,1
63,85,5,1,1,0
63,85,6,2,4,2
63,86,0,0,1,1
63,86,1,0,1,1
63,86,2,1,2,1
63,86,4,0,1,1
63,86,5,3,3,0
63,86,6,0,2,2
63,87,0,0,1,1
63,87,2,1,2,1
63,87,3,0,1,1
63,87,4,0,1,1
63,88,0,2,2,0
63,88,3,2,3,1
63,88,4,1,2,1
63,88,5,0,1,1
63,89,0,1,2,1
63,89,1,1,1,0
63,89,2,0,1,1
63,89,3,3,3,0
63,89,4,2,5,3
63,89,5,3,3,0
63,89,6,2,2,0
63,90,0,0,3,3
63,90,1,1,2,1
63,90,2,1,2,1
63,90,3,2,2,0
63,90,4,0,1,1
63,90,5,1,2,1
63,90,6,5,7,2
63,91,0,0,1,1
63,91,1,1,1,0
63,91,2,1,2,1
63,91,3,2,3,1
63,91,4,1,3,2
63,91,5,1,1,0
63,91,6,2,3,1
63,92,1,2,3,1
63,92,2,1,1,0
63,92,3,0,2,2
63,92,5,2,3,1
63,93,0,1,1,0
63,93,1,0,2,2
63,93,2,1,1,0
63,93,4,1,3,2
63,94,0,0,1,1
63,94,2,1,1,0
63,94,5,3,3,0
63,94,6,2,3,1
63,95,0,0,1,1
63,95,1,0,2,2
63,95,2,1,2,1
63,95,3,0,1,1
63,95,5,0,2,2
63,95,6,1,1,0
63,96,0,2,2,0
63,96,3,2,3,1
63,96,5,0,1,1
63,96,6,0,1,1
63,97,1,4,5,1
63,97,3,1,2,1
63,97,4,1,2,1
63,97,5,3,4,1
63,97,6,1,2,1
63,98,0,0,2,2
63,98,1,1,3,2
63,98,2,1,1,0
63,98,3,2,3,1
63,98,4,2,3,1
63,98,5,1,1,0
63,98,6,0,2,2
63,99,0,0,6,6
63,99,1,0,3,3
63,99,2,1,3,2
63,99,3,6,11,5
63,99,4,0,1,1
63,99,5,0,4,4
63,99,6,0,2,2
63,100,0,0,5,5
63,100,1,1,5,4
63,100,2,1,9,8
63,100,3,1,5,4
63,100,4,1,5,4
63,100,5,0,6,6
63,100,6,0,1,1
63,101,0,0,2,2
63,101,1,2,6,4
63,101,2,1,5,4
63,101,3,0,1,1
63,101,4,0,2,2
63,101,5,1,4,3
63,101,6,6,6,0
63,102,0,3,6,3
63,102,1,6,10,4
63,102,2,2,4,2
63,102,3,3,6,3
63,102,4,4,5,1
63,102,5,2,4,2
63,102,6,5,7,2
63,103,0,4,5,1
63,103,1,1,3,2
63,103,2,1,3,2
63,103,3,5,7,2
63,103,4,5,8,3
63,103,5,1,2,1
63,103,6,2,3,1
63,104,0,8,8,0
63,104,1,3,3,0
63,104,3,2,6,4
63,104,4,5,7,2
63,104,5,2,4,2
63,104,6,1,2,1
63,105,0,4,4,0
63,105,1,0,2,2
63,105,2,2,3,1
63,105,4,0,2,2
63,105,6,1,1,0
63,106,0,1,1,0
63,106,1,1,2,1
63,106,2,2,2,0
63,106,3,0,1,1
63,106,5,0,2,2
63,107,0,2,3,1
63,107,2,1,2,1
63,107,4,1,2,1
63,107,5,1,1,0
63,107,6,2,3,1
63,108,3,0,1,1
63,108,4,0,1,1
63,108,5,0,1,1
63,108,6,7,9,2
63,109,0,3,4,1
63,109,1,1,2,1
63,109,2,0,1,1
63,109,4,1,2,1
63,109,6,2,4,2
63,110,0,1,1,0
63,110,1,0,4,4
63,110,2,1,1,0
63,110,3,6,6,0
63,110,4,0,3,3
63,110,5,0,1,1
63,110,6,2,2,0
63,111,0,0,2,2
63,111,1,1,2,1
63,111,2,0,1,1
63,111,3,0,1,1
63,111,4,0,1,1
63,111,6,1,1,0
63,112,0,1,1,0
63,112,1,0,1,1
63,112,2,0,1,1
63,112,3,0,2,2
63,112,6,2,2,0
63,113,1,0,3,3
63,113,3,0,1,1
63,113,4,2,3,1
63,113,6,0,1,1
63,114,0,0,1,1
63,114,2,0,1,1
63,114,3,1,1,0
63,114,4,2,2,0
63,114,5,0,1,1
63,115,1,1,1,0
63,115,2,0,1,1
63,115,3,0,1,1
63,115,4,1,3,2
63,115,5,3,3,0
63,115,6,1,1,0
63,116,1,2,3,1
63,116,2,0,2,2
63,116,3,3,4,1
63,116,5,2,3,1
63,116,6,1,1,0
63,117,0,0,2,2
63,117,1,3,5,2
63,117,2,0,1,1
63,117,3,5,5,0
63,117,5,3,5,2
63,117,6,6,7,1
63,118,1,1,2,1
63,118,3,0,2,2
63,118,4,0,2,2
63,118,5,1,2,1
63,118,6,3,3,0
63,119,0,0,2,2
63,119,1,2,3,1
63,119,2,2,3,1
63,119,3,0,1,1
63,119,5,3,4,1
63,119,6,3,3,0
63,120,0,3,3,0
63,120,1,1,1,0
63,120,2,2,2,0
63,120,3,0,1,1
63,120,4,0,1,1
63,120,5,4,6,2
63,120,6,2,2,0
63,121,0,0,1,1
63,121,1,0,1,1
63,121,2,0,1,1
63,121,3,1,2,1
63,121,4,1,2,1
63,121,5,3,4,1
63,121,6,3,4,1
63,122,0,1,1,0
63,122,2,2,3,1
63,122,3,1,2,1
63,122,5,1,1,0
63,122,6,0,1,1
63,123,0,0,1,1
63,123,1,1,1,0
63,123,3,1,2,1
63,123,4,3,4,1
63,123,5,1,3,2
63,124,0,2,3,1
63,124,1,1,2,1
63,124,2,0,1,1
63,124,3,0,1,1
63,124,4,1,3,2
63,124,5,0,1,1
63,125,0,0,2,2
63,125,1,2,5,3
63,125,3,0,1,1
63,125,4,0,1,1
63,125,5,1,3,2
63,125,6,0,1,1
63,127,2,0,1,1
63,127,4,1,5,4
63,128,0,0,2,2
63,128,1,0,1,1
63,128,2,0,1,1
63,128,3,1,2,1
63,128,4,2,3,1
63,128,6,1,2,1
63,129,1,1,1,0
63,129,2,0,1,1
63,129,3,0,1,1
63,129,4,0,1,1
63,129,5,1,1,0
63,129,6,1,2,1
63,130,1,1,3,2
63,130,2,2,3,1
63,130,4,2,2,0
63,130,6,2,3,1
63,131,4,1,3,2
63,131,6,2,3,1
63,132,4,1,1,0
63,132,5,1,3,2
63,132,6,1,2,1
63,133,3,1,1,0
63,133,4,2,3,1
63,133,5,0,1,1
63,133,6,0,1,1
63,134,3,0,2,2
63,134,4,1,1,0
63,134,5,2,2,0
63,135,0,1,1,0
63,135,1,0,1,1
63,135,4,5,6,1
63,135,6,0,1,1
63,136,2,0,1,1
63,136,4,1,1,0
63,136,5,1,2,1
63,137,1,1,1,0
63,137,4,1,2,1
63,137,5,0,1,1
63,138,1,1,1,0
63,138,2,1,1,0
63,139,1,1,1,0
63,139,2,0,1,1
63,139,4,2,3,1
63,139,6,1,1,0
63,140,1,1,1,0
63,141,0,2,2,0
63,141,1,0,1,1
63,142,4,2,2,0
63,143,3,1,1,0
64,0,0,7,30,23
64,0,1,2,18,16
64,0,2,5,19,14
64,0,3,3,22,19
64,0,4,4,25,21
64,0,5,3,11,8
64,0,6,5,25,20
64,1,0,0,15,15
64,1,1,4,11,7
64,1,2,6,15,9
64,1,3,1,19,18
64,1,4,1,15,14
64,1,5,2,14,12
64,1,6,5,27,22
64,2,0,0,12,12
64,2,1,2,10,8
64,2,2,2,12,10
64,2,3,1,11,10
64,2,4,0,13,13
64,2,5,2,10,8
64,2,6,0,15,15
64,3,0,0,17,17
64,3,1,1,10,9
64,3,2,0,7,7
64,3,3,2,9,7
64,3,4,0,19,19
64,3,5,4,10,6
64,3,6,5,25,20
64,4,0,2,10,8
64,4,1,1,7,6
64,4,2,0,6,6
64,4,3,2,10,8
64,4,4,4,14,10
64,4,5,3,12,9
64,4,6,1,6,5
64,5,0,2,14,12
64,5,1,3,10,7
64,5,2,2,7,5
64,5,3,3,10,7
64,5,4,2,23,21
64,5,5,1,10,9
64,5,6,0,13,13
64,6,0,5,10,5
64,6,1,5,9,4
64,6,2,0,2,2
64,6,3,1,6,5
64,6,4,5,24,19
64,6,5,3,13,10
64,6,6,0,13,13
64,7,0,1,7,6
64,7,1,1,10,9
64,7,2,1,3,2
64,7,3,0,6,6
64,7,4,0,5,5
64,7,5,0,9,9
64,7,6,1,8,7
64,8,0,3,6,3
64,8,1,4,10,6
64,8,2,1,3,2
64,8,3,4,13,9
64,8,4,2,9,7
64,8,5,0,7,7
64,8,6,1,10,9
64,9,0,1,5,4
64,9,1,6,7,1
64,9,2,0,2,2
64,9,3,2,5,3
64,9,4,0,6,6
64,9,5,0,2,2
64,9,6,0,6,6
64,10,0,0,7,7
64,10,1,1,4,3
64,10,2,2,5,3
64,10,3,2,5,3
64,10,4,0,9,9
64,10,5,1,6,5
64,10,6,5,8,3
64,11,0,1,3,2
64,11,1,1,5,4
64,11,2,2,3,1
64,11,3,5,10,5
64,11,4,2,6,4
64,11,5,3,5,2
64,11,6,2,7,5
64,12,0,2,3,1
64,12,1,3,4,1
64,12,2,5,8,3
64,12,3,1,2,1
64,12,4,6,10,4
64,12,5,1,5,4
64,12,6,1,7,6
64,13,0,3,5,2
64,13,1,0,3,3
64,13,2,5,6,1
64,13,3,0,4,4
64,13,4,5,9,4
64,13,5,3,4,1
64,13,6,3,5,2
64,14,0,2,2,0
64,14,1,1,4,3
64,14,3,2,5,3
64,14,4,4,6,2
64,14,5,0,1,1
64,14,6,0,3,3
64,15,0,1,2,1
64,15,1,2,3,1
64,15,2,1,4,3
64,15,3,1,2,1
64,15,4,6,10,4
64,15,5,0,1,1
64,15,6,1,2,1
64,16,0,4,4,0
64,16,1,2,2,0
64,16,2,1,1,0
64,16,3,3,4,1
64,16,4,2,4,2
64,16,5,0,1,1
64,16,6,0,2,2
64,17,0,2,2,0
64,17,1,1,1,0
64,17,2,5,9,4
64,17,3,2,2,0
64,17,4,0,7,7
64,17,5,3,5,2
64,17,6,0,2,2
64,18,0,3,3,0
64,18,1,0,1,1
64,18,2,1,3,2
64,18,3,2,3,1
64,18,4,4,4,0
64,18,5,1,3,2
64,18,6,0,2,2
64,19,0,6,7,1
64,19,1,2,2,0
64,19,2,1,1,0
64,19,3,2,4,2
64,19,4,1,1,0
64,19,6,7,11,4
64,20,0,1,2,1
64,20,2,2,3,1
64,20,3,3,3,0
64,20,4,2,3,1
64,20,5,1,2,1
64,20,6,1,1,0
64,21,0,1,1,0
64,21,2,0,1,1
64,21,3,0,2,2
64,21,4,5,7,2
64,21,5,1,3,2
64,21,6,3,4,1
64,22,0,0,1,1
64,22,2,2,3,1
64,22,3,1,2,1
64,22,4,5,5,0
64,22,5,1,3,2
64,22,6,0,2,2
64,23,2,3,4,1
64,23,3,1,1,0
64,23,4,0,2,2
64,24,2,1,1,0
64,24,3,3,5,2
64,24,5,0,2,2
64,24,6,2,2,0
64,25,0,3,3,0
64,25,2,1,1,0
64,25,3,1,1,0
64,25,4,1,1,0
64,25,5,5,5,0
64,25,6,1,1,0
64,26,0,2,3,1
64,26,1,1,1,0
64,26,3,1,1,0
64,26,6,0,1,1
64,27,0,1,1,0
64,27,1,0,1,1
64,27,3,1,1,0
64,27,4,1,1,0
64,27,5,1,1,0
64,28,0,1,1,0
64,28,1,0,1,1
64,28,2,1,1,0
64,28,3,1,1,0
64,28,5,1,2,1
64,29,1,10,10,0
64,29,2,2,4,2
64,29,4,1,1,0
64,29,5,1,1,0
64,30,2,1,2,1
64,30,3,1,1,0
64,30,4,8,9,1
64,30,5,2,2,0
64,30,6,0,1,1
64,31,0,2,2,0
64,31,1,1,1,0
64,31,2,1,1,0
64,31,3,2,2,0
64,31,4,1,1,0
64,31,6,1,1,0
64,32,0,2,2,0
64,32,1,1,1,0
64,32,2,2,2,0
64,32,3,4,4,0
64,32,4,1,1,0
64,33,0,3,3,0
64,33,2,1,1,0
64,33,3,3,3,0
64,33,4,2,3,1
64,33,5,1,1,0
64,34,0,3,5,2
64,34,3,0,1,1
64,34,4,1,1,0
64,34,5,1,2,1
64,34,6,1,1,0
64,35,1,1,1,0
64,35,2,1,2,1
64,35,3,0,1,1
64,35,4,0,1,1
64,35,5,0,1,1
64,35,6,1,1,0
64,36,0,4,6,2
64,36,1,2,2,0
64,36,2,1,1,0
64,36,3,1,1,0
64,36,4,1,2,1
64,36,5,5,5,0
64,36,6,4,4,0
64,37,0,3,3,0
64,37,1,0,1,1
64,37,2,0,2,2
64,37,3,2,3,1
64,37,4,5,5,0
64,37,5,3,4,1
64,37,6,4,4,0
64,38,0,3,4,1
64,38,1,1,1,0
64,38,2,1,2,1
64,38,3,2,2,0
64,38,4,7,8,1
64,38,5,0,1,1
64,38,6,6,7,1
64,39,0,2,7,5
64,39,1,0,2,2
64,39,2,2,7,5
64,39,3,0,5,5
64,39,4,3,8,5
64,39,5,0,3,3
64,39,6,1,5,4
64,40,0,1,8,7
64,40,1,1,5,4
64,40,2,3,9,6
64,40,3,4,12,8
64,40,4,2,7,5
64,40,5,2,6,4
64,40,6,3,3,0
64,41,0,1,14,13
64,41,1,0,14,14
64,41,2,0,7,7
64,41,3,1,7,6
64,41,4,2,7,5
64,41,5,1,3,2
64,41,6,1,6,5
64,42,0,0,15,15
64,42,1,0,7,7
64,42,2,0,11,11
64,42,3,0,17,17
64,42,4,0,8,8
64,42,5,0,8,8
64,42,6,0,3,3
64,43,0,2,12,10
64,43,1,0,12,12
64,43,2,0,14,14
64,43,3,0,13,13
64,43,4,0,15,15
64,43,5,1,10,9
64,43,6,1,4,3
64,44,0,0,29,29
64,44,1,0,15,15
64,44,2,0,26,26
64,44,3,0,30,30
64,44,4,0,18,18
64,44,5,0,9,9
64,44,6,0,10,10
64,45,0,1,38,37
64,45,1,0,40,40
64,45,2,3,36,33
64,45,3,2,48,46
64,45,4,0,31,31
64,45,5,0,21,21
64,45,6,0,17,17
64,46,0,3,46,43
64,46,1,0,59,59
64,46,2,4,70,66
64,46,3,0,52,52
64,46,4,1,29,28
64,46,5,1,36,35
64,46,6,0,25,25
64,47,0,1,55,54
64,47,1,1,61,60
64,47,2,1,56,55
64,47,3,1,63,62
64,47,4,1,35,34
64,47,5,2,24,22
64,47,6,0,30,30
64,48,0,1,97,96
64,48,1,1,85,84
64,48,2,3,98,95
64,48,3,3,90,87
64,48,4,4,71,67
64,48,5,2,35,33
64,48,6,1,21,20
64,49,0,14,117,103
64,49,1,5,102,97
64,49,2,2,104,102
64,49,3,1,95,94
64,49,4,3,78,75
64,49,5,6,53,47
64,49,6,1,31,30
64,50,0,0,65,65
64,50,1,4,54,50
64,50,2,2,63,61
64,50,3,2,74,72
64,50,4,0,41,41
64,50,5,7,43,36
64,50,6,1,47,46
64,51,0,4,43,39
64,51,1,3,59,56
64,51,2,1,62,61
64,51,3,3,54,51
64,51,4,2,43,41
64,51,5,3,39,36
64,51,6,3,36,33
64,52,0,1,41,40
64,52,1,0,65,65
64,52,2,2,52,50
64,52,3,6,69,63
64,52,4,0,40,40
64,52,5,4,46,42
64,52,6,0,40,40
64,53,0,0,33,33
64,53,1,2,36,34
64,53,2,1,40,39
64,53,3,1,47,46
64,53,4,0,31,31
64,53,5,1,30,29
64,53,6,0,30,30
64,54,0,2,34,32
64,54,1,1,35,34
64,54,2,0,39,39
64,54,3,0,35,35
64,54,4,1,24,23
64,54,5,0,25,25
64,54,6,0,20,20
64,55,0,1,35,34
64,55,1,1,26,25
64,55,2,1,32,31
64,55,3,0,23,23
64,55,4,0,18,18
64,55,5,0,27,27
64,55,6,2,20,18
64,56,0,7,35,28
64,56,1,0,17,17
64,56,2,1,18,17
64,56,3,0,29,29
64,56,4,0,22,22
64,56,5,0,17,17
64,56,6,2,22,20
64,57,0,4,26,22
64,57,1,0,19,19
64,57,2,0,25,25
64,57,3,1,19,18
64,57,4,0,14,14
64,57,5,0,28,28
64,57,6,1,25,24
64,58,0,1,23,22
64,58,1,1,29,28
64,58,2,0,25,25
64,58,3,0,27,27
64,58,4,1,28,27
64,58,5,1,29,28
64,58,6,1,18,17
64,59,0,1,23,22
64,59,1,0,22,22
64,59,2,0,18,18
64,59,3,1,20,19
64,59,4,1,18,17
64,59,5,6,29,23
64,59,6,0,25,25
64,60,0,2,25,23
64,60,1,0,15,15
64,60,2,0,18,18
64,60,3,0,25,25
64,60,4,1,20,19
64,60,5,0,25,25
64,60,6,0,20,20
64,61,0,0,33,33
64,61,1,1,15,14
64,61,2,1,25,24
64,61,3,0,21,21
64,61,4,0,19,19
64,61,5,1,22,21
64,61,6,0,21,21
64,62,0,0,23,23
64,62,1,1,18,17
64,62,2,0,18,18
64,62,3,0,22,22
64,62,4,0,19,19
64,62,5,1,30,29
64,62,6,0,22,22
64,63,0,1,22,21
64,63,1,1,27,26
64,63,2,0,27,27
64,63,3,1,23,22
64,63,4,0,20,20
64,63,5,3,24,21
64,63,6,1,25,24
64,64,0,0,24,24
64,64,1,1,26,25
64,64,2,0,22,22
64,64,3,1,36,35
64,64,4,1,32,31
64,64,5,0,42,42
64,64,6,0,28,28
64,65,0,0,32,32
64,65,1,0,25,25
64,65,2,1,33,32
64,65,3,2,26,24
64,65,4,0,23,23
64,65,5,0,27,27
64,65,6,1,32,31
64,66,0,1,17,16
64,66,1,1,19,18
64,66,2,1,22,21
64,66,3,2,25,23
64,66,4,2,37,35
64,66,5,0,29,29
64,66,6,0,24,24
64,67,0,0,20,20
64,67,1,0,16,16
64,67,2,1,28,27
64,67,3,1,35,34
64,67,4,0,15,15
64,67,5,1,32,31
64,67,6,1,27,26
64,68,0,0,17,17
64,68,1,1,26,25
64,68,2,0,19,19
64,68,3,0,18,18
64,68,4,1,30,29
64,68,5,1,29,28
64,68,6,6,41,35
64,69,0,0,29,29
64,69,1,2,28,26
64,69,2,2,25,23
64,69,3,0,32,32
64,69,4,0,27,27
64,69,5,2,44,42
64,69,6,1,37,36
64,70,0,1,30,29
64,70,1,3,27,24
64,70,2,1,30,29
64,70,3,0,36,36
64,70,4,2,28,26
64,70,5,1,29,28
64,70,6,1,38,37
64,71,0,2,26,24
64,71,1,0,18,18
64,71,2,1,20,19
64,71,3,1,34,33
64,71,4,1,27,26
64,71,5,1,44,43
64,71,6,2,33,31
64,72,0,1,32,31
64,72,1,1,26,25
64,72,2,2,24,22
64,72,3,0,30,30
64,72,4,0,24,24
64,72,5,4,36,32
64,72,6,4,40,36
64,73,0,11,39,28
64,73,1,0,20,20
64,73,2,0,36,36
64,73,3,0,30,30
64,73,4,1,26,25
64,73,5,0,33,33
64,73,6,2,38,36
64,74,0,1,35,34
64,74,1,0,25,25
64,74,2,1,24,23
64,74,3,1,24,23
64,74,4,2,31,29
64,74,5,0,26,26
64,74,6,0,34,34
64,75,0,3,28,25
64,75,1,2,31,29
64,75,2,0,24,24
64,75,3,0,29,29
64,75,4,15,50,35
64,75,5,1,23,22
64,75,6,0,48,48
64,76,0,0,32,32
64,76,1,0,26,26
64,76,2,0,38,38
64,76,3,0,35,35
64,76,4,3,26,23
64,76,5,1,42,41
64,76,6,3,51,48
64,77,0,0,34,34
64,77,1,0,33,33
64,77,2,1,29,28
64,77,3,0,35,35
64,77,4,5,40,35
64,77,5,2,39,37
64,77,6,0,40,40
64,78,0,1,26,25
64,78,1,2,35,33
64,78,2,0,32,32
64,78,3,2,38,36
64,78,4,2,32,30
64,78,5,0,40,40
64,78,6,1,34,33
64,79,0,0,29,29
64,79,1,1,31,30
64,79,2,1,31,30
64,79,3,4,40,36
64,79,4,6,41,35
64,79,5,9,39,30
64,79,6,1,33,32
64,80,0,0,30,30
64,80,1,5,31,26
64,80,2,1,35,34
64,80,3,2,45,43
64,80,4,2,41,39
64,80,5,4,53,49
64,80,6,1,46,45
64,81,0,1,37,36
64,81,1,0,23,23
64,81,2,1,33,32
64,81,3,1,42,41
64,81,4,4,35,31
64,81,5,3,36,33
64,81,6,0,57,57
64,82,0,1,30,29
64,82,1,0,28,28
64,82,2,1,33,32
64,82,3,1,40,39
64,82,4,0,37,37
64,82,5,5,41,36
64,82,6,3,61,58
64,83,0,1,33,32
64,83,1,0,20,20
64,83,2,0,26,26
64,83,3,0,32,32
64,83,4,6,41,35
64,83,5,2,42,40
64,83,6,2,56,54
64,84,0,1,26,25
64,84,1,3,31,28
64,84,2,2,26,24
64,84,3,0,39,39
64,84,4,6,40,34
64,84,5,0,27,27
64,84,6,0,68,68
64,85,0,1,31,30
64,85,1,0,16,16
64,85,2,3,30,27
64,85,3,0,36,36
64,85,4,3,46,43
64,85,5,1,38,37
64,85,6,1,54,53
64,86,0,1,31,30
64,86,1,2,28,26
64,86,2,1,34,33
64,86,3,0,32,32
64,86,4,3,30,27
64,86,5,2,38,36
64,86,6,0,36,36
64,87,0,4,25,21
64,87,1,0,25,25
64,87,2,2,24,22
64,87,3,2,20,18
64,87,4,2,37,35
64,87,5,1,23,22
64,87,6,1,47,46
64,88,0,2,24,22
64,88,1,1,27,26
64,88,2,0,30,30
64,88,3,1,25,24
64,88,4,0,34,34
64,88,5,2,39,37
64,88,6,2,42,40
64,89,0,0,27,27
64,89,1,1,25,24
64,89,2,0,27,27
64,89,3,4,32,28
64,89,4,5,45,40
64,89,5,2,37,35
64,89,6,2,41,39
64,90,0,0,20,20
64,90,1,2,24,22
64,90,2,0,40,40
64,90,3,2,31,29
64,90,4,2,30,28
64,90,5,0,34,34
64,90,6,1,48,47
64,91,0,2,20,18
64,91,1,3,33,30
64,91,2,0,32,32
64,91,3,1,35,34
64,91,4,1,28,27
64,91,5,0,31,31
64,91,6,1,43,42
64,92,0,1,35,34
64,92,1,3,40,37
64,92,2,3,52,49
64,92,3,1,22,21
64,92,4,2,38,36
64,92,5,0,29,29
64,92,6,2,34,32
64,93,0,0,29,29
64,93,1,0,28,28
64,93,2,0,38,38
64,93,3,1,32,31
64,93,4,2,40,38
64,93,5,0,34,34
64,93,6,1,35,34
64,94,0,2,29,27
64,94,1,0,29,29
64,94,2,0,33,33
64,94,3,1,39,38
64,94,4,2,40,38
64,94,5,0,35,35
64,94,6,1,42,41
64,95,0,0,36,36
64,95,1,2,38,36
64,95,2,0,38,38
64,95,3,1,43,42
64,95,4,0,40,40
64,95,5,0,34,34
64,95,6,1,33,32
64,96,0,0,43,43
64,96,1,1,44,43
64,96,2,0,49,49
64,96,3,2,38,36
64,96,4,1,51,50
64,96,5,3,44,41
64,96,6,3,46,43
64,97,0,2,42,40
64,97,1,0,37,37
64,97,2,1,53,52
64,97,3,0,42,42
64,97,4,1,35,34
64,97,5,1,40,39
64,97,6,2,54,52
64,98,0,2,44,42
64,98,1,1,45,44
64,98,2,1,37,36
64,98,3,0,40,40
64,98,4,1,42,41
64,98,5,1,42,41
64,98,6,2,50,48
64,99,0,1,46,45
64,99,1,0,41,41
64,99,2,0,39,39
64,99,3,1,41,40
64,99,4,1,48,47
64,99,5,0,47,47
64,99,6,2,60,58
64,100,0,0,34,34
64,100,1,2,43,41
64,100,2,2,56,54
64,100,3,0,41,41
64,100,4,1,53,52
64,100,5,4,46,42
64,100,6,0,58,58
64,101,0,2,56,54
64,101,1,1,42,41
64,101,2,1,55,54
64,101,3,2,59,57
64,101,4,4,63,59
64,101,5,2,59,57
64,101,6,5,55,50
64,102,0,2,65,63
64,102,1,1,64,63
64,102,2,2,76,74
64,102,3,1,77,76
64,102,4,3,61,58
64,102,5,3,60,57
64,102,6,2,82,80
64,103,0,1,53,52
64,103,1,0,52,52
64,103,2,2,65,63
64,103,3,1,69,68
64,103,4,2,72,70
64,103,5,1,50,49
64,103,6,2,61,59
64,104,0,1,57,56
64,104,1,2,56,54
64,104,2,1,61,60
64,104,3,1,53,52
64,104,4,4,58,54
64,104,5,1,68,67
64,104,6,2,76,74
64,105,0,3,63,60
64,105,1,0,47,47
64,105,2,0,62,62
64,105,3,1,59,58
64,105,4,1,68,67
64,105,5,2,71,69
64,105,6,0,61,61
64,106,0,4,49,45
64,106,1,2,40,38
64,106,2,0,55,55
64,106,3,2,42,40
64,106,4,0,49,49
64,106,5,3,59,56
64,106,6,2,54,52
64,107,0,0,47,47
64,107,1,0,40,40
64,107,2,7,55,48
64,107,3,0,48,48
64,107,4,2,49,47
64,107,5,0,55,55
64,107,6,1,53,52
64,108,0,0,32,32
64,108,1,0,43,43
64,108,2,2,59,57
64,108,3,3,46,43
64,108,4,0,40,40
64,108,5,2,62,60
64,108,6,2,60,58
64,109,0,3,52,49
64,109,1,0,41,41
64,109,2,0,40,40
64,109,3,0,44,44
64,109,4,0,37,37
64,109,5,1,45,44
64,109,6,1,59,58
64,110,0,3,42,39
64,110,1,2,35,33
64,110,2,0,38,38
64,110,3,3,43,40
64,110,4,2,46,44
64,110,5,1,57,56
64,110,6,1,45,44
64,111,0,4,45,41
64,111,1,0,39,39
64,111,2,1,37,36
64,111,3,3,49,46
64,111,4,1,46,45
64,111,5,1,56,55
64,111,6,1,50,49
64,112,0,0,40,40
64,112,1,2,36,34
64,112,2,1,45,44
64,112,3,1,42,41
64,112,4,1,47,46
64,112,5,0,52,52
64,112,6,1,41,40
64,113,0,0,46,46
64,113,1,1,44,43
64,113,2,1,42,41
64,113,3,2,39,37
64,113,4,0,41,41
64,113,5,1,51,50
64,113,6,1,39,38
64,114,0,1,42,41
64,114,1,0,34,34
64,114,2,0,40,40
64,114,3,0,27,27
64,114,4,1,47,46
64,114,5,1,40,39
64,114,6,4,55,51
64,115,0,0,34,34
64,115,1,2,37,35
64,115,2,0,47,47
64,115,3,1,25,24
64,115,4,1,44,43
64,115,5,1,39,38
64,115,6,1,48,47
64,116,0,1,31,30
64,116,1,0,34,34
64,116,2,1,41,40
64,116,3,1,37,36
64,116,4,3,54,51
64,116,5,0,54,54
64,116,6,2,36,34
64,117,0,0,35,35
64,117,1,0,34,34
64,117,2,0,32,32
64,117,3,0,26,26
64,117,4,0,58,58
64,117,5,1,57,56
64,117,6,1,47,46
64,118,0,0,26,26
64,118,1,1,31,30
64,118,2,1,36,35
64,118,3,1,36,35
64,118,4,2,57,55
64,118,5,1,52,51
64,118,6,0,34,34
64,119,0,0,39,39
64,119,1,2,48,46
64,119,2,1,30,29
64,119,3,1,46,45
64,119,4,0,46,46
64,119,5,1,48,47
64,119,6,5,38,33
64,120,0,1,36,35
64,120,1,0,36,36
64,120,2,0,43,43
64,120,3,0,49,49
64,120,4,1,38,37
64,120,5,1,41,40
64,120,6,0,37,37
64,121,0,3,39,36
64,121,1,3,42,39
64,121,2,0,41,41
64,121,3,1,35,34
64,121,4,1,44,43
64,121,5,1,33,32
64,121,6,6,35,29
64,122,0,5,38,33
64,122,1,0,46,46
64,122,2,1,50,49
64,122,3,1,28,27
64,122,4,2,39,37
64,122,5,1,42,41
64,122,6,8,55,47
64,123,0,3,47,44
64,123,1,2,46,44
64,123,2,3,48,45
64,123,3,0,31,31
64,123,4,0,48,48
64,123,5,0,52,52
64,123,6,0,30,30
64,124,0,1,47,46
64,124,1,0,37,37
64,124,2,0,45,45
64,124,3,0,50,50
64,124,4,1,36,35
64,124,5,0,44,44
64,124,6,0,33,33
64,125,0,1,36,35
64,125,1,4,47,43
64,125,2,1,36,35
64,125,3,2,39,37
64,125,4,0,31,31
64,125,5,2,37,35
64,125,6,0,30,30
64,126,0,1,41,40
64,126,1,1,39,38
64,126,2,0,54,54
64,126,3,0,42,42
64,126,4,2,44,42
64,126,5,3,42,39
64,126,6,4,46,42
64,127,0,1,39,38
64,127,1,0,28,28
64,127,2,2,43,41
64,127,3,5,43,38
64,127,4,0,41,41
64,127,5,2,42,40
64,127,6,1,29,28
64,128,0,1,35,34
64,128,1,1,37,36
64,128,2,1,33,32
64,128,3,0,41,41
64,128,4,1,47,46
64,128,5,1,48,47
64,128,6,0,45,45
64,129,0,2,25,23
64,129,1,1,44,43
64,129,2,1,42,41
64,129,3,1,42,41
64,129,4,1,45,44
64,129,5,1,74,73
64,129,6,2,46,44
64,130,0,0,33,33
64,130,1,1,29,28
64,130,2,0,21,21
64,130,3,2,35,33
64,130,4,1,32,31
64,130,5,3,58,55
64,130,6,1,35,34
64,131,0,1,25,24
64,131,1,1,33,32
64,131,2,1,26,25
64,131,3,2,27,25
64,131,4,2,35,33
64,131,5,3,43,40
64,131,6,3,29,26
64,132,0,0,14,14
64,132,1,0,21,21
64,132,2,0,35,35
64,132,3,0,31,31
64,132,4,0,31,31
64,132,5,1,45,44
64,132,6,0,23,23
64,133,0,0,32,32
64,133,1,1,25,24
64,133,2,2,28,26
64,133,3,0,16,16
64,133,4,1,34,33
64,133,5,0,32,32
64,133,6,2,28,26
64,134,0,2,26,24
64,134,1,1,25,24
64,134,2,0,18,18
64,134,3,1,23,22
64,134,4,2,28,26
64,134,5,4,34,30
64,134,6,0,20,20
64,135,0,0,21,21
64,135,1,0,17,17
64,135,2,2,36,34
64,135,3,0,23,23
64,135,4,0,26,26
64,135,5,4,37,33
64,135,6,2,15,13
64,136,0,0,19,19
64,136,1,0,17,17
64,136,2,1,30,29
64,136,3,0,15,15
64,136,4,0,28,28
64,136,5,2,29,27
64,136,6,1,24,23
64,137,0,0,19,19
64,137,1,1,17,16
64,137,2,2,19,17
64,137,3,0,22,22
64,137,4,0,32,32
64,137,5,1,26,25
64,137,6,1,24,23
64,138,0,2,23,21
64,138,1,0,16,16
64,138,2,0,20,20
64,138,3,0,26,26
64,138,4,0,27,27
64,138,5,0,30,30
64,138,6,3,24,21
64,139,0,2,15,13
64,139,1,1,13,12
64,139,2,0,18,18
64,139,3,0,22,22
64,139,4,2,18,16
64,139,5,0,28,28
64,139,6,1,18,17
64,140,0,1,13,12
64,140,1,0,15,15
64,140,2,2,22,20
64,140,3,1,20,19
64,140,4,1,24,23
64,140,5,0,22,22
64,140,6,0,12,12
64,141,0,2,15,13
64,141,1,0,16,16
64,141,2,2,20,18
64,141,3,1,19,18
64,141,4,2,20,18
64,141,5,0,21,21
64,141,6,1,15,14
64,142,0,1,12,11
64,142,1,0,14,14
64,142,2,3,22,19
64,142,3,2,15,13
64,142,4,0,18,18
64,142,5,0,16,16
64,142,6,4,26,22
64,143,0,2,14,12
64,143,1,3,21,18
64,143,2,2,19,17
64,143,3,3,22,19
64,143,4,4,20,16
64,143,5,0,14,14
64,143,6,6,29,23
65,0,0,1,3,2
65,0,1,1,3,2
65,0,2,0,1,1
65,0,3,1,3,2
65,0,4,2,3,1
65,0,5,1,1,0
65,0,6,1,2,1
65,1,1,0,2,2
65,1,2,1,1,0
65,1,5,0,1,1
65,1,6,0,1,1
65,2,1,1,1,0
65,2,3,1,1,0
65,2,4,2,5,3
65,2,5,0,2,2
65,2,6,0,1,1
65,3,0,0,2,2
65,3,6,1,1,0
65,4,0,3,3,0
65,4,1,1,1,0
65,4,2,0,1,1
65,4,4,0,1,1
65,4,5,1,3,2
65,4,6,0,1,1
65,5,0,1,1,0
65,5,1,2,3,1
65,5,5,0,1,1
65,5,6,2,3,1
65,6,0,1,1,0
65,6,1,2,2,0
65,6,2,2,2,0
65,6,4,0,1,1
65,6,5,0,1,1
65,6,6,0,1,1
65,7,1,3,3,0
65,7,2,1,1,0
65,7,3,1,1,0
65,7,4,0,1,1
65,7,6,1,3,2
65,8,2,1,1,0
65,8,3,0,1,1
65,8,4,1,2,1
65,8,5,1,1,0
65,8,6,0,1,1
65,9,0,0,1,1
65,9,2,2,3,1
65,9,3,0,1,1
65,9,4,1,2,1
65,10,3,1,1,0
65,10,4,0,1,1
65,10,5,0,1,1
65,11,0,1,3,2
65,11,3,1,1,0
65,11,6,3,4,1
65,12,4,0,2,2
65,12,5,0,2,2
65,12,6,3,3,0
65,13,5,1,1,0
65,14,5,1,1,0
65,15,3,1,1,0
65,16,0,1,1,0
65,16,2,0,1,1
65,16,5,0,1,1
65,18,5,0,1,1
65,19,1,3,3,0
65,19,4,1,2,1
65,19,5,0,1,1
65,20,1,3,3,0
65,20,4,0,2,2
65,20,5,0,1,1
65,21,0,3,3,0
65,21,1,1,1,0
65,22,0,1,1,0
65,22,1,1,1,0
65,22,6,1,1,0
65,23,6,2,2,0
65,24,4,2,3,1
65,24,5,0,1,1
65,25,4,2,2,0
65,27,5,1,1,0
65,28,0,1,1,0
65,28,1,3,4,1
65,28,5,3,4,1
65,28,6,0,1,1
65,29,1,1,1,0
65,29,4,0,1,1
65,30,3,1,1,0
65,30,5,1,1,0
65,31,2,0,1,1
65,31,5,1,1,0
65,32,2,0,1,1
65,32,6,0,1,1
65,33,6,0,1,1
65,34,0,1,1,0
65,34,1,1,1,0
65,34,2,0,1,1
65,34,3,2,2,0
65,35,0,1,1,0
65,35,4,0,1,1
65,35,5,0,1,1
65,36,0,2,2,0
65,36,3,0,1,1
65,36,4,1,1,0
65,36,5,1,1,0
65,36,6,0,1,1
65,37,0,2,4,2
65,37,3,1,1,0
65,37,4,0,1,1
65,37,5,1,2,1
65,38,0,3,3,0
65,38,1,2,3,1
65,38,2,1,2,1
65,38,3,1,2,1
65,38,4,1,2,1
65,38,5,0,1,1
65,39,0,0,2,2
65,39,1,0,3,3
65,39,2,1,2,1
65,39,4,1,2,1
65,39,5,2,2,0
65,39,6,0,1,1
65,40,0,0,2,2
65,40,1,3,6,3
65,40,2,0,4,4
65,40,3,0,3,3
65,40,4,1,2,1
65,40,5,3,6,3
65,40,6,3,3,0
65,41,0,0,7,7
65,41,1,0,9,9
65,41,2,0,4,4
65,41,3,3,9,6
65,41,4,0,2,2
65,41,5,1,5,4
65,41,6,0,2,2
65,42,0,1,9,8
65,42,1,1,8,7
65,42,2,1,9,8
65,42,3,0,17,17
65,42,4,0,8,8
65,42,5,0,3,3
65,42,6,1,4,3
65,43,0,2,15,13
65,43,1,1,9,8
65,43,2,1,13,12
65,43,3,1,16,15
65,43,4,0,6,6
65,43,5,0,6,6
65,43,6,0,8,8
65,44,0,1,19,18
65,44,1,0,9,9
65,44,2,1,8,7
65,44,3,0,12,12
65,44,4,1,9,8
65,44,5,0,7,7
65,44,6,0,11,11
65,45,0,0,7,7
65,45,1,0,6,6
65,45,2,0,11,11
65,45,3,0,12,12
65,45,4,3,9,6
65,45,5,0,5,5
65,45,6,1,11,10
65,46,0,4,20,16
65,46,1,0,5,5
65,46,2,2,13,11
65,46,3,3,16,13
65,46,4,0,12,12
65,46,5,0,4,4
65,46,6,1,8,7
65,47,0,1,14,13
65,47,1,0,18,18
65,47,2,0,18,18
65,47,3,1,13,12
65,47,4,0,10,10
65,47,5,1,9,8
65,47,6,3,10,7
65,48,0,5,20,15
65,48,1,0,9,9
65,48,2,0,11,11
65,48,3,2,14,12
65,48,4,0,4,4
65,48,5,1,7,6
65,48,6,3,12,9
65,49,0,3,18,15
65,49,1,2,13,11
65,49,2,0,5,5
65,49,3,3,20,17
65,49,4,2,9,7
65,49,5,0,6,6
65,49,6,0,5,5
65,50,0,1,16,15
65,50,1,1,9,8
65,50,2,0,8,8
65,50,3,1,7,6
65,50,4,0,13,13
65,50,5,0,3,3
65,50,6,0,7,7
65,51,0,0,14,14
65,51,1,0,10,10
65,51,2,3,9,6
65,51,3,3,11,8
65,51,4,1,12,11
65,51,5,0,8,8
65,51,6,0,9,9
65,52,0,0,6,6
65,52,1,0,8,8
65,52,2,0,8,8
65,52,3,2,12,10
65,52,4,1,11,10
65,52,5,5,15,10
65,52,6,0,7,7
65,53,0,0,10,10
65,53,1,1,6,5
65,53,2,0,7,7
65,53,3,0,10,10
65,53,4,1,8,7
65,53,5,0,6,6
65,53,6,4,9,5
65,54,0,1,11,10
65,54,1,2,11,9
65,54,2,0,6,6
65,54,3,1,6,5
65,54,4,1,12,11
65,54,5,0,10,10
65,54,6,2,9,7
65,55,0,2,10,8
65,55,1,1,11,10
65,55,2,0,7,7
65,55,3,0,11,11
65,55,4,0,9,9
65,55,5,0,7,7
65,55,6,0,1,1
65,56,0,1,13,12
65,56,1,1,6,5
65,56,2,1,6,5
65,56,3,0,5,5
65,56,4,1,7,6
65,56,5,1,11,10
65,56,6,4,14,10
65,57,0,1,5,4
65,57,1,3,10,7
65,57,2,2,7,5
65,57,3,0,6,6
65,57,4,2,10,8
65,57,5,1,8,7
65,57,6,1,14,13
65,58,0,1,6,5
65,58,1,1,6,5
65,58,2,0,8,8
65,58,3,4,6,2
65,58,4,4,17,13
65,58,5,0,7,7
65,58,6,0,10,10
65,59,0,0,4,4
65,59,1,1,9,8
65,59,2,1,10,9
65,59,3,1,10,9
65,59,4,3,10,7
65,59,5,0,9,9
65,59,6,0,7,7
65,60,0,0,5,5
65,60,1,5,12,7
65,60,2,2,13,11
65,60,3,0,7,7
65,60,4,2,8,6
65,60,5,0,6,6
65,60,6,0,4,4
65,61,0,3,9,6
65,61,1,2,10,8
65,61,2,4,13,9
65,61,3,0,6,6
65,61,4,5,14,9
65,61,5,0,12,12
65,61,6,0,7,7
65,62,0,2,9,7
65,62,1,3,9,6
65,62,2,0,6,6
65,62,3,2,8,6
65,62,4,0,8,8
65,62,5,0,7,7
65,62,6,1,9,8
65,63,0,1,4,3
65,63,1,2,11,9
65,63,2,1,8,7
65,63,3,1,8,7
65,63,4,1,4,3
65,63,5,2,12,10
65,63,6,1,8,7
65,64,0,0,5,5
65,64,1,3,8,5
65,64,2,0,2,2
65,64,3,0,6,6
65,64,4,3,11,8
65,64,5,1,7,6
65,64,6,1,10,9
65,65,0,5,14,9
65,65,1,1,5,4
65,65,2,0,4,4
65,65,3,1,3,2
65,65,4,0,6,6
65,65,5,1,10,9
65,65,6,0,7,7
65,66,0,1,8,7
65,66,1,1,5,4
65,66,2,1,15,14
65,66,3,2,7,5
65,66,4,5,12,7
65,66,5,1,9,8
65,66,6,0,11,11
65,67,0,1,3,2
65,67,1,1,12,11
65,67,2,0,5,5
65,67,3,0,6,6
65,67,4,5,9,4
65,67,5,2,10,8
65,67,6,3,11,8
65,68,0,1,8,7
65,68,1,0,8,8
65,68,2,3,12,9
65,68,3,0,9,9
65,68,4,3,8,5
65,68,5,3,13,10
65,68,6,1,9,8
65,69,0,3,9,6
65,69,1,4,5,1
65,69,2,0,5,5
65,69,3,1,7,6
65,69,4,2,9,7
65,69,5,7,15,8
65,69,6,1,10,9
65,70,0,0,4,4
65,70,1,2,11,9
65,70,2,5,14,9
65,70,3,3,10,7
65,70,4,0,4,4
65,70,5,0,6,6
65,70,6,1,9,8
65,71,0,1,7,6
65,71,1,0,6,6
65,71,2,0,4,4
65,71,3,3,7,4
65,71,4,2,11,9
65,71,5,2,14,12
65,71,6,1,8,7
65,72,1,1,9,8
65,72,2,1,5,4
65,72,3,1,5,4
65,72,4,0,5,5
65,72,5,3,9,6
65,72,6,0,10,10
65,73,0,4,11,7
65,73,1,3,6,3
65,73,2,3,9,6
65,73,3,2,14,12
65,73,4,1,5,4
65,73,5,3,10,7
65,73,6,2,6,4
65,74,0,1,7,6
65,74,1,1,4,3
65,74,2,1,6,5
65,74,3,0,8,8
65,74,4,0,5,5
65,74,5,4,13,9
65,74,6,4,12,8
65,75,0,0,14,14
65,75,1,4,12,8
65,75,2,1,8,7
65,75,3,0,6,6
65,75,4,3,9,6
65,75,5,1,11,10
65,75,6,4,17,13
65,76,0,1,5,4
65,76,1,0,9,9
65,76,2,10,14,4
65,76,3,4,7,3
65,76,4,6,19,13
65,76,5,3,10,7
65,76,6,1,4,3
65,77,0,1,7,6
65,77,1,2,9,7
65,77,2,2,9,7
65,77,3,1,13,12
65,77,4,3,9,6
65,77,5,3,8,5
65,77,6,0,7,7
65,78,0,7,13,6
65,78,1,1,7,6
65,78,2,6,14,8
65,78,3,3,11,8
65,78,4,2,7,5
65,78,5,2,10,8
65,78,6,0,8,8
65,79,0,2,8,6
65,79,1,0,4,4
65,79,2,0,6,6
65,79,3,1,10,9
65,79,4,4,12,8
65,79,5,0,10,10
65,79,6,5,15,10
65,80,0,5,12,7
65,80,1,4,7,3
65,80,2,7,13,6
65,80,3,2,7,5
65,80,4,3,11,8
65,80,5,4,13,9
65,80,6,1,12,11
65,81,0,1,5,4
65,81,1,1,10,9
65,81,2,2,6,4
65,81,3,1,7,6
65,81,4,0,7,7
65,81,5,0,6,6
65,81,6,1,12,11
65,82,0,1,5,4
65,82,1,0,6,6
65,82,2,1,6,5
65,82,3,4,10,6
65,82,4,2,7,5
65,82,5,0,5,5
65,82,6,3,11,8
65,83,0,0,5,5
65,83,1,0,5,5
65,83,2,3,9,6
65,83,3,2,8,6
65,83,4,0,6,6
65,83,5,1,8,7
65,83,6,0,4,4
65,84,0,0,6,6
65,84,1,1,5,4
65,84,2,2,10,8
65,84,3,3,10,7
65,84,4,2,10,8
65,84,5,8,17,9
65,84,6,4,10,6
65,85,0,0,3,3
65,85,1,3,6,3
65,85,2,7,12,5
65,85,3,3,10,7
65,85,4,3,8,5
65,85,5,1,10,9
65,85,6,4,9,5
65,86,0,0,3,3
65,86,1,0,3,3
65,86,2,2,12,10
65,86,3,1,7,6
65,86,4,0,1,1
65,86,5,1,7,6
65,86,6,4,14,10
65,87,0,0,7,7
65,87,1,1,6,5
65,87,2,1,4,3
65,87,3,4,8,4
65,87,4,0,5,5
65,87,5,0,5,5
65,87,6,3,14,11
65,88,0,1,7,6
65,88,1,0,5,5
65,88,2,1,7,6
65,88,3,1,9,8
65,88,4,1,6,5
65,88,5,0,10,10
65,88,6,0,5,5
65,89,0,0,6,6
65,89,1,1,7,6
65,89,2,0,8,8
65,89,3,1,6,5
65,89,4,0,8,8
65,89,5,0,4,4
65,89,6,1,9,8
65,90,0,0,4,4
65,90,1,0,6,6
65,90,2,0,4,4
65,90,3,0,4,4
65,90,4,0,4,4
65,90,5,2,7,5
65,90,6,0,5,5
65,91,0,0,3,3
65,91,1,0,6,6
65,91,2,0,5,5
65,91,3,0,5,5
65,91,4,1,5,4
65,91,5,0,5,5
65,91,6,3,14,11
65,92,0,0,4,4
65,92,1,0,8,8
65,92,2,1,8,7
65,92,3,0,9,9
65,92,4,1,8,7
65,92,5,5,13,8
65,92,6,2,8,6
65,93,0,1,14,13
65,93,1,1,16,15
65,93,2,0,7,7
65,93,3,1,7,6
65,93,4,1,14,13
65,93,5,1,11,10
65,93,6,2,12,10
65,94,0,0,9,9
65,94,1,0,4,4
65,94,2,4,8,4
65,94,3,2,13,11
65,94,4,2,13,11
65,94,5,0,7,7
65,94,6,0,6,6
65,95,0,3,9,6
65,95,1,0,8,8
65,95,2,1,11,10
65,95,3,0,8,8
65,95,4,2,13,11
65,95,5,2,14,12
65,95,6,0,8,8
65,96,0,0,6,6
65,96,1,0,6,6
65,96,2,0,11,11
65,96,3,0,12,12
65,96,4,0,11,11
65,96,5,1,13,12
65,96,6,0,14,14
65,97,0,2,7,5
65,97,1,4,9,5
65,97,2,0,5,5
65,97,3,0,10,10
65,97,4,2,18,16
65,97,5,1,10,9
65,97,6,0,10,10
65,98,0,2,9,7
65,98,1,0,6,6
65,98,2,0,13,13
65,98,3,3,14,11
65,98,4,3,18,15
65,98,5,0,11,11
65,98,6,0,7,7
65,99,0,1,22,21
65,99,1,0,12,12
65,99,2,0,12,12
65,99,3,1,8,7
65,99,4,2,9,7
65,99,5,4,14,10
65,99,6,1,7,6
65,100,0,1,8,7
65,100,1,0,11,11
65,100,2,3,11,8
65,100,3,2,12,10
65,100,4,0,11,11
65,100,5,1,8,7
65,100,6,7,25,18
65,101,0,0,13,13
65,101,1,0,15,15
65,101,2,2,7,5
65,101,3,0,12,12
65,101,4,2,13,11
65,101,5,1,12,11
65,101,6,1,11,10
65,102,0,2,8,6
65,102,1,1,15,14
65,102,2,1,15,14
65,102,3,0,7,7
65,102,4,4,18,14
65,102,5,0,10,10
65,102,6,2,15,13
65,103,0,1,15,14
65,103,1,2,16,14
65,103,2,2,19,17
65,103,3,0,14,14
65,103,4,2,13,11
65,103,5,3,19,16
65,103,6,1,12,11
65,104,0,3,13,10
65,104,1,5,18,13
65,104,2,1,7,6
65,104,3,2,15,13
65,104,4,1,12,11
65,104,5,2,15,13
65,104,6,2,8,6
65,105,0,1,10,9
65,105,1,2,10,8
65,105,2,0,11,11
65,105,3,4,18,14
65,105,4,0,12,12
65,105,5,0,8,8
65,105,6,1,8,7
65,106,0,0,10,10
65,106,1,4,9,5
65,106,2,1,8,7
65,106,3,0,11,11
65,106,4,1,4,3
65,106,5,1,11,10
65,106,6,2,6,4
65,107,0,0,4,4
65,107,1,0,7,7
65,107,2,1,8,7
65,107,3,0,9,9
65,107,4,2,8,6
65,107,5,1,11,10
65,107,6,1,10,9
65,108,0,1,5,4
65,108,1,0,11,11
65,108,2,0,5,5
65,108,3,2,12,10
65,108,4,0,12,12
65,108,5,1,4,3
65,108,6,0,6,6
65,109,0,0,4,4
65,109,1,1,7,6
65,109,2,0,5,5
65,109,3,1,13,12
65,109,4,1,9,8
65,109,5,1,10,9
65,109,6,1,15,14
65,110,0,1,9,8
65,110,1,0,8,8
65,110,2,0,14,14
65,110,3,1,4,3
65,110,4,0,5,5
65,110,5,1,9,8
65,110,6,0,9,9
65,111,0,0,4,4
65,111,1,1,4,3
65,111,2,1,13,12
65,111,3,0,7,7
65,111,4,2,11,9
65,111,5,1,6,5
65,111,6,1,5,4
65,112,0,1,6,5
65,112,1,3,14,11
65,112,2,0,10,10
65,112,3,2,10,8
65,112,4,0,6,6
65,112,5,2,11,9
65,112,6,0,7,7
65,113,0,0,7,7
65,113,1,1,8,7
65,113,2,0,6,6
65,113,3,2,11,9
65,113,4,0,5,5
65,113,5,2,14,12
65,113,6,0,1,1
65,114,0,2,9,7
65,114,1,1,10,9
65,114,2,0,6,6
65,114,3,1,12,11
65,114,4,0,7,7
65,114,5,2,4,2
65,114,6,0,10,10
65,115,0,0,3,3
65,115,1,1,10,9
65,115,2,0,7,7
65,115,3,1,9,8
65,115,4,0,7,7
65,115,5,0,10,10
65,115,6,1,11,10
65,116,0,0,5,5
65,116,1,1,5,4
65,116,2,4,12,8
65,116,3,4,13,9
65,116,4,1,10,9
65,116,5,3,11,8
65,116,6,0,11,11
65,117,0,1,8,7
65,117,1,1,8,7
65,117,2,0,7,7
65,117,3,1,5,4
65,117,4,3,11,8
65,117,5,1,8,7
65,117,6,2,12,10
65,118,0,0,3,3
65,118,1,3,10,7
65,118,2,5,18,13
65,118,3,0,5,5
65,118,4,1,11,10
65,118,5,1,5,4
65,118,6,0,4,4
65,119,0,0,2,2
65,119,1,3,12,9
65,119,2,0,4,4
65,119,3,0,9,9
65,119,4,1,9,8
65,119,5,1,7,6
65,119,6,5,14,9
65,120,0,1,4,3
65,120,1,5,12,7
65,120,2,0,3,3
65,120,3,2,12,10
65,120,4,1,16,15
65,120,5,0,8,8
65,120,6,14,28,14
65,121,0,0,2,2
65,121,1,2,11,9
65,121,2,2,9,7
65,121,3,5,13,8
65,121,4,0,8,8
65,121,5,0,6,6
65,121,6,3,11,8
65,122,0,0,7,7
65,122,1,0,5,5
65,122,2,0,8,8
65,122,3,0,7,7
65,122,4,0,17,17
65,122,5,1,7,6
65,122,6,1,3,2
65,123,0,0,5,5
65,123,1,3,13,10
65,123,2,0,5,5
65,123,3,1,8,7
65,123,4,1,8,7
65,123,5,4,10,6
65,123,6,1,9,8
65,124,0,0,5,5
65,124,1,0,6,6
65,124,2,1,9,8
65,124,3,2,6,4
65,124,4,1,5,4
65,124,5,1,5,4
65,124,6,2,8,6
65,125,0,5,14,9
65,125,1,4,12,8
65,125,2,6,15,9
65,125,3,0,3,3
65,125,4,2,9,7
65,125,5,0,10,10
65,125,6,2,10,8
65,126,0,2,7,5
65,126,1,2,10,8
65,126,2,3,8,5
65,126,3,0,4,4
65,126,4,0,9,9
65,126,5,1,8,7
65,126,6,0,8,8
65,127,0,1,5,4
65,127,1,3,8,5
65,127,2,0,4,4
65,127,3,0,6,6
65,127,4,0,2,2
65,127,5,1,9,8
65,127,6,0,2,2
65,128,0,2,9,7
65,128,1,2,7,5
65,128,2,2,9,7
65,128,3,2,7,5
65,128,4,0,3,3
65,128,5,0,9,9
65,128,6,1,10,9
65,129,0,1,4,3
65,129,1,0,3,3
65,129,2,3,7,4
65,129,3,0,8,8
65,129,4,1,7,6
65,129,5,1,9,8
65,129,6,1,9,8
65,130,0,3,9,6
65,130,1,0,5,5
65,130,2,2,8,6
65,130,3,0,6,6
65,130,4,1,6,5
65,130,5,1,4,3
65,130,6,0,7,7
65,131,0,2,6,4
65,131,1,0,2,2
65,131,2,3,4,1
65,131,3,2,7,5
65,131,4,0,4,4
65,131,5,1,3,2
65,131,6,0,5,5
65,132,0,1,2,1
65,132,1,0,1,1
65,132,2,0,6,6
65,132,3,1,10,9
65,132,4,0,5,5
65,132,5,0,4,4
65,132,6,0,4,4
65,133,0,1,6,5
65,133,1,0,3,3
65,133,2,1,4,3
65,133,3,0,5,5
65,133,4,1,3,2
65,133,5,1,5,4
65,133,6,0,1,1
65,134,0,2,5,3
65,134,1,0,3,3
65,134,2,2,7,5
65,134,3,6,12,6
65,134,4,2,5,3
65,134,5,1,2,1
65,134,6,0,2,2
65,135,0,1,6,5
65,135,1,0,3,3
65,135,2,1,1,0
65,135,3,2,5,3
65,135,4,0,1,1
65,135,5,2,7,5
65,135,6,0,3,3
65,136,0,0,4,4
65,136,1,0,1,1
65,136,2,1,4,3
65,136,3,0,6,6
65,136,4,1,6,5
65,136,5,1,6,5
65,136,6,4,8,4
65,137,0,1,4,3
65,137,1,0,4,4
65,137,2,5,9,4
65,137,3,0,2,2
65,137,4,2,6,4
65,137,5,0,3,3
65,137,6,3,5,2
65,138,0,2,5,3
65,138,2,5,8,3
65,138,3,1,2,1
65,138,4,1,5,4
65,138,5,0,2,2
65,138,6,2,5,3
65,139,0,4,4,0
65,139,1,0,1,1
65,139,2,0,1,1
65,139,3,1,4,3
65,139,4,5,8,3
65,139,5,0,3,3
65,139,6,8,12,4
65,140,0,0,4,4
65,140,1,3,6,3
65,140,3,3,5,2
65,140,4,4,6,2
65,140,5,2,6,4
65,140,6,0,3,3
65,141,0,1,4,3
65,141,2,2,2,0
65,141,3,0,5,5
65,141,4,0,3,3
65,141,5,2,3,1
65,141,6,0,3,3
65,142,0,0,1,1
65,142,1,0,2,2
65,142,2,5,7,2
65,142,3,3,7,4
65,142,4,0,3,3
65,142,5,0,1,1
65,143,0,0,1,1
65,143,1,0,1,1
65,143,2,0,1,1
65,143,3,2,2,0
65,143,4,1,2,1
65,143,5,3,4,1
65,143,6,0,1,1
66,0,0,5,17,12
66,0,1,1,15,14
66,0,2,1,18,17
66,0,3,0,20,20
66,0,4,3,35,32
66,0,5,1,19,18
66,0,6,2,22,20
66,1,0,0,7,7
66,1,1,1,9,8
66,1,2,3,21,18
66,1,3,0,10,10
66,1,4,3,26,23
66,1,5,0,11,11
66,1,6,0,13,13
66,2,0,2,20,18
66,2,1,1,15,14
66,2,2,1,10,9
66,2,3,0,11,11
66,2,4,6,22,16
66,2,5,0,16,16
66,2,6,1,19,18
66,3,0,1,12,11
66,3,1,3,12,9
66,3,2,2,16,14
66,3,3,3,22,19
66,3,4,0,24,24
66,3,5,1,9,8
66,3,6,1,24,23
66,4,0,1,9,8
66,4,1,2,12,10
66,4,2,1,10,9
66,4,3,0,14,14
66,4,4,0,16,16
66,4,5,1,11,10
66,4,6,1,18,17
66,5,0,1,7,6
66,5,1,0,11,11
66,5,2,2,12,10
66,5,3,1,13,12
66,5,4,1,12,11
66,5,5,1,7,6
66,5,6,0,11,11
66,6,0,1,10,9
66,6,1,1,9,8
66,6,2,1,13,12
66,6,3,1,8,7
66,6,4,0,12,12
66,6,5,0,13,13
66,6,6,2,15,13
66,7,0,1,10,9
66,7,1,0,2,2
66,7,2,0,10,10
66,7,3,0,10,10
66,7,4,2,11,9
66,7,5,1,12,11
66,7,6,2,13,11
66,8,0,0,6,6
66,8,1,1,14,13
66,8,2,0,3,3
66,8,3,0,8,8
66,8,4,0,11,11
66,8,5,0,6,6
66,8,6,0,5,5
66,9,0,2,8,6
66,9,1,1,6,5
66,9,2,0,3,3
66,9,3,1,7,6
66,9,4,2,8,6
66,9,5,2,12,10
66,9,6,0,9,9
66,10,0,2,6,4
66,10,1,2,9,7
66,10,2,1,5,4
66,10,3,2,7,5
66,10,4,3,15,12
66,10,5,3,10,7
66,10,6,0,2,2
66,11,0,0,2,2
66,11,1,0,1,1
66,11,2,0,4,4
66,11,3,1,4,3
66,11,4,0,3,3
66,11,5,0,4,4
66,11,6,0,11,11
66,12,0,0,6,6
66,12,1,1,7,6
66,12,2,0,4,4
66,12,3,0,1,1
66,12,4,0,4,4
66,12,5,3,14,11
66,12,6,0,6,6
66,13,0,1,4,3
66,13,1,0,6,6
66,13,2,0,5,5
66,13,3,1,3,2
66,13,4,0,4,4
66,13,5,0,2,2
66,13,6,1,7,6
66,14,0,0,5,5
66,14,1,0,5,5
66,14,2,0,2,2
66,14,3,1,4,3
66,14,4,0,5,5
66,14,5,0,5,5
66,14,6,1,6,5
66,15,0,3,5,2
66,15,1,2,6,4
66,15,2,0,2,2
66,15,3,1,7,6
66,15,4,0,6,6
66,15,5,0,3,3
66,15,6,0,4,4
66,16,0,1,5,4
66,16,1,1,5,4
66,16,2,0,7,7
66,16,3,0,3,3
66,16,4,0,3,3
66,16,5,0,1,1
66,16,6,3,14,11
66,17,0,3,6,3
66,17,1,2,3,1
66,17,2,0,6,6
66,17,3,0,2,2
66,17,4,0,4,4
66,17,5,2,8,6
66,17,6,0,3,3
66,18,0,0,4,4
66,18,1,0,3,3
66,18,2,0,6,6
66,18,3,0,1,1
66,18,4,0,3,3
66,18,5,4,7,3
66,18,6,1,4,3
66,19,0,0,1,1
66,19,1,1,4,3
66,19,2,0,2,2
66,19,3,0,1,1
66,19,4,3,8,5
66,19,5,6,7,1
66,19,6,2,5,3
66,20,0,0,3,3
66,20,1,2,2,0
66,20,2,0,2,2
66,20,3,0,1,1
66,20,4,0,3,3
66,20,5,0,2,2
66,20,6,0,2,2
66,21,0,0,2,2
66,21,1,0,1,1
66,21,2,1,2,1
66,21,3,0,3,3
66,21,4,0,1,1
66,21,5,2,4,2
66,22,0,0,2,2
66,22,1,2,3,1
66,22,2,0,1,1
66,22,3,0,1,1
66,22,4,1,5,4
66,22,6,3,5,2
66,23,0,1,1,0
66,23,1,1,1,0
66,23,2,1,2,1
66,23,3,1,2,1
66,23,4,0,2,2
66,23,6,2,3,1
66,24,1,2,4,2
66,24,2,0,2,2
66,24,3,2,2,0
66,24,4,1,2,1
66,24,5,0,1,1
66,25,0,0,3,3
66,25,1,2,3,1
66,25,2,1,3,2
66,25,4,2,2,0
66,25,5,1,1,0
66,25,6,1,1,0
66,26,0,1,1,0
66,26,1,3,5,2
66,26,3,1,2,1
66,26,4,0,2,2
66,26,5,1,2,1
66,26,6,2,3,1
66,27,0,0,1,1
66,27,1,1,1,0
66,27,2,0,1,1
66,27,3,1,3,2
66,27,4,0,1,1
66,27,6,3,4,1
66,28,0,0,1,1
66,28,1,1,2,1
66,28,3,0,1,1
66,28,4,2,3,1
66,28,5,0,1,1
66,29,0,1,2,1
66,29,1,1,1,0
66,29,2,0,3,3
66,29,3,1,1,0
66,29,4,2,3,1
66,29,6,0,1,1
66,30,0,0,3,3
66,30,1,0,1,1
66,30,2,1,2,1
66,30,3,6,6,0
66,30,4,0,2,2
66,30,5,0,1,1
66,31,0,0,3,3
66,31,1,2,3,1
66,31,2,0,3,3
66,31,3,3,3,0
66,31,4,0,1,1
66,31,5,3,4,1
66,32,0,0,2,2
66,32,1,0,4,4
66,32,4,0,2,2
66,32,5,2,3,1
66,32,6,0,2,2
66,33,0,1,2,1
66,33,1,3,4,1
66,33,4,0,1,1
66,33,5,1,3,2
66,34,0,0,1,1
66,34,2,0,2,2
66,34,4,1,4,3
66,34,5,0,1,1
66,34,6,0,2,2
66,35,0,0,2,2
66,35,1,0,2,2
66,35,2,0,1,1
66,35,4,0,1,1
66,35,5,2,3,1
66,35,6,1,4,3
66,36,0,1,4,3
66,36,1,3,5,2
66,36,2,0,1,1
66,36,3,3,4,1
66,36,4,0,2,2
66,36,5,0,3,3
66,36,6,0,1,1
66,37,0,0,1,1
66,37,1,0,2,2
66,37,2,0,3,3
66,37,3,0,1,1
66,37,4,3,7,4
66,37,5,0,1,1
66,37,6,2,6,4
66,38,0,1,7,6
66,38,1,0,5,5
66,38,2,2,6,4
66,38,3,0,11,11
66,38,4,0,7,7
66,38,5,0,5,5
66,38,6,0,5,5
66,39,0,0,12,12
66,39,1,1,6,5
66,39,2,0,13,13
66,39,3,0,4,4
66,39,4,0,6,6
66,39,5,0,4,4
66,39,6,0,6,6
66,40,0,0,10,10
66,40,1,0,7,7
66,40,2,1,7,6
66,40,3,0,6,6
66,40,4,0,9,9
66,40,5,1,11,10
66,40,6,1,4,3
66,41,0,1,14,13
66,41,1,1,20,19
66,41,2,1,14,13
66,41,3,0,8,8
66,41,4,3,19,16
66,41,5,0,4,4
66,41,6,0,4,4
66,42,0,0,34,34
66,42,1,1,26,25
66,42,2,0,33,33
66,42,3,0,24,24
66,42,4,2,27,25
66,42,5,1,17,16
66,42,6,1,12,11
66,43,0,1,33,32
66,43,1,0,24,24
66,43,2,0,28,28
66,43,3,0,27,27
66,43,4,1,20,19
66,43,5,0,4,4
66,43,6,0,18,18
66,44,0,1,42,41
66,44,1,0,50,50
66,44,2,0,31,31
66,44,3,1,27,26
66,44,4,1,30,29
66,44,5,0,23,23
66,44,6,0,22,22
66,45,0,1,57,56
66,45,1,4,75,71
66,45,2,4,63,59
66,45,3,1,62,61
66,45,4,0,48,48
66,45,5,4,44,40
66,45,6,1,32,31
66,46,0,0,64,64
66,46,1,1,58,57
66,46,2,0,52,52
66,46,3,3,71,68
66,46,4,0,36,36
66,46,5,0,40,40
66,46,6,1,40,39
66,47,0,1,73,72
66,47,1,2,74,72
66,47,2,1,67,66
66,47,3,1,68,67
66,47,4,3,58,55
66,47,5,3,41,38
66,47,6,1,43,42
66,48,0,1,77,76
66,48,1,4,96,92
66,48,2,0,91,91
66,48,3,0,108,108
66,48,4,3,69,66
66,48,5,2,47,45
66,48,6,0,41,41
66,49,0,3,95,92
66,49,1,2,102,100
66,49,2,8,102,94
66,49,3,1,107,106
66,49,4,0,85,85
66,49,5,5,47,42
66,49,6,1,48,47
66,50,0,2,78,76
66,50,1,1,63,62
66,50,2,3,72,69
66,50,3,0,78,78
66,50,4,1,62,61
66,50,5,0,35,35
66,50,6,0,27,27
66,51,0,0,57,57
66,51,1,0,51,51
66,51,2,2,52,50
66,51,3,1,58,57
66,51,4,2,35,33
66,51,5,1,43,42
66,51,6,0,25,25
66,52,0,0,47,47
66,52,1,0,29,29
66,52,2,0,35,35
66,52,3,0,39,39
66,52,4,1,31,30
66,52,5,0,34,34
66,52,6,2,38,36
66,53,0,1,33,32
66,53,1,5,36,31
66,53,2,0,42,42
66,53,3,0,38,38
66,53,4,3,34,31
66,53,5,1,35,34
66,53,6,0,28,28
66,54,0,0,36,36
66,54,1,0,21,21
66,54,2,0,35,35
66,54,3,1,31,30
66,54,4,0,25,25
66,54,5,2,46,44
66,54,6,3,29,26
66,55,0,0,27,27
66,55,1,0,20,20
66,55,2,0,30,30
66,55,3,0,40,40
66,55,4,0,34,34
66,55,5,1,30,29
66,55,6,0,40,40
66,56,0,0,34,34
66,56,1,0,28,28
66,56,2,0,28,28
66,56,3,0,43,43
66,56,4,1,37,36
66,56,5,1,33,32
66,56,6,1,25,24
66,57,0,0,32,32
66,57,1,0,29,29
66,57,2,2,28,26
66,57,3,1,29,28
66,57,4,0,24,24
66,57,5,0,30,30
66,57,6,0,42,42
66,58,0,0,28,28
66,58,1,0,21,21
66,58,2,0,28,28
66,58,3,0,31,31
66,58,4,0,25,25
66,58,5,3,43,40
66,58,6,1,33,32
66,59,0,0,30,30
66,59,1,0,35,35
66,59,2,0,23,23
66,59,3,0,24,24
66,59,4,0,37,37
66,59,5,1,31,30
66,59,6,0,26,26
66,60,0,1,44,43
66,60,1,2,34,32
66,60,2,1,25,24
66,60,3,1,36,35
66,60,4,2,18,16
66,60,5,0,32,32
66,60,6,0,26,26
66,61,0,0,26,26
66,61,1,1,18,17
66,61,2,1,19,18
66,61,3,0,24,24
66,61,4,0,14,14
66,61,5,0,37,37
66,61,6,3,26,23
66,62,0,0,23,23
66,62,1,1,23,22
66,62,2,0,25,25
66,62,3,2,38,36
66,62,4,0,19,19
66,62,5,1,41,40
66,62,6,0,29,29
66,63,0,1,28,27
66,63,1,1,28,27
66,63,2,0,19,19
66,63,3,0,21,21
66,63,4,0,30,30
66,63,5,0,30,30
66,63,6,1,31,30
66,64,0,1,24,23
66,64,1,0,25,25
66,64,2,1,25,24
66,64,3,1,25,24
66,64,4,1,29,28
66,64,5,2,38,36
66,64,6,0,25,25
66,65,0,2,22,20
66,65,1,0,24,24
66,65,2,2,24,22
66,65,3,2,34,32
66,65,4,1,24,23
66,65,5,2,32,30
66,65,6,0,26,26
66,66,0,1,19,18
66,66,1,0,27,27
66,66,2,0,24,24
66,66,3,0,20,20
66,66,4,1,26,25
66,66,5,0,24,24
66,66,6,2,39,37
66,67,0,1,28,27
66,67,1,2,17,15
66,67,2,0,17,17
66,67,3,0,20,20
66,67,4,2,30,28
66,67,5,0,35,35
66,67,6,2,34,32
66,68,0,0,29,29
66,68,1,3,20,17
66,68,2,5,41,36
66,68,3,1,33,32
66,68,4,3,23,20
66,68,5,3,45,42
66,68,6,1,38,37
66,69,0,1,44,43
66,69,1,2,37,35
66,69,2,2,32,30
66,69,3,0,29,29
66,69,4,0,33,33
66,69,5,0,35,35
66,69,6,1,40,39
66,70,0,0,35,35
66,70,1,0,35,35
66,70,2,0,30,30
66,70,3,0,31,31
66,70,4,0,34,34
66,70,5,1,47,46
66,70,6,1,47,46
66,71,0,2,27,25
66,71,1,1,37,36
66,71,2,0,27,27
66,71,3,2,35,33
66,71,4,1,38,37
66,71,5,0,43,43
66,71,6,2,40,38
66,72,0,0,21,21
66,72,1,0,33,33
66,72,2,4,38,34
66,72,3,1,29,28
66,72,4,1,39,38
66,72,5,1,30,29
66,72,6,2,50,48
66,73,0,1,27,26
66,73,1,1,16,15
66,73,2,0,27,27
66,73,3,2,30,28
66,73,4,1,30,29
66,73,5,1,44,43
66,73,6,4,46,42
66,74,0,0,24,24
66,74,1,0,29,29
66,74,2,1,37,36
66,74,3,2,32,30
66,74,4,0,32,32
66,74,5,0,34,34
66,74,6,5,56,51
66,75,0,0,31,31
66,75,1,2,22,20
66,75,2,0,27,27
66,75,3,1,36,35
66,75,4,0,22,22
66,75,5,0,30,30
66,75,6,5,46,41
66,76,0,0,27,27
66,76,1,2,26,24
66,76,2,1,23,22
66,76,3,0,26,26
66,76,4,0,24,24
66,76,5,1,44,43
66,76,6,0,48,48
66,77,0,0,31,31
66,77,1,0,31,31
66,77,2,1,29,28
66,77,3,1,46,45
66,77,4,1,25,24
66,77,5,1,28,27
66,77,6,1,46,45
66,78,0,0,22,22
66,78,1,0,35,35
66,78,2,2,32,30
66,78,3,3,38,35
66,78,4,2,31,29
66,78,5,1,37,36
66,78,6,1,41,40
66,79,0,1,32,31
66,79,1,0,27,27
66,79,2,0,24,24
66,79,3,1,31,30
66,79,4,2,17,15
66,79,5,1,33,32
66,79,6,1,38,37
66,80,0,0,46,46
66,80,1,1,42,41
66,80,2,0,25,25
66,80,3,0,36,36
66,80,4,0,30,30
66,80,5,2,30,28
66,80,6,3,39,36
66,81,0,1,29,28
66,81,1,0,33,33
66,81,2,1,29,28
66,81,3,0,29,29
66,81,4,0,32,32
66,81,5,0,33,33
66,81,6,0,33,33
66,82,0,2,37,35
66,82,1,0,26,26
66,82,2,0,28,28
66,82,3,3,27,24
66,82,4,0,35,35
66,82,5,0,32,32
66,82,6,0,39,39
66,83,0,0,34,34
66,83,1,1,30,29
66,83,2,0,33,33
66,83,3,1,24,23
66,83,4,1,27,26
66,83,5,0,33,33
66,83,6,0,39,39
66,84,0,0,18,18
66,84,1,5,39,34
66,84,2,5,36,31
66,84,3,0,19,19
66,84,4,1,25,24
66,84,5,0,31,31
66,84,6,0,43,43
66,85,0,0,32,32
66,85,1,2,19,17
66,85,2,4,36,32
66,85,3,1,26,25
66,85,4,0,26,26
66,85,5,3,41,38
66,85,6,2,30,28
66,86,0,0,35,35
66,86,1,0,20,20
66,86,2,0,27,27
66,86,3,0,30,30
66,86,4,0,31,31
66,86,5,0,34,34
66,86,6,0,34,34
66,87,0,2,26,24
66,87,1,1,33,32
66,87,2,2,34,32
66,87,3,0,29,29
66,87,4,1,21,20
66,87,5,0,33,33
66,87,6,1,31,30
66,88,0,3,29,26
66,88,1,0,29,29
66,88,2,2,40,38
66,88,3,0,17,17
66,88,4,0,34,34
66,88,5,5,37,32
66,88,6,2,45,43
66,89,0,0,25,25
66,89,1,0,24,24
66,89,2,1,27,26
66,89,3,1,24,23
66,89,4,6,42,36
66,89,5,2,38,36
66,89,6,1,41,40
66,90,0,0,27,27
66,90,1,0,19,19
66,90,2,1,30,29
66,90,3,0,23,23
66,90,4,4,39,35
66,90,5,0,42,42
66,90,6,1,26,25
66,91,0,0,19,19
66,91,1,1,36,35
66,91,2,0,28,28
66,91,3,0,24,24
66,91,4,3,38,35
66,91,5,3,37,34
66,91,6,0,44,44
66,92,0,1,30,29
66,92,1,1,25,24
66,92,2,6,44,38
66,92,3,1,26,25
66,92,4,0,38,38
66,92,5,1,32,31
66,92,6,1,51,50
66,93,0,1,31,30
66,93,1,0,15,15
66,93,2,1,23,22
66,93,3,1,30,29
66,93,4,0,25,25
66,93,5,2,31,29
66,93,6,1,51,50
66,94,0,0,26,26
66,94,1,1,24,23
66,94,2,3,31,28
66,94,3,0,30,30
66,94,4,1,32,31
66,94,5,2,51,49
66,94,6,0,36,36
66,95,0,0,24,24
66,95,1,2,33,31
66,95,2,0,43,43
66,95,3,1,31,30
66,95,4,0,39,39
66,95,5,1,54,53
66,95,6,0,43,43
66,96,0,0,21,21
66,96,1,0,21,21
66,96,2,2,40,38
66,96,3,0,31,31
66,96,4,0,47,47
66,96,5,4,60,56
66,96,6,0,39,39
66,97,0,1,31,30
66,97,1,0,30,30
66,97,2,0,39,39
66,97,3,0,38,38
66,97,4,0,33,33
66,97,5,3,61,58
66,97,6,0,49,49
66,98,0,0,47,47
66,98,1,1,28,27
66,98,2,2,51,49
66,98,3,0,36,36
66,98,4,0,34,34
66,98,5,6,48,42
66,98,6,2,49,47
66,99,0,0,29,29
66,99,1,1,39,38
66,99,2,0,44,44
66,99,3,1,40,39
66,99,4,2,38,36
66,99,5,6,75,69
66,99,6,0,45,45
66,100,0,0,36,36
66,100,1,1,39,38
66,100,2,1,42,41
66,100,3,0,47,47
66,100,4,3,52,49
66,100,5,16,98,82
66,100,6,0,46,46
66,101,0,0,32,32
66,101,1,0,40,40
66,101,2,1,37,36
66,101,3,0,37,37
66,101,4,2,50,48
66,101,5,2,68,66
66,101,6,2,59,57
66,102,0,4,65,61
66,102,1,1,60,59
66,102,2,1,66,65
66,102,3,1,69,68
66,102,4,5,54,49
66,102,5,2,86,84
66,102,6,2,73,71
66,103,0,4,62,58
66,103,1,4,61,57
66,103,2,1,63,62
66,103,3,3,59,56
66,103,4,3,68,65
66,103,5,5,84,79
66,103,6,1,73,72
66,104,0,4,53,49
66,104,1,1,57,56
66,104,2,3,64,61
66,104,3,2,72,70
66,104,4,3,72,69
66,104,5,2,64,62
66,104,6,6,75,69
66,105,0,3,75,72
66,105,1,2,58,56
66,105,2,2,66,64
66,105,3,4,75,71
66,105,4,4,77,73
66,105,5,1,67,66
66,105,6,0,61,61
66,106,0,4,57,53
66,106,1,2,46,44
66,106,2,2,54,52
66,106,3,1,59,58
66,106,4,0,47,47
66,106,5,0,62,62
66,106,6,1,46,45
66,107,0,3,38,35
66,107,1,1,39,38
66,107,2,1,41,40
66,107,3,5,45,40
66,107,4,0,49,49
66,107,5,2,52,50
66,107,6,3,63,60
66,108,0,1,30,29
66,108,1,0,31,31
66,108,2,1,45,44
66,108,3,0,41,41
66,108,4,0,42,42
66,108,5,0,52,52
66,108,6,5,33,28
66,109,0,3,41,38
66,109,1,1,44,43
66,109,2,3,56,53
66,109,3,1,40,39
66,109,4,0,50,50
66,109,5,2,67,65
66,109,6,1,49,48
66,110,0,4,40,36
66,110,1,1,50,49
66,110,2,1,51,50
66,110,3,0,38,38
66,110,4,1,37,36
66,110,5,2,53,51
66,110,6,1,33,32
66,111,0,1,29,28
66,111,1,0,35,35
66,111,2,0,38,38
66,111,3,2,42,40
66,111,4,1,38,37
66,111,5,0,49,49
66,111,6,1,38,37
66,112,0,0,27,27
66,112,1,0,29,29
66,112,2,0,47,47
66,112,3,1,52,51
66,112,4,0,27,27
66,112,5,1,51,50
66,112,6,0,34,34
66,113,0,2,37,35
66,113,1,0,30,30
66,113,2,2,43,41
66,113,3,0,32,32
66,113,4,0,37,37
66,113,5,2,58,56
66,113,6,1,22,21
66,114,0,2,31,29
66,114,1,1,53,52
66,114,2,0,34,34
66,114,3,0,41,41
66,114,4,1,33,32
66,114,5,2,45,43
66,114,6,1,39,38
66,115,0,2,43,41
66,115,1,5,47,42
66,115,2,0,31,31
66,115,3,0,35,35
66,115,4,1,31,30
66,115,5,1,54,53
66,115,6,2,41,39
66,116,0,0,28,28
66,116,1,1,36,35
66,116,2,0,39,39
66,116,3,0,33,33
66,116,4,2,43,41
66,116,5,1,57,56
66,116,6,1,32,31
66,117,0,4,32,28
66,117,1,1,37,36
66,117,2,2,38,36
66,117,3,0,54,54
66,117,4,1,39,38
66,117,5,0,40,40
66,117,6,1,46,45
66,118,0,0,27,27
66,118,1,1,24,23
66,118,2,0,45,45
66,118,3,0,22,22
66,118,4,0,50,50
66,118,5,2,56,54
66,118,6,0,35,35
66,119,0,1,34,33
66,119,1,0,20,20
66,119,2,5,43,38
66,119,3,0,31,31
66,119,4,1,45,44
66,119,5,0,54,54
66,119,6,1,29,28
66,120,0,1,39,38
66,120,1,3,41,38
66,120,2,1,41,40
66,120,3,3,33,30
66,120,4,0,48,48
66,120,5,3,45,42
66,120,6,1,46,45
66,121,0,0,31,31
66,121,1,1,24,23
66,121,2,0,37,37
66,121,3,2,30,28
66,121,4,2,42,40
66,121,5,1,34,33
66,121,6,2,52,50
66,122,0,0,22,22
66,122,1,0,37,37
66,122,2,0,33,33
66,122,3,0,46,46
66,122,4,3,45,42
66,122,5,0,34,34
66,122,6,0,39,39
66,123,0,0,32,32
66,123,1,0,35,35
66,123,2,0,33,33
66,123,3,2,32,30
66,123,4,1,38,37
66,123,5,1,47,46
66,123,6,1,30,29
66,124,0,0,23,23
66,124,1,0,36,36
66,124,2,5,41,36
66,124,3,2,37,35
66,124,4,1,44,43
66,124,5,5,53,48
66,124,6,2,33,31
66,125,0,0,26,26
66,125,1,0,25,25
66,125,2,2,31,29
66,125,3,1,33,32
66,125,4,2,39,37
66,125,5,7,59,52
66,125,6,0,29,29
66,126,0,1,28,27
66,126,1,0,35,35
66,126,2,0,38,38
66,126,3,2,25,23
66,126,4,0,29,29
66,126,5,4,57,53
66,126,6,1,27,26
66,127,0,1,29,28
66,127,1,0,22,22
66,127,2,3,34,31
66,127,3,1,28,27
66,127,4,0,39,39
66,127,5,2,61,59
66,127,6,1,39,38
66,128,0,1,28,27
66,128,1,1,36,35
66,128,2,1,23,22
66,128,3,0,32,32
66,128,4,1,43,42
66,128,5,3,68,65
66,128,6,0,36,36
66,129,0,0,21,21
66,129,1,0,33,33
66,129,2,0,28,28
66,129,3,0,28,28
66,129,4,1,31,30
66,129,5,4,39,35
66,129,6,1,23,22
66,130,0,1,28,27
66,130,1,0,21,21
66,130,2,0,28,28
66,130,3,0,20,20
66,130,4,0,18,18
66,130,5,0,36,36
66,130,6,0,18,18
66,131,0,0,34,34
66,131,1,2,27,25
66,131,2,1,32,31
66,131,3,2,19,17
66,131,4,0,24,24
66,131,5,0,25,25
66,131,6,0,24,24
66,132,0,1,16,15
66,132,1,0,19,19
66,132,2,2,25,23
66,132,3,0,24,24
66,132,4,0,22,22
66,132,5,1,35,34
66,132,6,2,22,20
66,133,0,1,11,10
66,133,1,0,13,13
66,133,2,0,18,18
66,133,3,0,24,24
66,133,4,0,38,38
66,133,5,1,29,28
66,133,6,0,17,17
66,134,0,2,22,20
66,134,1,1,19,18
66,134,2,1,18,17
66,134,3,0,22,22
66,134,4,1,18,17
66,134,5,1,24,23
66,134,6,0,18,18
66,135,0,0,12,12
66,135,1,1,22,21
66,135,2,0,17,17
66,135,3,1,20,19
66,135,4,2,29,27
66,135,5,0,25,25
66,135,6,1,18,17
66,136,0,1,17,16
66,136,1,2,17,15
66,136,2,1,19,18
66,136,3,0,22,22
66,136,4,1,26,25
66,136,5,0,25,25
66,136,6,0,30,30
66,137,0,0,22,22
66,137,1,0,20,20
66,137,2,1,24,23
66,137,3,5,25,20
66,137,4,0,28,28
66,137,5,1,30,29
66,137,6,1,26,25
66,138,0,0,13,13
66,138,1,1,16,15
66,138,2,0,22,22
66,138,3,1,30,29
66,138,4,0,15,15
66,138,5,0,26,26
66,138,6,0,25,25
66,139,0,0,14,14
66,139,1,0,16,16
66,139,2,1,14,13
66,139,3,1,21,20
66,139,4,0,24,24
66,139,5,1,22,21
66,139,6,1,17,16
66,140,0,0,10,10
66,140,1,0,15,15
66,140,2,0,17,17
66,140,3,2,24,22
66,140,4,2,13,11
66,140,5,1,25,24
66,140,6,1,16,15
66,141,0,1,16,15
66,141,1,0,10,10
66,141,2,2,26,24
66,141,3,0,20,20
66,141,4,0,21,21
66,141,5,4,31,27
66,141,6,2,14,12
66,142,0,1,9,8
66,142,1,0,8,8
66,142,2,0,13,13
66,142,3,1,18,17
66,142,4,0,21,21
66,142,5,0,16,16
66,142,6,0,12,12
66,143,0,0,12,12
66,143,1,1,17,16
66,143,2,0,9,9
66,143,3,0,17,17
66,143,4,0,24,24
66,143,5,1,14,13
66,143,6,0,9,9
